gb|DQ241380.1|+|0-777|ARO:3002539|AAC(3)-IV [Escherichia coli] 	0	722	41	763	777	53827366-	722	GTGCAATACGAATGGCGAAAAGCCGAGCTCATCGGTCAGCTTCTCAACCTTGGGGTTACCCCCGGCGGTGTGCTGCTGGTCCACAGCTCCTTCCGTAGCGTCCGGCCCCTCGAAGATGGGCCACTTGGACTGATCGAGGCCCTGCGTGCTGCGCTGGGTCCGGGAGGGACGCTCGTCATGCCCTCGTGGTCAGGTCTGGACGACGAGCCGTTCGATCCTGCCACGTCGCCCGTTACACCGGACCTTGGAGTTGTCTCTGACACATTCTGGCGCCTGCCAAATGTAAAGCGCAGCGCCCATCCATTTGCCTTTGCGGCAGCGGGGCCACAGGCAGAGCAGATCATCTCTGATCCATTGCCCCTGCCACCTCACTCGCCTGCAAGCCCGGTCGCCCGTGTCCATGAACTCGATGGGCAGGTACTTCTCCTCGGCGTGGGACACGATGCCAACACGACGCTGCATCTTGCCGAGTTGATGGCAAAGGTTCCCTATGGGGTGCCGAGACACTGCACCATTCTTCAGGATGGCAAGTTGGTACGCGTCGATTATCTCGAGAATGACCACTGCTGTGAGCGCTTTGCCTTGGCGGACAGGTGGCTCAAGGAGAAGAGCCTTCAGAAGGAAGGTCCAGTCGGTCATGCCTTTGCTCGGTTGATCCGCTCCCGCGACATTGTGGCGACAGCCCTGGGTCAACTGGGCCGAGATCCGTTGATCTTCCTGCA
gb|EU220744|+|0-786|ARO:3001441|OXA-116 [Acinetobacter baumannii] 	0	727	54167	54894	786	246080-	727	TTACTTATAACAAGCGCTATTTTTATTTCAGCCTGCTCACCTTATATAGTGACTGCTAATCCAAATCACAGCGCTTCAAAATCTGATGTAAAAGCAGAGAAAATTAAAAATTTATTTAACGAAGCACACACTACGGGTGTTTTAGTTATCCAACAAGGCCAAACTCAACAAAGCTATGGTAATGATCTTGCTCGTGCTTCGACCGAGTATGTACCTGCTTCGACCTTCAAAATGCTTAATGCTTTGATCGGCCTTGAGCACCATAAGGCAACCACCACAGAAGTATTTAAGTGGGATGGTAAAAAAAGGTTATTCCCAGAATGGGAAAAGGACATGACCCTAGGCGATGCCATGAAAGCTTCCGCTATTCCAGTTTATCAAGATTTAGCTCGTCGTATTGGACTTGAGCTCATGTCTAAGGAAGTGAAGCGTGTTGGTTATGGCAATGCAGATATCGGTACCCAAGTCGATAATTTTTGGCTGGTGGGTCCTTTAAAAATTACTCCTCAGCAAGAGGCACAGTTTGCTTACAAGCTAGCTAATAAAACGCTTCCATTTAGCCAAAAAGTCCAAGATGAAGTGCAATCCATGCTATTCATAGAAGAAAAGAATGGAAACAAAATATACGCAAAAAGTGGTTGGGGATGGGATGTAAACCCACAAGTAGGCTGGTTAACTGGATGGGTTGTTCAGCCTCAAGGGAATATTGTAGCGTTCTCCCTTAACT
gb|KM433672|+|0-822|ARO:3003161|OXA-423 [Acinetobacter baumannii] 	0	767	80	847	822	254088-	767	ATGAATAAATATTTTACTTGCTATGTGGTTGCTTCTCTTTTTCTTTCTGGTTGTACGGTTCAGCATAATTTAATAAATGAAACCCCGAGTCAGATTGTTCAAGGACATAATCAGGTGATTCATCAATACTTTGATGAAAAAAACACCTCAGGTGTGCTGGTTATTCAAACAGATAAAAAAATTAATCTATATGGTAATGCTCTAAGCCGCGCAAATACAGAATATGTGCCAGCCTCTACATTTAAAATGTTGAATGCCCTGATCGGATTGGAGAACCAGAAAACGGATATTAATGAAATATTTAAATGGAAGGGCGAGAAAAGGTCATTTACCGCTTGGGAAAAAGACATGACACTAGGAGAAGCCATGAAGCTTTCTGCAGTCCCAGTCTATCAGGAACTTGCGCGACGTATCGGTCTTGATCTCATGCAAAAAGAAGTAAAACGTATTGGTTTCGGTAATGCTGAAATTGGACAGCAGGTTGATAATTTCTGGTTGGTAGGACCATTAAAGGTTACGCCTATTCAAGAGGTAGAGTTTGTTTCCCAATTAGCACATACACAGCTTCCATTTAGTGAAAAAGTGCAGGCTAATGTAAAAAATATGCTTCTTTTAGAAGAGAGTAATGGCTACAAAATTTTTGGAAAGACTGGTTGGGCAATGGATATAAAACCACAAGTGGGCTGGTTGACCGGCTGGGTTGAGCAGCCAGATGGAAAAATTGTCGCTTTTGCATTAAATATGGAAATGCGGTCAGAAATGCCGGC
gb|KF305666.1|+|0-825|ARO:3001715|OXA-259 [Acinetobacter baumannii] 	0	770	54149	54919	825	246080-	770	ATGAACATTAAAGCACTCTTACTTATAACAAGCGCTATTTTTATTTCAGCCTGCTCACCTTATATAGTGACTGCTAATCCAAATCACAGCGCTTCAAAATCTGATGTAAAAGCAGAGAAAATTAAAAATTTATTTAACGAAGCACACACTACGGGTGTTTTAGTTATCCAACAAGGCCAAACTCAACAAAGCTATGGTAATGATCTTGCTCGTGCTTCGACCGAGTATGTACCTGCTTCGACCTTCAAAATGCTTAATGCTTTGATCGGCCTTGAGCACCATAAGGCAACCACCACAGAAGTATTTAAGTGGGATGGTAAAAAAAGGTTATTCCCAGAATGGGAAAAGGACATGACCCTAGGCGATGCCATGAAAGCTTCCGCTATTCCAGTTTATCAAGATTTAGCTCGTCGTATTGGACTTGAGCTCATGTCTAAGGAAGTGAAGCGTGTTGGTTATGGCAATGCAGATATCGGTACCCAAGTCGATAATTTTTGGCTGGTGGGTCCTTTAAAAATTACTCCTCAGCAAGAGGCACAGTTTGCTTACAAGCTAGCTAATAAAACGCTTCCATTTAGCCAAAAAGTCCAAGATGAAGTGCAATCCATGCTATTCATAGAAGAAAAGAATGGAAACAAAATATACGCAAAAAGTGGTTGGGGATGGGATGTAAACCCACAAGTAGGCTGGTTAACTGGATGGGTTGTTCAGCCTCAAGGGAATATTGTAGCGTTCTCCCTTAACTTAGAAATGAAAAAAGGAATACCTAG
gb|Y11069|+|0-780|ARO:3001065|SHV-6 [Klebsiella pneumoniae] 	5	725	51	771	780	1612535+	720	AGCCACCCTGCCGCTGGCGGTACACGCCAGCCCGCAGCCGCTTGAGCAAATTAAACAAAGCGAAAGCCAGCTGTCGGGCCGCGTAGGCATGATAGAAATGGATCTGGCCAGCGGCCGCACGCTGACCGCCTGGCGCGCCGATGAACGCTTTCCCATGATGAGCACCTTTAAAGTAGTGCTCTGCGGCGCAGTGCTGGCGCGGGTGGATGCCGGTGACGAACAGCTGGAGCGAAAGATCCACTATCGCCAGCAGGATCTGGTGGACTACTCGCCGGTCAGCGAAAAACACCTTGCCGACGGCATGACGGTCGGCGAACTCTGCGCCGCCGCCATTACCATGAGCGATAACAGCGCCGCCAATCTGCTGCTGGCCACCGTCGGCGGCCCCGCAGGATTGACTGCCTTTTTGCGCCAGATCGGCGACAACGTCACCCGCCTTGACCGCTGGGAAACGGAACTGAATGAGGCGCTTCCCGGCGACGCCCGCGACACCACTACCCCGGCCAGCATGGCCGCGACCCTGCGCAAGCTGCTGACCAGCCAGCGTCTGAGCGCCCGTTCGCAACGGCAGCTGCTGCAGTGGATGGTGGACGATCGGGTCGCCGGACCGTTGATCCGCTCCGTGCTGCCGGCGGGCTGGTTTATCGCCGATAAGACCGGAGCTAGCAAGCGGGGTGCGCGCGGGATTGTCGCCCTGCTTGGCCCGAATAACAAAGCAGA
gb|JF812965|+|0-861|ARO:3001167|SHV-120 [Escherichia coli] 	0	806	16	822	861	1612535+	806	ATGCGTTATATTCGCCTGTGTATTATCACCCTGTGAGCCACCCTGCCGCTGGCGGTACACGCCAGCCCGCAGCCGCTTGAGCAAATTAAACAAAGCGAAAGCCAGCTGTCGGGCCGCGTAGGCATGATAGAAATGGATCTGGCCAGCGGCCGCACGCTGACCGCCTGGCGCGCCGATGAACGCTTTCCCATGATGAGCACCTTTAAAGTAGTGCTCTGCGGCGCAGTGCTGGCGCGGGTGGATGCCGGTGACGAACAGCTGGAGCGAAAGATCCACTATCGCCAGCAGGATCTGGTGGACTACTCGCCGGTCAGCGAAAAACACCTTGCCGACGGCATGACGGTCGGCGAACTCTGCGCCGCCGCCATTACCATGAGCGATAACAGCGCCGCCAATCTGCTGCTGGCCACCGTCGGCGGCCCCGCAGGATTGACTGCCTTTTTGCGCCAGATCGGCGACAACGTCACCCGCCTTGACCGCTGGGAAACGGAACTGAATGAGGCGCTTCCCGGCGACGCCCGCGACACCACTACCCCGGCCAGCATGGCCGCGACCCTGCGCAAGCTGCTGACCAGCCAGCGTCTGAGCGCCCGTTCGCAACGGCAGCTGCTGCAGTGGATGGTGGACGATCGGGTCGCCGGACCGTTGATCCGCTCCGTGCTGCCGGCGGGCTGGTTTATCGCCGATAAGACCGGAGCTAGCAAGCGGGGTGCGCGCGGGATTGTCGCCCTGCTTGGCCCGAATAACAAAGCAGAGCGCATTGTGGTGATTTATCTGCGGGATACGCCGGCGAGCATGGCCGAGCG
gb|KP050487.1|+|0-861|ARO:3001350|SHV-180 [Klebsiella pneumoniae] 	0	806	16	822	861	1612535+	806	ATGCGTTATATTCGCCTGTGTATTATCACCCTGTGAGCCACCCTGCCGCTGGCGGTACACGCCAGCCCGCAGCCGCTTGAGCAAATTAAACAAAGCGAAAGCCAGCTGTCGGGCCGCGTAGGCATGATAGAAATGGATCTGGCCAGCGGCCGCACGCTGACCGCCTGGCGCGCCGATGAACGCTTTCCCATGATGAGCACCTTTAAAGTAGTGCTCTGCGGCGCAGTGCTGGCGCGGGTGGATGCCGGTGACGAACAGCTGGAGCGAAAGATCCACTATCGCCAGCAGGATCTGGTGGACTACTCGCCGGTCAGCGAAAAACACCTTGCCGACGGCATGACGGTCGGCGAACTCTGCGCCGCCGCCATTACCATGAGCGATAACAGCGCCGCCAATCTGCTGCTGGCCACCGTCGGCGGCCCCGCAGGATTGACTGCCTTTTTGCGCCAGATCGGCGACAACGTCACCCGCCTTGACCGCTGGGAAACGGAACTGAATGAGGCGCTTCCCGGCGACGCCCGCGACACCACTACCCCGGCCAGCATGGCCGCGACCCTGCGCAAGCTGCTGACCAGCCAGCGTCTGAGCGCCCGTTCGCAACGGCAGCTGCTGCAGTGGATGGTGGACGATCGGGTCGCCGGACCGTTGATCCGCTCCGTGCTGCCGGCGGGCTGGTTTATCGCCGATAAGACCGGAGCTAGCAAGCGGGGTGCGCGCGGGATTGTCGCCCTGCTTGGCCCGAATAACAAAGCAGAGCGCATTGTGGTGATTTATCTGCGGGATACGCCGGCGAGCATGGCCGAGCG
gb|AE006468.2|+|1707351-1707789|ARO:3002571|AAC(6')-Iaa [Salmonella enterica subsp. enterica serovar Typhimurium str. LT2] 	129	383	0	254	438	55192214+	254	GCATCATTTATTGCGATGGCAGACGGGGTGGCGATTGGCTTTGCGGATGCCTCAATCCGCCACGATTATGTCAATGGCTGTGACAGTTCGCCCGTGGTTTTCCTTGAAGGTATTTTTGTTCTCCCCTCGTTCCGTCAACGCGGCTTAGCGAAACAATTGATTGCAGCAGTGCAACGATGGGGAACGAATAAAGGGTGTCGGGAAATGGCTTCCGATACCTCGCCGGAAAATACAATTTCACAGAAAGTTCACCT
gb|APOR01000009.1|+|341736-342561|ARO:3001716|OXA-260 [Acinetobacter baumannii NIPH 1362] 	0	770	54149	54919	825	246080-	770	ATGAACATTAAAGCACTCTTACTTATAACAAGCGCTATTTTTATTTCAGCCTGCTCACCTTATATAGTGACTGCTAATCCAAATCACAGCGCTTCAAAATCTGATGTAAAAGCAGAGAAAATTAAAAATTTATTTAACGAAGCACACACTACGGGTGTTTTAGTTATCCAACAAGGCCAAACTCAACAAAGCTATGGTAATGATCTTGCTCGTGCTTCGACCGAGTATGTACCTGCTTCGACCTTCAAAATGCTTAATGCTTTGATCGGCCTTGAGCACCATAAGGCAACCACCACAGAAGTATTTAAGTGGGATGGTAAAAAAAGGTTATTCCCAGAATGGGAAAAGGACATGACCCTAGGCGATGCCATGAAAGCTTCCGCTATTCCAGTTTATCAAGATTTAGCTCGTCGTATTGGACTTGAGCTCATGTCTAAGGAAGTGAAGCGTGTTGGTTATGGCAATGCAGATATCGGTACCCAAGTCGATAATTTTTGGCTGGTGGGTCCTTTAAAAATTACTCCTCAGCAAGAGGCACAGTTTGCTTACAAGCTAGCTAATAAAACGCTTCCATTTAGCCAAAAAGTCCAAGATGAAGTGCAATCCATGCTATTCATAGAAGAAAAGAATGGAAACAAAATATACGCAAAAAGTGGTTGGGGATGGGATGTAAACCCACAAGTAGGCTGGTTAACTGGATGGGTTGTTCAGCCTCAAGGGAATATTGTAGCGTTCTCCCTTAACTTAGAAATGAAAAAAGGAATACCTAG
gb|GQ423625.1|+|0-825|ARO:3001442|OXA-117 [Acinetobacter baumannii] 	0	770	54149	54919	825	246080-	770	ATGAACATTAAAGCACTCTTACTTATAACAAGCGCTATTTTTATTTCAGCCTGCTCACCTTATATAGTGACTGCTAATCCAAATCACAGCGCTTCAAAATCTGATGTAAAAGCAGAGAAAATTAAAAATTTATTTAACGAAGCACACACTACGGGTGTTTTAGTTATCCAACAAGGCCAAACTCAACAAAGCTATGGTAATGATCTTGCTCGTGCTTCGACCGAGTATGTACCTGCTTCGACCTTCAAAATGCTTAATGCTTTGATCGGCCTTGAGCACCATAAGGCAACCACCACAGAAGTATTTAAGTGGGATGGTAAAAAAAGGTTATTCCCAGAATGGGAAAAGGACATGACCCTAGGCGATGCCATGAAAGCTTCCGCTATTCCAGTTTATCAAGATTTAGCTCGTCGTATTGGACTTGAGCTCATGTCTAAGGAAGTGAAGCGTGTTGGTTATGGCAATGCAGATATCGGTACCCAAGTCGATAATTTTTGGCTGGTGGGTCCTTTAAAAATTACTCCTCAGCAAGAGGCACAGTTTGCTTACAAGCTAGCTAATAAAACGCTTCCATTTAGCCAAAAAGTCCAAGATGAAGTGCAATCCATGCTATTCATAGAAGAAAAGAATGGAAACAAAATATACGCAAAAAGTGGTTGGGGATGGGATGTAAACCCACAAGTAGGCTGGTTAACTGGATGGGTTGTTCAGCCTCAAGGGAATATTGTAGCGTTCTCCCTTAACTTAGAAATGAAAAAAGGAATACCTAG
gb|KM588352|+|0-825|ARO:3003147|OXA-424 [Acinetobacter baumannii] 	0	770	54149	54919	825	246080-	770	ATGAACATTAAAGCACTCTTACTTATAACAAGCGCTATTTTTATTTCAGCCTGCTCACCTTATATAGTGACTGCTAATCCAAATCACAGCGCTTCAAAATCTGATGTAAAAGCAGAGAAAATTAAAAATTTATTTAACGAAGCACACACTACGGGTGTTTTAGTTATCCAACAAGGCCAAACTCAACAAAGCTATGGTAATGATCTTGCTCGTGCTTCGACCGAGTATGTACCTGCTTCGACCTTCAAAATGCTTAATGCTTTGATCGGCCTTGAGCACCATAAGGCAACCACCACAGAAGTATTTAAGTGGGATGGTAAAAAAAGGTTATTCCCAGAATGGGAAAAGGACATGACCCTAGGCGATGCCATGAAAGCTTCCGCTATTCCAGTTTATCAAGATTTAGCTCGTCGTATTGGACTTGAGCTCATGTCTAAGGAAGTGAAGCGTGTTGGTTATGGCAATGCAGATATCGGTACCCAAGTCGATAATTTTTGGCTGGTGGGTCCTTTAAAAATTACTCCTCAGCAAGAGGCACAGTTTGCTTACAAGCTAGCTAATAAAACGCTTCCATTTAGCCAAAAAGTCCAAGATGAAGTGCAATCCATGCTATTCATAGAAGAAAAGAATGGAAACAAAATATACGCAAAAAGTGGTTGGGGATGGGATGTAAACCCACAAGTAGGCTGGTTAACTGGATGGGTTGTTCAGCCTCAAGGGAATATTGTAGCGTTCTCCCTTAACTTAGAAATGAAAAAAGGAATACCTAG
gb|AB302939|+|8-869|ARO:3001115|SHV-60 [Klebsiella pneumoniae] 	0	806	16	822	861	1612535+	806	ATGCGTTATATTCGCCTGTGTATTATCACCCTGTGAGCCACCCTGCCGCTGGCGGTACACGCCAGCCCGCAGCCGCTTGAGCAAATTAAACAAAGCGAAAGCCAGCTGTCGGGCCGCGTAGGCATGATAGAAATGGATCTGGCCAGCGGCCGCACGCTGACCGCCTGGCGCGCCGATGAACGCTTTCCCATGATGAGCACCTTTAAAGTAGTGCTCTGCGGCGCAGTGCTGGCGCGGGTGGATGCCGGTGACGAACAGCTGGAGCGAAAGATCCACTATCGCCAGCAGGATCTGGTGGACTACTCGCCGGTCAGCGAAAAACACCTTGCCGACGGCATGACGGTCGGCGAACTCTGCGCCGCCGCCATTACCATGAGCGATAACAGCGCCGCCAATCTGCTGCTGGCCACCGTCGGCGGCCCCGCAGGATTGACTGCCTTTTTGCGCCAGATCGGCGACAACGTCACCCGCCTTGACCGCTGGGAAACGGAACTGAATGAGGCGCTTCCCGGCGACGCCCGCGACACCACTACCCCGGCCAGCATGGCCGCGACCCTGCGCAAGCTGCTGACCAGCCAGCGTCTGAGCGCCCGTTCGCAACGGCAGCTGCTGCAGTGGATGGTGGACGATCGGGTCGCCGGACCGTTGATCCGCTCCGTGCTGCCGGCGGGCTGGTTTATCGCCGATAAGACCGGAGCTAGCAAGCGGGGTGCGCGCGGGATTGTCGCCCTGCTTGGCCCGAATAACAAAGCAGAGCGCATTGTGGTGATTTATCTGCGGGATACGCCGGCGAGCATGGCCGAGCG
gb|AJ866284|+|0-861|ARO:3001116|SHV-61 [Klebsiella pneumoniae] 	0	806	16	822	861	1612535+	806	ATGCGTTATATTCGCCTGTGTATTATCACCCTGTGAGCCACCCTGCCGCTGGCGGTACACGCCAGCCCGCAGCCGCTTGAGCAAATTAAACAAAGCGAAAGCCAGCTGTCGGGCCGCGTAGGCATGATAGAAATGGATCTGGCCAGCGGCCGCACGCTGACCGCCTGGCGCGCCGATGAACGCTTTCCCATGATGAGCACCTTTAAAGTAGTGCTCTGCGGCGCAGTGCTGGCGCGGGTGGATGCCGGTGACGAACAGCTGGAGCGAAAGATCCACTATCGCCAGCAGGATCTGGTGGACTACTCGCCGGTCAGCGAAAAACACCTTGCCGACGGCATGACGGTCGGCGAACTCTGCGCCGCCGCCATTACCATGAGCGATAACAGCGCCGCCAATCTGCTGCTGGCCACCGTCGGCGGCCCCGCAGGATTGACTGCCTTTTTGCGCCAGATCGGCGACAACGTCACCCGCCTTGACCGCTGGGAAACGGAACTGAATGAGGCGCTTCCCGGCGACGCCCGCGACACCACTACCCCGGCCAGCATGGCCGCGACCCTGCGCAAGCTGCTGACCAGCCAGCGTCTGAGCGCCCGTTCGCAACGGCAGCTGCTGCAGTGGATGGTGGACGATCGGGTCGCCGGACCGTTGATCCGCTCCGTGCTGCCGGCGGGCTGGTTTATCGCCGATAAGACCGGAGCTAGCAAGCGGGGTGCGCGCGGGATTGTCGCCCTGCTTGGCCCGAATAACAAAGCAGAGCGCATTGTGGTGATTTATCTGCGGGATACGCCGGCGAGCATGGCCGAGCG
gb|HQ661362|+|71-932|ARO:3001168|SHV-121 [Klebsiella pneumoniae] 	0	806	16	822	861	1612535+	806	ATGCGTTATATTCGCCTGTGTATTATCACCCTGTGAGCCACCCTGCCGCTGGCGGTACACGCCAGCCCGCAGCCGCTTGAGCAAATTAAACAAAGCGAAAGCCAGCTGTCGGGCCGCGTAGGCATGATAGAAATGGATCTGGCCAGCGGCCGCACGCTGACCGCCTGGCGCGCCGATGAACGCTTTCCCATGATGAGCACCTTTAAAGTAGTGCTCTGCGGCGCAGTGCTGGCGCGGGTGGATGCCGGTGACGAACAGCTGGAGCGAAAGATCCACTATCGCCAGCAGGATCTGGTGGACTACTCGCCGGTCAGCGAAAAACACCTTGCCGACGGCATGACGGTCGGCGAACTCTGCGCCGCCGCCATTACCATGAGCGATAACAGCGCCGCCAATCTGCTGCTGGCCACCGTCGGCGGCCCCGCAGGATTGACTGCCTTTTTGCGCCAGATCGGCGACAACGTCACCCGCCTTGACCGCTGGGAAACGGAACTGAATGAGGCGCTTCCCGGCGACGCCCGCGACACCACTACCCCGGCCAGCATGGCCGCGACCCTGCGCAAGCTGCTGACCAGCCAGCGTCTGAGCGCCCGTTCGCAACGGCAGCTGCTGCAGTGGATGGTGGACGATCGGGTCGCCGGACCGTTGATCCGCTCCGTGCTGCCGGCGGGCTGGTTTATCGCCGATAAGACCGGAGCTAGCAAGCGGGGTGCGCGCGGGATTGTCGCCCTGCTTGGCCCGAATAACAAAGCAGAGCGCATTGTGGTGATTTATCTGCGGGATACGCCGGCGAGCATGGCCGAGCG
gb|APQV01000009.1|+|266252-267077|ARO:3001717|OXA-261 [Acinetobacter baumannii NIPH 201] 	0	770	54149	54919	825	246080-	770	ATGAACATTAAAGCACTCTTACTTATAACAAGCGCTATTTTTATTTCAGCCTGCTCACCTTATATAGTGACTGCTAATCCAAATCACAGCGCTTCAAAATCTGATGTAAAAGCAGAGAAAATTAAAAATTTATTTAACGAAGCACACACTACGGGTGTTTTAGTTATCCAACAAGGCCAAACTCAACAAAGCTATGGTAATGATCTTGCTCGTGCTTCGACCGAGTATGTACCTGCTTCGACCTTCAAAATGCTTAATGCTTTGATCGGCCTTGAGCACCATAAGGCAACCACCACAGAAGTATTTAAGTGGGATGGTAAAAAAAGGTTATTCCCAGAATGGGAAAAGGACATGACCCTAGGCGATGCCATGAAAGCTTCCGCTATTCCAGTTTATCAAGATTTAGCTCGTCGTATTGGACTTGAGCTCATGTCTAAGGAAGTGAAGCGTGTTGGTTATGGCAATGCAGATATCGGTACCCAAGTCGATAATTTTTGGCTGGTGGGTCCTTTAAAAATTACTCCTCAGCAAGAGGCACAGTTTGCTTACAAGCTAGCTAATAAAACGCTTCCATTTAGCCAAAAAGTCCAAGATGAAGTGCAATCCATGCTATTCATAGAAGAAAAGAATGGAAACAAAATATACGCAAAAAGTGGTTGGGGATGGGATGTAAACCCACAAGTAGGCTGGTTAACTGGATGGGTTGTTCAGCCTCAAGGGAATATTGTAGCGTTCTCCCTTAACTTAGAAATGAAAAAAGGAATACCTAG
gb|KP050489|+|0-861|ARO:3001364|SHV-182 [Klebsiella pneumoniae] 	0	806	16	822	861	1612535+	806	ATGCGTTATATTCGCCTGTGTATTATCACCCTGTGAGCCACCCTGCCGCTGGCGGTACACGCCAGCCCGCAGCCGCTTGAGCAAATTAAACAAAGCGAAAGCCAGCTGTCGGGCCGCGTAGGCATGATAGAAATGGATCTGGCCAGCGGCCGCACGCTGACCGCCTGGCGCGCCGATGAACGCTTTCCCATGATGAGCACCTTTAAAGTAGTGCTCTGCGGCGCAGTGCTGGCGCGGGTGGATGCCGGTGACGAACAGCTGGAGCGAAAGATCCACTATCGCCAGCAGGATCTGGTGGACTACTCGCCGGTCAGCGAAAAACACCTTGCCGACGGCATGACGGTCGGCGAACTCTGCGCCGCCGCCATTACCATGAGCGATAACAGCGCCGCCAATCTGCTGCTGGCCACCGTCGGCGGCCCCGCAGGATTGACTGCCTTTTTGCGCCAGATCGGCGACAACGTCACCCGCCTTGACCGCTGGGAAACGGAACTGAATGAGGCGCTTCCCGGCGACGCCCGCGACACCACTACCCCGGCCAGCATGGCCGCGACCCTGCGCAAGCTGCTGACCAGCCAGCGTCTGAGCGCCCGTTCGCAACGGCAGCTGCTGCAGTGGATGGTGGACGATCGGGTCGCCGGACCGTTGATCCGCTCCGTGCTGCCGGCGGGCTGGTTTATCGCCGATAAGACCGGAGCTAGCAAGCGGGGTGCGCGCGGGATTGTCGCCCTGCTTGGCCCGAATAACAAAGCAGAGCGCATTGTGGTGATTTATCTGCGGGATACGCCGGCGAGCATGGCCGAGCG
gb|KM588353|+|0-825|ARO:3003148|OXA-425 [Acinetobacter baumannii] 	0	770	54149	54919	825	246080-	770	ATGAACATTAAAGCACTCTTACTTATAACAAGCGCTATTTTTATTTCAGCCTGCTCACCTTATATAGTGACTGCTAATCCAAATCACAGCGCTTCAAAATCTGATGTAAAAGCAGAGAAAATTAAAAATTTATTTAACGAAGCACACACTACGGGTGTTTTAGTTATCCAACAAGGCCAAACTCAACAAAGCTATGGTAATGATCTTGCTCGTGCTTCGACCGAGTATGTACCTGCTTCGACCTTCAAAATGCTTAATGCTTTGATCGGCCTTGAGCACCATAAGGCAACCACCACAGAAGTATTTAAGTGGGATGGTAAAAAAAGGTTATTCCCAGAATGGGAAAAGGACATGACCCTAGGCGATGCCATGAAAGCTTCCGCTATTCCAGTTTATCAAGATTTAGCTCGTCGTATTGGACTTGAGCTCATGTCTAAGGAAGTGAAGCGTGTTGGTTATGGCAATGCAGATATCGGTACCCAAGTCGATAATTTTTGGCTGGTGGGTCCTTTAAAAATTACTCCTCAGCAAGAGGCACAGTTTGCTTACAAGCTAGCTAATAAAACGCTTCCATTTAGCCAAAAAGTCCAAGATGAAGTGCAATCCATGCTATTCATAGAAGAAAAGAATGGAAACAAAATATACGCAAAAAGTGGTTGGGGATGGGATGTAAACCCACAAGTAGGCTGGTTAACTGGATGGGTTGTTCAGCCTCAAGGGAATATTGTAGCGTTCTCCCTTAACTTAGAAATGAAAAAAGGAATACCTAG
gb|HE963768|+|0-825|ARO:3001672|OXA-120 [Acinetobacter baumannii] 	0	770	54149	54919	825	246080-	770	ATGAACATTAAAGCACTCTTACTTATAACAAGCGCTATTTTTATTTCAGCCTGCTCACCTTATATAGTGACTGCTAATCCAAATCACAGCGCTTCAAAATCTGATGTAAAAGCAGAGAAAATTAAAAATTTATTTAACGAAGCACACACTACGGGTGTTTTAGTTATCCAACAAGGCCAAACTCAACAAAGCTATGGTAATGATCTTGCTCGTGCTTCGACCGAGTATGTACCTGCTTCGACCTTCAAAATGCTTAATGCTTTGATCGGCCTTGAGCACCATAAGGCAACCACCACAGAAGTATTTAAGTGGGATGGTAAAAAAAGGTTATTCCCAGAATGGGAAAAGGACATGACCCTAGGCGATGCCATGAAAGCTTCCGCTATTCCAGTTTATCAAGATTTAGCTCGTCGTATTGGACTTGAGCTCATGTCTAAGGAAGTGAAGCGTGTTGGTTATGGCAATGCAGATATCGGTACCCAAGTCGATAATTTTTGGCTGGTGGGTCCTTTAAAAATTACTCCTCAGCAAGAGGCACAGTTTGCTTACAAGCTAGCTAATAAAACGCTTCCATTTAGCCAAAAAGTCCAAGATGAAGTGCAATCCATGCTATTCATAGAAGAAAAGAATGGAAACAAAATATACGCAAAAAGTGGTTGGGGATGGGATGTAAACCCACAAGTAGGCTGGTTAACTGGATGGGTTGTTCAGCCTCAAGGGAATATTGTAGCGTTCTCCCTTAACTTAGAAATGAAAAAAGGAATACCTAG
gb|AB462903|+|1199-1751|ARO:3002574|AAC(6')-Iaf [Pseudomonas aeruginosa] 	4	497	106	599	552	53314296+	493	ACTATTCAATATGCGATATAGCTGAATCAAATGAATTAATCCTTGAAGCAGCAAAGATGCTTAAGAAAAGCTTTCTTGATGCTGGAAATGAATCATGGGGAGATATTAAAAATGCTATTGAAGAAGTTGAAGAATGTATAGAACATCCAAATATATGCTTGGGAATATGTCTGGATGATAAACTGATTGGATGGACCGGATTAAGGCCGATGTACGATAAGACCTGGGAACTTCATCCCATGGTTATAAAAACTGAATATCAAGGCAAGGGTTTTGGGAAAGTACTACTAAGAGAACTAGAGACGAGAGCGAAGAGTAGGGGAATTATCGGAATAGCTCTTGGAACTGATGACGAATATCAGAAAACTAGTTTGTCTATGATTGATATAAACGAACGAAATATCTTCGATGAAATCGGGAATATAAAGAACGTTAATAATCATCCATATGAGTTTTATAAGAAATGTGGTTATATGATCGTTGGAATAATCCC
gb|HG934764|+|0-864|ARO:3001351|SHV-183 [Enterobacter cloacae] 	0	809	16	822	864	1612535+	806	ATGCGTTATATTCGCCTGTGTATTATCACCCTGTGAGCCACCCTGCCGCTGGCGGTACACGCCAGCCCGCAGCCGCTTGAGCAAATTAAACAAAGCGAAAGCCAGCTGTCGGGCCGCGTAGGCATGATAGAAATGGATCTGGCCAGCGGCCGCACGCTGACCGCCTGGCGCGCCGATGAACGCTTTCCCATGATGAGCACCTTTAAAGTAGTGCTCTGCGGCGCAGTGCTGGCGCGGGTGGATGCCGGTGACGAACAGCTGGAGCGAAAGATCCACTATCGCCAGCAGGATCTGGTGGACTACTCGCCGGTCAGCGAAAAACACCTTGCCGACGGCATGACGGTCGGCGAACTCTGCGCCGCCGCCATTACCATGAGCGATAACAGCGCCGCCAATCTGCTGCTGGCCACCGTCGGCGGCCCCGCAGGATTGACTGCCTTTTTGCGCCAGATCGGCGACAACGTCACCCGCCTTGACCGCTGGGAAACGGAACTGAATGAGGCGCTTCCCGGCGACGCCCGCGACACCACTACCCCGGCCAGCATGGCCGCGACCCTGCGCAAGCTGCTGACCAGCCAGCGTCTGAGCGCCCGTTCGCAACGGCAGCTGCTGCAGTGGATGGTGGACGATCGGGTCGCCGGACCGTTGATCCGCTCCGTGCTGCCGGCGGGCTGGTTTATCGCCGATAAGACCGGAGCTAGCAAGCGGGGTGCGCGCGGGATTGTCGCCCTGCTTGGCCCGAATAACAAAGCAGAGCGCATTGTGGTGATTTATCTGCGGGATACGCCGGCGAGCATGGCCGAGCG
gb|KM588354|+|0-825|ARO:3003149|OXA-426 [Acinetobacter baumannii] 	0	770	54149	54919	825	246080-	770	ATGAACATTAAAGCACTCTTACTTATAACAAGCGCTATTTTTATTTCAGCCTGCTCACCTTATATAGTGACTGCTAATCCAAATCACAGCGCTTCAAAATCTGATGTAAAAGCAGAGAAAATTAAAAATTTATTTAACGAAGCACACACTACGGGTGTTTTAGTTATCCAACAAGGCCAAACTCAACAAAGCTATGGTAATGATCTTGCTCGTGCTTCGACCGAGTATGTACCTGCTTCGACCTTCAAAATGCTTAATGCTTTGATCGGCCTTGAGCACCATAAGGCAACCACCACAGAAGTATTTAAGTGGGATGGTAAAAAAAGGTTATTCCCAGAATGGGAAAAGGACATGACCCTAGGCGATGCCATGAAAGCTTCCGCTATTCCAGTTTATCAAGATTTAGCTCGTCGTATTGGACTTGAGCTCATGTCTAAGGAAGTGAAGCGTGTTGGTTATGGCAATGCAGATATCGGTACCCAAGTCGATAATTTTTGGCTGGTGGGTCCTTTAAAAATTACTCCTCAGCAAGAGGCACAGTTTGCTTACAAGCTAGCTAATAAAACGCTTCCATTTAGCCAAAAAGTCCAAGATGAAGTGCAATCCATGCTATTCATAGAAGAAAAGAATGGAAACAAAATATACGCAAAAAGTGGTTGGGGATGGGATGTAAACCCACAAGTAGGCTGGTTAACTGGATGGGTTGTTCAGCCTCAAGGGAATATTGTAGCGTTCTCCCTTAACTTAGAAATGAAAAAAGGAATACCTAG
gb|FJ666073|+|0-1194|ARO:3002509|PDC-10 [Pseudomonas aeruginosa] 	0	1139	35513	36652	1194	232416+	1139	ATGCGCGATACCAGATTCCCCTGCCTGTGCGGCATCGCCGCTTCCACACTGCTGTTCGCCACCACCCCGGCCATTGCCGATGAGGCCCCGGCGGATCGCCTGAAGGCACTGGTCGACGCCGCCGTACAACCGGTGATGAAGGCCAATGACATTCCGGGCCTGGCCGTAGCCATCAGCCTGAAAGGAGAACCGCATTACTTCAGCTATGGGCTGGCCTCGAAAGAGGACGGCCGCCGGGTGACGCCGGAGACCCTGTTCGAGATCGGCTCGGTGAGCAAGACCTTCACCGTCACCCTCGCCGGCTATGCCCTGGCCCAGGACAAGATGCGCCTCGACGACCGCGCCAGCCAGCACTGGCCGGCACTGCAGGGCAGCCGCTTCGACGGCATCAGCCTGCTCGACCTCGCGACCTATACCGCCGGCGGCTTGCCGCTGCAGTTCCCCGACTCGGTGCAGAAGGACCAGGCACAGATCCGCGACTACTACCGCCAGTGGCAGCCGACCTACGCGCCGGGCAGCCAGCGCCTCTATTCCAACCCGAGCATCGGCCTGTTCGGCTATCTCGCCGCGCGCAGCCTGGGCCAGCCGTTCGAACGGCTCATGGAGCAGCAATTGTTCCCGGCACTGGGCCTCGAACAGACCCACCTCGACGTGCCCGAGGCGGCGCTGGCGCAGTACGCCCAGGGCTACGGCAAGGACGACCGCCCGCTACGGGTCGGTCCCGGCCCGCTGGATGCCGAAGGCTACGGGGTGAAGACCAGCGCGGCCGACCTGCTGCGCTTCGTCGATGCCAACCTGCATCCGGAGCGCCTGGACAGGCCCTGGGCGCAGGCGCTCGATGCCACCCATCGCGGTTACTACAAGGTCGGCGACATGACCCAGGGCCTGGGCTGGGAAGCCTACGACTGGCCGATCTCCCTGAAGCGCCTGCAGGCCGGCAACTCGACGCCGATGGCGCTGCAACCACACAGGATCGCCAGGCTGCCCGCGCCACAGGCGCTGGAGGGCCAGCGCCTGCTGAACAAGACCGGCTCCACCAACGGCTTCGGCGCCTACGTGGCGTTCGTCCCGGGCCGCGACCTGGGCCTGGTGATCCTGGCCAACCGCAACTATCCCAATGCCGAGCGGGTGAAGATCGC
gb|KF057027|+|0-825|ARO:3001443|OXA-121 [Acinetobacter baumannii] 	0	770	54149	54919	825	246080-	770	ATGAACATTAAAGCACTCTTACTTATAACAAGCGCTATTTTTATTTCAGCCTGCTCACCTTATATAGTGACTGCTAATCCAAATCACAGCGCTTCAAAATCTGATGTAAAAGCAGAGAAAATTAAAAATTTATTTAACGAAGCACACACTACGGGTGTTTTAGTTATCCAACAAGGCCAAACTCAACAAAGCTATGGTAATGATCTTGCTCGTGCTTCGACCGAGTATGTACCTGCTTCGACCTTCAAAATGCTTAATGCTTTGATCGGCCTTGAGCACCATAAGGCAACCACCACAGAAGTATTTAAGTGGGATGGTAAAAAAAGGTTATTCCCAGAATGGGAAAAGGACATGACCCTAGGCGATGCCATGAAAGCTTCCGCTATTCCAGTTTATCAAGATTTAGCTCGTCGTATTGGACTTGAGCTCATGTCTAAGGAAGTGAAGCGTGTTGGTTATGGCAATGCAGATATCGGTACCCAAGTCGATAATTTTTGGCTGGTGGGTCCTTTAAAAATTACTCCTCAGCAAGAGGCACAGTTTGCTTACAAGCTAGCTAATAAAACGCTTCCATTTAGCCAAAAAGTCCAAGATGAAGTGCAATCCATGCTATTCATAGAAGAAAAGAATGGAAACAAAATATACGCAAAAAGTGGTTGGGGATGGGATGTAAACCCACAAGTAGGCTGGTTAACTGGATGGGTTGTTCAGCCTCAAGGGAATATTGTAGCGTTCTCCCTTAACTTAGAAATGAAAAAAGGAATACCTAG
gb|FJ503047|+|0-519|ARO:3002592|AAC(6')-Ib-Hangzhou [Acinetobacter baumannii] 	0	464	113	577	519	104606+	464	ATGACTGAGCATGACCTTGCGATGCTCTATGAGTGGCTAAATCGATCTCATATCGTCGAGTGGTGGGGCGGAGAAGAAGCACGCCCGACACTTGCTGACGTACAGGAACAGTACTTGCCAAGCGTTTTAGCGCAAGAGTCCGTCACTCCATACATTGCAATGCTGAATGGAGAGCCGATTGGGTATGCCCAGTCGTACGTTGCTCTTGGAAGCGGGGACGGATGGTGGGAAGAAGAAACCGATCCAGGAGTACGCGGAATAGACCAGTCACTGGCGAATGCATCACAACTGGGCAAAGGCTTGGGAACCAAGCTGGTTCGAGCTCTGGTTGAGTTGCTGTTCAATGATCCCGAGGTCACCAAGATCCAAACGGACCCGTCGCCGAGCAACTTGCGAGCGATCCGATGCTACGAGAAAGCGGGGTTTGAGAGGCAAGGTACCGTAACCACCCCAGATGGTCCAGC
gb|APRA01000005.1|+|465153-465978|ARO:3001718|OXA-262 [Acinetobacter baumannii NIPH 67] 	0	770	54149	54919	825	246080-	770	ATGAACATTAAAGCACTCTTACTTATAACAAGCGCTATTTTTATTTCAGCCTGCTCACCTTATATAGTGACTGCTAATCCAAATCACAGCGCTTCAAAATCTGATGTAAAAGCAGAGAAAATTAAAAATTTATTTAACGAAGCACACACTACGGGTGTTTTAGTTATCCAACAAGGCCAAACTCAACAAAGCTATGGTAATGATCTTGCTCGTGCTTCGACCGAGTATGTACCTGCTTCGACCTTCAAAATGCTTAATGCTTTGATCGGCCTTGAGCACCATAAGGCAACCACCACAGAAGTATTTAAGTGGGATGGTAAAAAAAGGTTATTCCCAGAATGGGAAAAGGACATGACCCTAGGCGATGCCATGAAAGCTTCCGCTATTCCAGTTTATCAAGATTTAGCTCGTCGTATTGGACTTGAGCTCATGTCTAAGGAAGTGAAGCGTGTTGGTTATGGCAATGCAGATATCGGTACCCAAGTCGATAATTTTTGGCTGGTGGGTCCTTTAAAAATTACTCCTCAGCAAGAGGCACAGTTTGCTTACAAGCTAGCTAATAAAACGCTTCCATTTAGCCAAAAAGTCCAAGATGAAGTGCAATCCATGCTATTCATAGAAGAAAAGAATGGAAACAAAATATACGCAAAAAGTGGTTGGGGATGGGATGTAAACCCACAAGTAGGCTGGTTAACTGGATGGGTTGTTCAGCCTCAAGGGAATATTGTAGCGTTCTCCCTTAACTTAGAAATGAAAAAAGGAATACCTAG
gb|AJ866285|+|0-861|ARO:3001117|SHV-62 [Klebsiella pneumoniae] 	0	806	16	822	861	1612535+	806	ATGCGTTATATTCGCCTGTGTATTATCACCCTGTGAGCCACCCTGCCGCTGGCGGTACACGCCAGCCCGCAGCCGCTTGAGCAAATTAAACAAAGCGAAAGCCAGCTGTCGGGCCGCGTAGGCATGATAGAAATGGATCTGGCCAGCGGCCGCACGCTGACCGCCTGGCGCGCCGATGAACGCTTTCCCATGATGAGCACCTTTAAAGTAGTGCTCTGCGGCGCAGTGCTGGCGCGGGTGGATGCCGGTGACGAACAGCTGGAGCGAAAGATCCACTATCGCCAGCAGGATCTGGTGGACTACTCGCCGGTCAGCGAAAAACACCTTGCCGACGGCATGACGGTCGGCGAACTCTGCGCCGCCGCCATTACCATGAGCGATAACAGCGCCGCCAATCTGCTGCTGGCCACCGTCGGCGGCCCCGCAGGATTGACTGCCTTTTTGCGCCAGATCGGCGACAACGTCACCCGCCTTGACCGCTGGGAAACGGAACTGAATGAGGCGCTTCCCGGCGACGCCCGCGACACCACTACCCCGGCCAGCATGGCCGCGACCCTGCGCAAGCTGCTGACCAGCCAGCGTCTGAGCGCCCGTTCGCAACGGCAGCTGCTGCAGTGGATGGTGGACGATCGGGTCGCCGGACCGTTGATCCGCTCCGTGCTGCCGGCGGGCTGGTTTATCGCCGATAAGACCGGAGCTAGCAAGCGGGGTGCGCGCGGGATTGTCGCCCTGCTTGGCCCGAATAACAAAGCAGAGCGCATTGTGGTGATTTATCTGCGGGATACGCCGGCGAGCATGGCCGAGCG
gb|KM233164|+|0-861|ARO:3003152|SHV-185 [Klebsiella pneumoniae] 	0	806	16	822	861	1612535+	806	ATGCGTTATATTCGCCTGTGTATTATCACCCTGTGAGCCACCCTGCCGCTGGCGGTACACGCCAGCCCGCAGCCGCTTGAGCAAATTAAACAAAGCGAAAGCCAGCTGTCGGGCCGCGTAGGCATGATAGAAATGGATCTGGCCAGCGGCCGCACGCTGACCGCCTGGCGCGCCGATGAACGCTTTCCCATGATGAGCACCTTTAAAGTAGTGCTCTGCGGCGCAGTGCTGGCGCGGGTGGATGCCGGTGACGAACAGCTGGAGCGAAAGATCCACTATCGCCAGCAGGATCTGGTGGACTACTCGCCGGTCAGCGAAAAACACCTTGCCGACGGCATGACGGTCGGCGAACTCTGCGCCGCCGCCATTACCATGAGCGATAACAGCGCCGCCAATCTGCTGCTGGCCACCGTCGGCGGCCCCGCAGGATTGACTGCCTTTTTGCGCCAGATCGGCGACAACGTCACCCGCCTTGACCGCTGGGAAACGGAACTGAATGAGGCGCTTCCCGGCGACGCCCGCGACACCACTACCCCGGCCAGCATGGCCGCGACCCTGCGCAAGCTGCTGACCAGCCAGCGTCTGAGCGCCCGTTCGCAACGGCAGCTGCTGCAGTGGATGGTGGACGATCGGGTCGCCGGACCGTTGATCCGCTCCGTGCTGCCGGCGGGCTGGTTTATCGCCGATAAGACCGGAGCTAGCAAGCGGGGTGCGCGCGGGATTGTCGCCCTGCTTGGCCCGAATAACAAAGCAGAGCGCATTGTGGTGATTTATCTGCGGGATACGCCGGCGAGCATGGCCGAGCG
gb|EU085533|+|0-519|ARO:3002591|AAC(6')-Ib-Suzhou [Enterobacter cloacae] 	0	464	113	577	519	104606+	464	ATGACTGAGCATGACCTTGCGATGCTCTATGAGTGGCTAAATCGATCTCATATCGTCGAGTGGTGGGGCGGAGAAGAAGCACGCCCGACACTTGCTGACGTACAGGAACAGTACTTGCCAAGCGTTTTAGCGCAAGAGTCCGTCACTCCATACATTGCAATGCTGAATGGAGAGCCGATTGGGTATGCCCAGTCGTACGTTGCTCTTGGAAGCGGGGACGGATGGTGGGAAGAAGAAACCGATCCAGGAGTACGCGGAATAGACCAGTCACTGGCGAATGCATCACAACTGGGCAAAGGCTTGGGAACCAAGCTGGTTCGAGCTCTGGTTGAGTTGCTGTTCAATGATCCCGAGGTCACCAAGATCCAAACGGACCCGTCGCCGAGCAACTTGCGAGCGATCCGATGCTACGAGAAAGCGGGGTTTGAGAGGCAAGGTACCGTAACCACCCCAGATGGTCCAGC
gb|HM751103.1|+|0-864|ARO:3001169|SHV-122 [Klebsiella pneumoniae] 	0	809	16	822	864	1612535+	806	ATGCGTTATATTCGCCTGTGTATTATCACCCTGTGAGCCACCCTGCCGCTGGCGGTACACGCCAGCCCGCAGCCGCTTGAGCAAATTAAACAAAGCGAAAGCCAGCTGTCGGGCCGCGTAGGCATGATAGAAATGGATCTGGCCAGCGGCCGCACGCTGACCGCCTGGCGCGCCGATGAACGCTTTCCCATGATGAGCACCTTTAAAGTAGTGCTCTGCGGCGCAGTGCTGGCGCGGGTGGATGCCGGTGACGAACAGCTGGAGCGAAAGATCCACTATCGCCAGCAGGATCTGGTGGACTACTCGCCGGTCAGCGAAAAACACCTTGCCGACGGCATGACGGTCGGCGAACTCTGCGCCGCCGCCATTACCATGAGCGATAACAGCGCCGCCAATCTGCTGCTGGCCACCGTCGGCGGCCCCGCAGGATTGACTGCCTTTTTGCGCCAGATCGGCGACAACGTCACCCGCCTTGACCGCTGGGAAACGGAACTGAATGAGGCGCTTCCCGGCGACGCCCGCGACACCACTACCCCGGCCAGCATGGCCGCGACCCTGCGCAAGCTGCTGACCAGCCAGCGTCTGAGCGCCCGTTCGCAACGGCAGCTGCTGCAGTGGATGGTGGACGATCGGGTCGCCGGACCGTTGATCCGCTCCGTGCTGCCGGCGGGCTGGTTTATCGCCGATAAGACCGGAGCTAGCAAGCGGGGTGCGCGCGGGATTGTCGCCCTGCTTGGCCCGAATAACAAAGCAGAGCGCATTGTGGTGATTTATCTGCGGGATACGCCGGCGAGCATGGCCGAGCG
gb|EU255291.1|+|0-825|ARO:3001444|OXA-122 [Acinetobacter baumannii] 	0	770	54149	54919	825	246080-	770	ATGAACATTAAAGCACTCTTACTTATAACAAGCGCTATTTTTATTTCAGCCTGCTCACCTTATATAGTGACTGCTAATCCAAATCACAGCGCTTCAAAATCTGATGTAAAAGCAGAGAAAATTAAAAATTTATTTAACGAAGCACACACTACGGGTGTTTTAGTTATCCAACAAGGCCAAACTCAACAAAGCTATGGTAATGATCTTGCTCGTGCTTCGACCGAGTATGTACCTGCTTCGACCTTCAAAATGCTTAATGCTTTGATCGGCCTTGAGCACCATAAGGCAACCACCACAGAAGTATTTAAGTGGGATGGTAAAAAAAGGTTATTCCCAGAATGGGAAAAGGACATGACCCTAGGCGATGCCATGAAAGCTTCCGCTATTCCAGTTTATCAAGATTTAGCTCGTCGTATTGGACTTGAGCTCATGTCTAAGGAAGTGAAGCGTGTTGGTTATGGCAATGCAGATATCGGTACCCAAGTCGATAATTTTTGGCTGGTGGGTCCTTTAAAAATTACTCCTCAGCAAGAGGCACAGTTTGCTTACAAGCTAGCTAATAAAACGCTTCCATTTAGCCAAAAAGTCCAAGATGAAGTGCAATCCATGCTATTCATAGAAGAAAAGAATGGAAACAAAATATACGCAAAAAGTGGTTGGGGATGGGATGTAAACCCACAAGTAGGCTGGTTAACTGGATGGGTTGTTCAGCCTCAAGGGAATATTGTAGCGTTCTCCCTTAACTTAGAAATGAAAAAAGGAATACCTAG
gb|KM233165|+|0-861|ARO:3003153|SHV-186 [Klebsiella pneumoniae] 	0	806	16	822	861	1612535+	806	ATGCGTTATATTCGCCTGTGTATTATCACCCTGTGAGCCACCCTGCCGCTGGCGGTACACGCCAGCCCGCAGCCGCTTGAGCAAATTAAACAAAGCGAAAGCCAGCTGTCGGGCCGCGTAGGCATGATAGAAATGGATCTGGCCAGCGGCCGCACGCTGACCGCCTGGCGCGCCGATGAACGCTTTCCCATGATGAGCACCTTTAAAGTAGTGCTCTGCGGCGCAGTGCTGGCGCGGGTGGATGCCGGTGACGAACAGCTGGAGCGAAAGATCCACTATCGCCAGCAGGATCTGGTGGACTACTCGCCGGTCAGCGAAAAACACCTTGCCGACGGCATGACGGTCGGCGAACTCTGCGCCGCCGCCATTACCATGAGCGATAACAGCGCCGCCAATCTGCTGCTGGCCACCGTCGGCGGCCCCGCAGGATTGACTGCCTTTTTGCGCCAGATCGGCGACAACGTCACCCGCCTTGACCGCTGGGAAACGGAACTGAATGAGGCGCTTCCCGGCGACGCCCGCGACACCACTACCCCGGCCAGCATGGCCGCGACCCTGCGCAAGCTGCTGACCAGCCAGCGTCTGAGCGCCCGTTCGCAACGGCAGCTGCTGCAGTGGATGGTGGACGATCGGGTCGCCGGACCGTTGATCCGCTCCGTGCTGCCGGCGGGCTGGTTTATCGCCGATAAGACCGGAGCTAGCAAGCGGGGTGCGCGCGGGATTGTCGCCCTGCTTGGCCCGAATAACAAAGCAGAGCGCATTGTGGTGATTTATCTGCGGGATACGCCGGCGAGCATGGCCGAGCG
gb|KM979376.1|+|20-845|ARO:3003120|OXA-429 [Acinetobacter baumannii] 	0	770	54149	54919	825	246080-	770	ATGAACATTAAAGCACTCTTACTTATAACAAGCGCTATTTTTATTTCAGCCTGCTCACCTTATATAGTGACTGCTAATCCAAATCACAGCGCTTCAAAATCTGATGTAAAAGCAGAGAAAATTAAAAATTTATTTAACGAAGCACACACTACGGGTGTTTTAGTTATCCAACAAGGCCAAACTCAACAAAGCTATGGTAATGATCTTGCTCGTGCTTCGACCGAGTATGTACCTGCTTCGACCTTCAAAATGCTTAATGCTTTGATCGGCCTTGAGCACCATAAGGCAACCACCACAGAAGTATTTAAGTGGGATGGTAAAAAAAGGTTATTCCCAGAATGGGAAAAGGACATGACCCTAGGCGATGCCATGAAAGCTTCCGCTATTCCAGTTTATCAAGATTTAGCTCGTCGTATTGGACTTGAGCTCATGTCTAAGGAAGTGAAGCGTGTTGGTTATGGCAATGCAGATATCGGTACCCAAGTCGATAATTTTTGGCTGGTGGGTCCTTTAAAAATTACTCCTCAGCAAGAGGCACAGTTTGCTTACAAGCTAGCTAATAAAACGCTTCCATTTAGCCAAAAAGTCCAAGATGAAGTGCAATCCATGCTATTCATAGAAGAAAAGAATGGAAACAAAATATACGCAAAAAGTGGTTGGGGATGGGATGTAAACCCACAAGTAGGCTGGTTAACTGGATGGGTTGTTCAGCCTCAAGGGAATATTGTAGCGTTCTCCCTTAACTTAGAAATGAAAAAAGGAATACCTAG
gb|EU342351|+|172-1033|ARO:3001118|SHV-63 [Klebsiella pneumoniae] 	0	806	16	822	861	1612535+	806	ATGCGTTATATTCGCCTGTGTATTATCACCCTGTGAGCCACCCTGCCGCTGGCGGTACACGCCAGCCCGCAGCCGCTTGAGCAAATTAAACAAAGCGAAAGCCAGCTGTCGGGCCGCGTAGGCATGATAGAAATGGATCTGGCCAGCGGCCGCACGCTGACCGCCTGGCGCGCCGATGAACGCTTTCCCATGATGAGCACCTTTAAAGTAGTGCTCTGCGGCGCAGTGCTGGCGCGGGTGGATGCCGGTGACGAACAGCTGGAGCGAAAGATCCACTATCGCCAGCAGGATCTGGTGGACTACTCGCCGGTCAGCGAAAAACACCTTGCCGACGGCATGACGGTCGGCGAACTCTGCGCCGCCGCCATTACCATGAGCGATAACAGCGCCGCCAATCTGCTGCTGGCCACCGTCGGCGGCCCCGCAGGATTGACTGCCTTTTTGCGCCAGATCGGCGACAACGTCACCCGCCTTGACCGCTGGGAAACGGAACTGAATGAGGCGCTTCCCGGCGACGCCCGCGACACCACTACCCCGGCCAGCATGGCCGCGACCCTGCGCAAGCTGCTGACCAGCCAGCGTCTGAGCGCCCGTTCGCAACGGCAGCTGCTGCAGTGGATGGTGGACGATCGGGTCGCCGGACCGTTGATCCGCTCCGTGCTGCCGGCGGGCTGGTTTATCGCCGATAAGACCGGAGCTAGCAAGCGGGGTGCGCGCGGGATTGTCGCCCTGCTTGGCCCGAATAACAAAGCAGAGCGCATTGTGGTGATTTATCTGCGGGATACGCCGGCGAGCATGGCCGAGCG
gb|DQ303918|+|0-600|ARO:3002547|AAC(6')-Ib-cr [Escherichia coli] 	12	545	44	577	600	104606+	533	AAAACAAAGTTAGGCATCACAAAGTACAGCATCGTGACCAACAGCAACGATTCCGTCACACTGCGCCTCATGACTGAGCATGACCTTGCGATGCTCTATGAGTGGCTAAATCGATCTCATATCGTCGAGTGGTGGGGCGGAGAAGAAGCACGCCCGACACTTGCTGACGTACAGGAACAGTACTTGCCAAGCGTTTTAGCGCAAGAGTCCGTCACTCCATACATTGCAATGCTGAATGGAGAGCCGATTGGGTATGCCCAGTCGTACGTTGCTCTTGGAAGCGGGGACGGATGGTGGGAAGAAGAAACCGATCCAGGAGTACGCGGAATAGACCAGTCACTGGCGAATGCATCACAACTGGGCAAAGGCTTGGGAACCAAGCTGGTTCGAGCTCTGGTTGAGTTGCTGTTCAATGATCCCGAGGTCACCAAGATCCAAACGGACCCGTCGCCGAGCAACTTGCGAGCGATCCGATGCTACGAGAAAGCGGGGTTTGAGAGGCAAGGTACCGTAACCACCCCAGATGGTCCAGC
gb|EU255292.1|+|0-825|ARO:3001445|OXA-123 [Acinetobacter baumannii] 	0	770	54149	54919	825	246080-	770	ATGAACATTAAAGCACTCTTACTTATAACAAGCGCTATTTTTATTTCAGCCTGCTCACCTTATATAGTGACTGCTAATCCAAATCACAGCGCTTCAAAATCTGATGTAAAAGCAGAGAAAATTAAAAATTTATTTAACGAAGCACACACTACGGGTGTTTTAGTTATCCAACAAGGCCAAACTCAACAAAGCTATGGTAATGATCTTGCTCGTGCTTCGACCGAGTATGTACCTGCTTCGACCTTCAAAATGCTTAATGCTTTGATCGGCCTTGAGCACCATAAGGCAACCACCACAGAAGTATTTAAGTGGGATGGTAAAAAAAGGTTATTCCCAGAATGGGAAAAGGACATGACCCTAGGCGATGCCATGAAAGCTTCCGCTATTCCAGTTTATCAAGATTTAGCTCGTCGTATTGGACTTGAGCTCATGTCTAAGGAAGTGAAGCGTGTTGGTTATGGCAATGCAGATATCGGTACCCAAGTCGATAATTTTTGGCTGGTGGGTCCTTTAAAAATTACTCCTCAGCAAGAGGCACAGTTTGCTTACAAGCTAGCTAATAAAACGCTTCCATTTAGCCAAAAAGTCCAAGATGAAGTGCAATCCATGCTATTCATAGAAGAAAAGAATGGAAACAAAATATACGCAAAAAGTGGTTGGGGATGGGATGTAAACCCACAAGTAGGCTGGTTAACTGGATGGGTTGTTCAGCCTCAAGGGAATATTGTAGCGTTCTCCCTTAACTTAGAAATGAAAAAAGGAATACCTAG
gb|FJ666064|+|0-1194|ARO:3002498|PDC-2 [Pseudomonas aeruginosa] 	0	1139	35513	36652	1194	232416+	1139	ATGCGCGATACCAGATTCCCCTGCCTGTGCGGCATCGCCGCTTCCACACTGCTGTTCGCCACCACCCCGGCCATTGCCGATGAGGCCCCGGCGGATCGCCTGAAGGCACTGGTCGACGCCGCCGTACAACCGGTGATGAAGGCCAATGACATTCCGGGCCTGGCCGTAGCCATCAGCCTGAAAGGAGAACCGCATTACTTCAGCTATGGGCTGGCCTCGAAAGAGGACGGCCGCCGGGTGACGCCGGAGACCCTGTTCGAGATCGGCTCGGTGAGCAAGACCTTCACCGTCACCCTCGCCGGCTATGCCCTGGCCCAGGACAAGATGCGCCTCGACGACCGCGCCAGCCAGCACTGGCCGGCACTGCAGGGCAGCCGCTTCGACGGCATCAGCCTGCTCGACCTCGCGACCTATACCGCCGGCGGCTTGCCGCTGCAGTTCCCCGACTCGGTGCAGAAGGACCAGGCACAGATCCGCGACTACTACCGCCAGTGGCAGCCGACCTACGCGCCGGGCAGCCAGCGCCTCTATTCCAACCCGAGCATCGGCCTGTTCGGCTATCTCGCCGCGCGCAGCCTGGGCCAGCCGTTCGAACGGCTCATGGAGCAGCAATTGTTCCCGGCACTGGGCCTCGAACAGACCCACCTCGACGTGCCCGAGGCGGCGCTGGCGCAGTACGCCCAGGGCTACGGCAAGGACGACCGCCCGCTACGGGTCGGTCCCGGCCCGCTGGATGCCGAAGGCTACGGGGTGAAGACCAGCGCGGCCGACCTGCTGCGCTTCGTCGATGCCAACCTGCATCCGGAGCGCCTGGACAGGCCCTGGGCGCAGGCGCTCGATGCCACCCATCGCGGTTACTACAAGGTCGGCGACATGACCCAGGGCCTGGGCTGGGAAGCCTACGACTGGCCGATCTCCCTGAAGCGCCTGCAGGCCGGCAACTCGACGCCGATGGCGCTGCAACCACACAGGATCGCCAGGCTGCCCGCGCCACAGGCGCTGGAGGGCCAGCGCCTGCTGAACAAGACCGGCTCCACCAACGGCTTCGGCGCCTACGTGGCGTTCGTCCCGGGCCGCGACCTGGGCCTGGTGATCCTGGCCAACCGCAACTATCCCAATGCCGAGCGGGTGAAGATCGC
gb|EU255293.1|+|0-825|ARO:3001446|OXA-124 [Acinetobacter baumannii] 	0	770	54149	54919	825	246080-	770	ATGAACATTAAAGCACTCTTACTTATAACAAGCGCTATTTTTATTTCAGCCTGCTCACCTTATATAGTGACTGCTAATCCAAATCACAGCGCTTCAAAATCTGATGTAAAAGCAGAGAAAATTAAAAATTTATTTAACGAAGCACACACTACGGGTGTTTTAGTTATCCAACAAGGCCAAACTCAACAAAGCTATGGTAATGATCTTGCTCGTGCTTCGACCGAGTATGTACCTGCTTCGACCTTCAAAATGCTTAATGCTTTGATCGGCCTTGAGCACCATAAGGCAACCACCACAGAAGTATTTAAGTGGGATGGTAAAAAAAGGTTATTCCCAGAATGGGAAAAGGACATGACCCTAGGCGATGCCATGAAAGCTTCCGCTATTCCAGTTTATCAAGATTTAGCTCGTCGTATTGGACTTGAGCTCATGTCTAAGGAAGTGAAGCGTGTTGGTTATGGCAATGCAGATATCGGTACCCAAGTCGATAATTTTTGGCTGGTGGGTCCTTTAAAAATTACTCCTCAGCAAGAGGCACAGTTTGCTTACAAGCTAGCTAATAAAACGCTTCCATTTAGCCAAAAAGTCCAAGATGAAGTGCAATCCATGCTATTCATAGAAGAAAAGAATGGAAACAAAATATACGCAAAAAGTGGTTGGGGATGGGATGTAAACCCACAAGTAGGCTGGTTAACTGGATGGGTTGTTCAGCCTCAAGGGAATATTGTAGCGTTCTCCCTTAACTTAGAAATGAAAAAAGGAATACCTAG
gb|NG_049717.1|+|13-838|ARO:3003121|OXA-430 [Acinetobacter baumannii] 	0	770	54149	54919	825	246080-	770	ATGAACATTAAAGCACTCTTACTTATAACAAGCGCTATTTTTATTTCAGCCTGCTCACCTTATATAGTGACTGCTAATCCAAATCACAGCGCTTCAAAATCTGATGTAAAAGCAGAGAAAATTAAAAATTTATTTAACGAAGCACACACTACGGGTGTTTTAGTTATCCAACAAGGCCAAACTCAACAAAGCTATGGTAATGATCTTGCTCGTGCTTCGACCGAGTATGTACCTGCTTCGACCTTCAAAATGCTTAATGCTTTGATCGGCCTTGAGCACCATAAGGCAACCACCACAGAAGTATTTAAGTGGGATGGTAAAAAAAGGTTATTCCCAGAATGGGAAAAGGACATGACCCTAGGCGATGCCATGAAAGCTTCCGCTATTCCAGTTTATCAAGATTTAGCTCGTCGTATTGGACTTGAGCTCATGTCTAAGGAAGTGAAGCGTGTTGGTTATGGCAATGCAGATATCGGTACCCAAGTCGATAATTTTTGGCTGGTGGGTCCTTTAAAAATTACTCCTCAGCAAGAGGCACAGTTTGCTTACAAGCTAGCTAATAAAACGCTTCCATTTAGCCAAAAAGTCCAAGATGAAGTGCAATCCATGCTATTCATAGAAGAAAAGAATGGAAACAAAATATACGCAAAAAGTGGTTGGGGATGGGATGTAAACCCACAAGTAGGCTGGTTAACTGGATGGGTTGTTCAGCCTCAAGGGAATATTGTAGCGTTCTCCCTTAACTTAGAAATGAAAAAAGGAATACCTAG
gb|JQ808129|+|633-1188|ARO:3002546|AAC(6')-Ib [Klebsiella pneumoniae] 	0	500	77	577	555	104606+	500	GTGACCAACAGCAACGATTCCGTCACACTGCGCCTCATGACTGAGCATGACCTTGCGATGCTCTATGAGTGGCTAAATCGATCTCATATCGTCGAGTGGTGGGGCGGAGAAGAAGCACGCCCGACACTTGCTGACGTACAGGAACAGTACTTGCCAAGCGTTTTAGCGCAAGAGTCCGTCACTCCATACATTGCAATGCTGAATGGAGAGCCGATTGGGTATGCCCAGTCGTACGTTGCTCTTGGAAGCGGGGACGGATGGTGGGAAGAAGAAACCGATCCAGGAGTACGCGGAATAGACCAGTCACTGGCGAATGCATCACAACTGGGCAAAGGCTTGGGAACCAAGCTGGTTCGAGCTCTGGTTGAGTTGCTGTTCAATGATCCCGAGGTCACCAAGATCCAAACGGACCCGTCGCCGAGCAACTTGCGAGCGATCCGATGCTACGAGAAAGCGGGGTTTGAGAGGCAAGGTACCGTAACCACCCCAGATGGTCCAGC
gb|GQ390805|+|0-813|ARO:3001170|SHV-123 [Klebsiella pneumoniae] 	0	758	16	774	813	1612535+	758	ATGCGTTATATTCGCCTGTGTATTATCACCCTGTGAGCCACCCTGCCGCTGGCGGTACACGCCAGCCCGCAGCCGCTTGAGCAAATTAAACAAAGCGAAAGCCAGCTGTCGGGCCGCGTAGGCATGATAGAAATGGATCTGGCCAGCGGCCGCACGCTGACCGCCTGGCGCGCCGATGAACGCTTTCCCATGATGAGCACCTTTAAAGTAGTGCTCTGCGGCGCAGTGCTGGCGCGGGTGGATGCCGGTGACGAACAGCTGGAGCGAAAGATCCACTATCGCCAGCAGGATCTGGTGGACTACTCGCCGGTCAGCGAAAAACACCTTGCCGACGGCATGACGGTCGGCGAACTCTGCGCCGCCGCCATTACCATGAGCGATAACAGCGCCGCCAATCTGCTGCTGGCCACCGTCGGCGGCCCCGCAGGATTGACTGCCTTTTTGCGCCAGATCGGCGACAACGTCACCCGCCTTGACCGCTGGGAAACGGAACTGAATGAGGCGCTTCCCGGCGACGCCCGCGACACCACTACCCCGGCCAGCATGGCCGCGACCCTGCGCAAGCTGCTGACCAGCCAGCGTCTGAGCGCCCGTTCGCAACGGCAGCTGCTGCAGTGGATGGTGGACGATCGGGTCGCCGGACCGTTGATCCGCTCCGTGCTGCCGGCGGGCTGGTTTATCGCCGATAAGACCGGAGCTAGCAAGCGGGGTGCGCGCGGGATTGTCGCCCTGCTTGGCCCGAATAACAAAGCAGAGCG
gb|DQ174304|+|4-865|ARO:3001119|SHV-64 [Klebsiella pneumoniae] 	0	806	16	822	861	1612535+	806	ATGCGTTATATTCGCCTGTGTATTATCACCCTGTGAGCCACCCTGCCGCTGGCGGTACACGCCAGCCCGCAGCCGCTTGAGCAAATTAAACAAAGCGAAAGCCAGCTGTCGGGCCGCGTAGGCATGATAGAAATGGATCTGGCCAGCGGCCGCACGCTGACCGCCTGGCGCGCCGATGAACGCTTTCCCATGATGAGCACCTTTAAAGTAGTGCTCTGCGGCGCAGTGCTGGCGCGGGTGGATGCCGGTGACGAACAGCTGGAGCGAAAGATCCACTATCGCCAGCAGGATCTGGTGGACTACTCGCCGGTCAGCGAAAAACACCTTGCCGACGGCATGACGGTCGGCGAACTCTGCGCCGCCGCCATTACCATGAGCGATAACAGCGCCGCCAATCTGCTGCTGGCCACCGTCGGCGGCCCCGCAGGATTGACTGCCTTTTTGCGCCAGATCGGCGACAACGTCACCCGCCTTGACCGCTGGGAAACGGAACTGAATGAGGCGCTTCCCGGCGACGCCCGCGACACCACTACCCCGGCCAGCATGGCCGCGACCCTGCGCAAGCTGCTGACCAGCCAGCGTCTGAGCGCCCGTTCGCAACGGCAGCTGCTGCAGTGGATGGTGGACGATCGGGTCGCCGGACCGTTGATCCGCTCCGTGCTGCCGGCGGGCTGGTTTATCGCCGATAAGACCGGAGCTAGCAAGCGGGGTGCGCGCGGGATTGTCGCCCTGCTTGGCCCGAATAACAAAGCAGAGCGCATTGTGGTGATTTATCTGCGGGATACGCCGGCGAGCATGGCCGAGCG
gb|APQY01000006.1|+|416598-417423|ARO:3001719|OXA-263 [Acinetobacter baumannii NIPH 329] 	0	770	54149	54919	825	246080-	770	ATGAACATTAAAGCACTCTTACTTATAACAAGCGCTATTTTTATTTCAGCCTGCTCACCTTATATAGTGACTGCTAATCCAAATCACAGCGCTTCAAAATCTGATGTAAAAGCAGAGAAAATTAAAAATTTATTTAACGAAGCACACACTACGGGTGTTTTAGTTATCCAACAAGGCCAAACTCAACAAAGCTATGGTAATGATCTTGCTCGTGCTTCGACCGAGTATGTACCTGCTTCGACCTTCAAAATGCTTAATGCTTTGATCGGCCTTGAGCACCATAAGGCAACCACCACAGAAGTATTTAAGTGGGATGGTAAAAAAAGGTTATTCCCAGAATGGGAAAAGGACATGACCCTAGGCGATGCCATGAAAGCTTCCGCTATTCCAGTTTATCAAGATTTAGCTCGTCGTATTGGACTTGAGCTCATGTCTAAGGAAGTGAAGCGTGTTGGTTATGGCAATGCAGATATCGGTACCCAAGTCGATAATTTTTGGCTGGTGGGTCCTTTAAAAATTACTCCTCAGCAAGAGGCACAGTTTGCTTACAAGCTAGCTAATAAAACGCTTCCATTTAGCCAAAAAGTCCAAGATGAAGTGCAATCCATGCTATTCATAGAAGAAAAGAATGGAAACAAAATATACGCAAAAAGTGGTTGGGGATGGGATGTAAACCCACAAGTAGGCTGGTTAACTGGATGGGTTGTTCAGCCTCAAGGGAATATTGTAGCGTTCTCCCTTAACTTAGAAATGAAAAAAGGAATACCTAG
gb|EU255294.1|+|0-825|ARO:3001447|OXA-125 [Acinetobacter baumannii] 	0	770	54149	54919	825	246080-	770	ATGAACATTAAAGCACTCTTACTTATAACAAGCGCTATTTTTATTTCAGCCTGCTCACCTTATATAGTGACTGCTAATCCAAATCACAGCGCTTCAAAATCTGATGTAAAAGCAGAGAAAATTAAAAATTTATTTAACGAAGCACACACTACGGGTGTTTTAGTTATCCAACAAGGCCAAACTCAACAAAGCTATGGTAATGATCTTGCTCGTGCTTCGACCGAGTATGTACCTGCTTCGACCTTCAAAATGCTTAATGCTTTGATCGGCCTTGAGCACCATAAGGCAACCACCACAGAAGTATTTAAGTGGGATGGTAAAAAAAGGTTATTCCCAGAATGGGAAAAGGACATGACCCTAGGCGATGCCATGAAAGCTTCCGCTATTCCAGTTTATCAAGATTTAGCTCGTCGTATTGGACTTGAGCTCATGTCTAAGGAAGTGAAGCGTGTTGGTTATGGCAATGCAGATATCGGTACCCAAGTCGATAATTTTTGGCTGGTGGGTCCTTTAAAAATTACTCCTCAGCAAGAGGCACAGTTTGCTTACAAGCTAGCTAATAAAACGCTTCCATTTAGCCAAAAAGTCCAAGATGAAGTGCAATCCATGCTATTCATAGAAGAAAAGAATGGAAACAAAATATACGCAAAAAGTGGTTGGGGATGGGATGTAAACCCACAAGTAGGCTGGTTAACTGGATGGGTTGTTCAGCCTCAAGGGAATATTGTAGCGTTCTCCCTTAACTTAGAAATGAAAAAAGGAATACCTAG
gb|LN515533|+|0-867|ARO:3003154|SHV-187 [Klebsiella pneumoniae] 	0	812	10	822	867	1612535+	812	GTGGTTATGCGTTATATTCGCCTGTGTATTATCACCCTGTGAGCCACCCTGCCGCTGGCGGTACACGCCAGCCCGCAGCCGCTTGAGCAAATTAAACAAAGCGAAAGCCAGCTGTCGGGCCGCGTAGGCATGATAGAAATGGATCTGGCCAGCGGCCGCACGCTGACCGCCTGGCGCGCCGATGAACGCTTTCCCATGATGAGCACCTTTAAAGTAGTGCTCTGCGGCGCAGTGCTGGCGCGGGTGGATGCCGGTGACGAACAGCTGGAGCGAAAGATCCACTATCGCCAGCAGGATCTGGTGGACTACTCGCCGGTCAGCGAAAAACACCTTGCCGACGGCATGACGGTCGGCGAACTCTGCGCCGCCGCCATTACCATGAGCGATAACAGCGCCGCCAATCTGCTGCTGGCCACCGTCGGCGGCCCCGCAGGATTGACTGCCTTTTTGCGCCAGATCGGCGACAACGTCACCCGCCTTGACCGCTGGGAAACGGAACTGAATGAGGCGCTTCCCGGCGACGCCCGCGACACCACTACCCCGGCCAGCATGGCCGCGACCCTGCGCAAGCTGCTGACCAGCCAGCGTCTGAGCGCCCGTTCGCAACGGCAGCTGCTGCAGTGGATGGTGGACGATCGGGTCGCCGGACCGTTGATCCGCTCCGTGCTGCCGGCGGGCTGGTTTATCGCCGATAAGACCGGAGCTAGCAAGCGGGGTGCGCGCGGGATTGTCGCCCTGCTTGGCCCGAATAACAAAGCAGAGCGCATTGTGGTGATTTATCTGCGGGATACGCCGGCGAGCATGGCCGAGCG
gb|KM979378.1|+|14-839|ARO:3003124|OXA-431 [Acinetobacter baumannii] 	0	770	54149	54919	825	246080-	770	ATGAACATTAAAGCACTCTTACTTATAACAAGCGCTATTTTTATTTCAGCCTGCTCACCTTATATAGTGACTGCTAATCCAAATCACAGCGCTTCAAAATCTGATGTAAAAGCAGAGAAAATTAAAAATTTATTTAACGAAGCACACACTACGGGTGTTTTAGTTATCCAACAAGGCCAAACTCAACAAAGCTATGGTAATGATCTTGCTCGTGCTTCGACCGAGTATGTACCTGCTTCGACCTTCAAAATGCTTAATGCTTTGATCGGCCTTGAGCACCATAAGGCAACCACCACAGAAGTATTTAAGTGGGATGGTAAAAAAAGGTTATTCCCAGAATGGGAAAAGGACATGACCCTAGGCGATGCCATGAAAGCTTCCGCTATTCCAGTTTATCAAGATTTAGCTCGTCGTATTGGACTTGAGCTCATGTCTAAGGAAGTGAAGCGTGTTGGTTATGGCAATGCAGATATCGGTACCCAAGTCGATAATTTTTGGCTGGTGGGTCCTTTAAAAATTACTCCTCAGCAAGAGGCACAGTTTGCTTACAAGCTAGCTAATAAAACGCTTCCATTTAGCCAAAAAGTCCAAGATGAAGTGCAATCCATGCTATTCATAGAAGAAAAGAATGGAAACAAAATATACGCAAAAAGTGGTTGGGGATGGGATGTAAACCCACAAGTAGGCTGGTTAACTGGATGGGTTGTTCAGCCTCAAGGGAATATTGTAGCGTTCTCCCTTAACTTAGAAATGAAAAAAGGAATACCTAG
gb|U59183|+|247-859|ARO:3002581|AAC(6')-Ib10 [Pseudomonas aeruginosa] 	0	557	18	577	612	104606+	559	ATGTTACGCAGCAGGGCAGTCGCCCTAAAACAAAGTTAGGCATCACAAAGTACAGCATCGTGACCAACAGCAACGATTCCGTCACACTGCGCCTCATGACTGAGCATGACCTTGCGATGCTCTATGAGTGGCTAAATCGATCTCATATCGTCGAGTGGTGGGGCGGAGAAGAAGCACGCCCGACACTTGCTGACGTACAGGAACAGTACTTGCCAAGCGTTTTAGCGCAAGAGTCCGTCACTCCATACATTGCAATGCTGAATGGAGAGCCGATTGGGTATGCCCAGTCGTACGTTGCTCTTGGAAGCGGGGACGGATGGTGGGAAGAAGAAACCGATCCAGGAGTACGCGGAATAGACCAGTCACTGGCGAATGCATCACAACTGGGCAAAGGCTTGGGAACCAAGCTGGTTCGAGCTCTGGTTGAGTTGCTGTTCAATGATCCCGAGGTCACCAAGATCCAAACGGACCCGTCGCCGAGCAACTTGCGAGCGATCCGATGCTACGAGAAAGCGGGGTTTGAGAGGCAAGGTACCGTAACCACCCCAGATGGTCCAGC
gb|GQ390806|+|0-813|ARO:3001171|SHV-124 [Klebsiella pneumoniae] 	0	758	16	774	813	1612535+	758	ATGCGTTATATTCGCCTGTGTATTATCACCCTGTGAGCCACCCTGCCGCTGGCGGTACACGCCAGCCCGCAGCCGCTTGAGCAAATTAAACAAAGCGAAAGCCAGCTGTCGGGCCGCGTAGGCATGATAGAAATGGATCTGGCCAGCGGCCGCACGCTGACCGCCTGGCGCGCCGATGAACGCTTTCCCATGATGAGCACCTTTAAAGTAGTGCTCTGCGGCGCAGTGCTGGCGCGGGTGGATGCCGGTGACGAACAGCTGGAGCGAAAGATCCACTATCGCCAGCAGGATCTGGTGGACTACTCGCCGGTCAGCGAAAAACACCTTGCCGACGGCATGACGGTCGGCGAACTCTGCGCCGCCGCCATTACCATGAGCGATAACAGCGCCGCCAATCTGCTGCTGGCCACCGTCGGCGGCCCCGCAGGATTGACTGCCTTTTTGCGCCAGATCGGCGACAACGTCACCCGCCTTGACCGCTGGGAAACGGAACTGAATGAGGCGCTTCCCGGCGACGCCCGCGACACCACTACCCCGGCCAGCATGGCCGCGACCCTGCGCAAGCTGCTGACCAGCCAGCGTCTGAGCGCCCGTTCGCAACGGCAGCTGCTGCAGTGGATGGTGGACGATCGGGTCGCCGGACCGTTGATCCGCTCCGTGCTGCCGGCGGGCTGGTTTATCGCCGATAAGACCGGAGCTAGCAAGCGGGGTGCGCGCGGGATTGTCGCCCTGCTTGGCCCGAATAACAAAGCAGAGCG
gb|EU255295.1|+|0-825|ARO:3001448|OXA-126 [Acinetobacter baumannii] 	0	770	54149	54919	825	246080-	770	ATGAACATTAAAGCACTCTTACTTATAACAAGCGCTATTTTTATTTCAGCCTGCTCACCTTATATAGTGACTGCTAATCCAAATCACAGCGCTTCAAAATCTGATGTAAAAGCAGAGAAAATTAAAAATTTATTTAACGAAGCACACACTACGGGTGTTTTAGTTATCCAACAAGGCCAAACTCAACAAAGCTATGGTAATGATCTTGCTCGTGCTTCGACCGAGTATGTACCTGCTTCGACCTTCAAAATGCTTAATGCTTTGATCGGCCTTGAGCACCATAAGGCAACCACCACAGAAGTATTTAAGTGGGATGGTAAAAAAAGGTTATTCCCAGAATGGGAAAAGGACATGACCCTAGGCGATGCCATGAAAGCTTCCGCTATTCCAGTTTATCAAGATTTAGCTCGTCGTATTGGACTTGAGCTCATGTCTAAGGAAGTGAAGCGTGTTGGTTATGGCAATGCAGATATCGGTACCCAAGTCGATAATTTTTGGCTGGTGGGTCCTTTAAAAATTACTCCTCAGCAAGAGGCACAGTTTGCTTACAAGCTAGCTAATAAAACGCTTCCATTTAGCCAAAAAGTCCAAGATGAAGTGCAATCCATGCTATTCATAGAAGAAAAGAATGGAAACAAAATATACGCAAAAAGTGGTTGGGGATGGGATGTAAACCCACAAGTAGGCTGGTTAACTGGATGGGTTGTTCAGCCTCAAGGGAATATTGTAGCGTTCTCCCTTAACTTAGAAATGAAAAAAGGAATACCTAG
gb|KM979379.1|+|14-839|ARO:3003125|OXA-432 [Acinetobacter baumannii] 	0	770	54149	54919	825	246080-	770	ATGAACATTAAAGCACTCTTACTTATAACAAGCGCTATTTTTATTTCAGCCTGCTCACCTTATATAGTGACTGCTAATCCAAATCACAGCGCTTCAAAATCTGATGTAAAAGCAGAGAAAATTAAAAATTTATTTAACGAAGCACACACTACGGGTGTTTTAGTTATCCAACAAGGCCAAACTCAACAAAGCTATGGTAATGATCTTGCTCGTGCTTCGACCGAGTATGTACCTGCTTCGACCTTCAAAATGCTTAATGCTTTGATCGGCCTTGAGCACCATAAGGCAACCACCACAGAAGTATTTAAGTGGGATGGTAAAAAAAGGTTATTCCCAGAATGGGAAAAGGACATGACCCTAGGCGATGCCATGAAAGCTTCCGCTATTCCAGTTTATCAAGATTTAGCTCGTCGTATTGGACTTGAGCTCATGTCTAAGGAAGTGAAGCGTGTTGGTTATGGCAATGCAGATATCGGTACCCAAGTCGATAATTTTTGGCTGGTGGGTCCTTTAAAAATTACTCCTCAGCAAGAGGCACAGTTTGCTTACAAGCTAGCTAATAAAACGCTTCCATTTAGCCAAAAAGTCCAAGATGAAGTGCAATCCATGCTATTCATAGAAGAAAAGAATGGAAACAAAATATACGCAAAAAGTGGTTGGGGATGGGATGTAAACCCACAAGTAGGCTGGTTAACTGGATGGGTTGTTCAGCCTCAAGGGAATATTGTAGCGTTCTCCCTTAACTTAGAAATGAAAAAAGGAATACCTAG
gb|EU255296.1|+|0-825|ARO:3001449|OXA-127 [Acinetobacter baumannii] 	0	770	54149	54919	825	246080-	770	ATGAACATTAAAGCACTCTTACTTATAACAAGCGCTATTTTTATTTCAGCCTGCTCACCTTATATAGTGACTGCTAATCCAAATCACAGCGCTTCAAAATCTGATGTAAAAGCAGAGAAAATTAAAAATTTATTTAACGAAGCACACACTACGGGTGTTTTAGTTATCCAACAAGGCCAAACTCAACAAAGCTATGGTAATGATCTTGCTCGTGCTTCGACCGAGTATGTACCTGCTTCGACCTTCAAAATGCTTAATGCTTTGATCGGCCTTGAGCACCATAAGGCAACCACCACAGAAGTATTTAAGTGGGATGGTAAAAAAAGGTTATTCCCAGAATGGGAAAAGGACATGACCCTAGGCGATGCCATGAAAGCTTCCGCTATTCCAGTTTATCAAGATTTAGCTCGTCGTATTGGACTTGAGCTCATGTCTAAGGAAGTGAAGCGTGTTGGTTATGGCAATGCAGATATCGGTACCCAAGTCGATAATTTTTGGCTGGTGGGTCCTTTAAAAATTACTCCTCAGCAAGAGGCACAGTTTGCTTACAAGCTAGCTAATAAAACGCTTCCATTTAGCCAAAAAGTCCAAGATGAAGTGCAATCCATGCTATTCATAGAAGAAAAGAATGGAAACAAAATATACGCAAAAAGTGGTTGGGGATGGGATGTAAACCCACAAGTAGGCTGGTTAACTGGATGGGTTGTTCAGCCTCAAGGGAATATTGTAGCGTTCTCCCTTAACTTAGAAATGAAAAAAGGAATACCTAG
gb|LN515534|+|0-873|ARO:3003155|SHV-188 [Klebsiella pneumoniae] 	0	818	10	822	873	1612535+	812	GTGGTTATGCGTTATATTCGCCTGTGTATTATCACCCTGTGAGCCACCCTGCCGCTGGCGGTACACGCCAGCCCGCAGCCGCTTGAGCAAATTAAACAAAGCGAAAGCCAGCTGTCGGGCCGCGTAGGCATGATAGAAATGGATCTGGCCAGCGGCCGCACGCTGACCGCCTGGCGCGCCGATGAACGCTTTCCCATGATGAGCACCTTTAAAGTAGTGCTCTGCGGCGCAGTGCTGGCGCGGGTGGATGCCGGTGACGAACAGCTGGAGCGAAAGATCCACTATCGCCAGCAGGATCTGGTGGACTACTCGCCGGTCAGCGAAAAACACCTTGCCGACGGCATGACGGTCGGCGAACTCTGCGCCGCCGCCATTACCATGAGCGATAACAGCGCCGCCAATCTGCTGCTGGCCACCGTCGGCGGCCCCGCAGGATTGACTGCCTTTTTGCGCCAGATCGGCGACAACGTCACCCGCCTTGACCGCTGGGAAACGGAACTGAATGAGGCGCTTCCCGGCGACGCCCGCGACACCACTACCCCGGCCAGCATGGCCGCGACCCTGCGCAAGCTGCTGACCAGCCAGCGTCTGAGCGCCCGTTCGCAACGGCAGCTGCTGCAGTGGATGGTGGACGATCGGGTCGCCGGACCGTTGATCCGCTCCGTGCTGCCGGCGGGCTGGTTTATCGCCGATAAGACCGGAGCTAGCAAGCGGGGTGCGCGCGGGATTGTCGCCCTGCTTGGCCCGAATAACAAAGCAGAGCGCATTGTGGTGATTTATCTGCGGGATACGCCGGCGAGCATGGCCGAGCG
gb|GQ390807|+|0-813|ARO:3001172|SHV-125 [Klebsiella pneumoniae] 	0	758	16	774	813	1612535+	758	ATGCGTTATATTCGCCTGTGTATTATCACCCTGTGAGCCACCCTGCCGCTGGCGGTACACGCCAGCCCGCAGCCGCTTGAGCAAATTAAACAAAGCGAAAGCCAGCTGTCGGGCCGCGTAGGCATGATAGAAATGGATCTGGCCAGCGGCCGCACGCTGACCGCCTGGCGCGCCGATGAACGCTTTCCCATGATGAGCACCTTTAAAGTAGTGCTCTGCGGCGCAGTGCTGGCGCGGGTGGATGCCGGTGACGAACAGCTGGAGCGAAAGATCCACTATCGCCAGCAGGATCTGGTGGACTACTCGCCGGTCAGCGAAAAACACCTTGCCGACGGCATGACGGTCGGCGAACTCTGCGCCGCCGCCATTACCATGAGCGATAACAGCGCCGCCAATCTGCTGCTGGCCACCGTCGGCGGCCCCGCAGGATTGACTGCCTTTTTGCGCCAGATCGGCGACAACGTCACCCGCCTTGACCGCTGGGAAACGGAACTGAATGAGGCGCTTCCCGGCGACGCCCGCGACACCACTACCCCGGCCAGCATGGCCGCGACCCTGCGCAAGCTGCTGACCAGCCAGCGTCTGAGCGCCCGTTCGCAACGGCAGCTGCTGCAGTGGATGGTGGACGATCGGGTCGCCGGACCGTTGATCCGCTCCGTGCTGCCGGCGGGCTGGTTTATCGCCGATAAGACCGGAGCTAGCAAGCGGGGTGCGCGCGGGATTGTCGCCCTGCTTGGCCCGAATAACAAAGCAGAGCG
gb|KM979380.1|+|25-850|ARO:3003126|OXA-433 [Acinetobacter baumannii] 	0	770	54149	54919	825	246080-	770	ATGAACATTAAAGCACTCTTACTTATAACAAGCGCTATTTTTATTTCAGCCTGCTCACCTTATATAGTGACTGCTAATCCAAATCACAGCGCTTCAAAATCTGATGTAAAAGCAGAGAAAATTAAAAATTTATTTAACGAAGCACACACTACGGGTGTTTTAGTTATCCAACAAGGCCAAACTCAACAAAGCTATGGTAATGATCTTGCTCGTGCTTCGACCGAGTATGTACCTGCTTCGACCTTCAAAATGCTTAATGCTTTGATCGGCCTTGAGCACCATAAGGCAACCACCACAGAAGTATTTAAGTGGGATGGTAAAAAAAGGTTATTCCCAGAATGGGAAAAGGACATGACCCTAGGCGATGCCATGAAAGCTTCCGCTATTCCAGTTTATCAAGATTTAGCTCGTCGTATTGGACTTGAGCTCATGTCTAAGGAAGTGAAGCGTGTTGGTTATGGCAATGCAGATATCGGTACCCAAGTCGATAATTTTTGGCTGGTGGGTCCTTTAAAAATTACTCCTCAGCAAGAGGCACAGTTTGCTTACAAGCTAGCTAATAAAACGCTTCCATTTAGCCAAAAAGTCCAAGATGAAGTGCAATCCATGCTATTCATAGAAGAAAAGAATGGAAACAAAATATACGCAAAAAGTGGTTGGGGATGGGATGTAAACCCACAAGTAGGCTGGTTAACTGGATGGGTTGTTCAGCCTCAAGGGAATATTGTAGCGTTCTCCCTTAACTTAGAAATGAAAAAAGGAATACCTAG
gb|DQ174305|+|4-865|ARO:3001120|SHV-65 [Klebsiella pneumoniae] 	0	806	16	822	861	1612535+	806	ATGCGTTATATTCGCCTGTGTATTATCACCCTGTGAGCCACCCTGCCGCTGGCGGTACACGCCAGCCCGCAGCCGCTTGAGCAAATTAAACAAAGCGAAAGCCAGCTGTCGGGCCGCGTAGGCATGATAGAAATGGATCTGGCCAGCGGCCGCACGCTGACCGCCTGGCGCGCCGATGAACGCTTTCCCATGATGAGCACCTTTAAAGTAGTGCTCTGCGGCGCAGTGCTGGCGCGGGTGGATGCCGGTGACGAACAGCTGGAGCGAAAGATCCACTATCGCCAGCAGGATCTGGTGGACTACTCGCCGGTCAGCGAAAAACACCTTGCCGACGGCATGACGGTCGGCGAACTCTGCGCCGCCGCCATTACCATGAGCGATAACAGCGCCGCCAATCTGCTGCTGGCCACCGTCGGCGGCCCCGCAGGATTGACTGCCTTTTTGCGCCAGATCGGCGACAACGTCACCCGCCTTGACCGCTGGGAAACGGAACTGAATGAGGCGCTTCCCGGCGACGCCCGCGACACCACTACCCCGGCCAGCATGGCCGCGACCCTGCGCAAGCTGCTGACCAGCCAGCGTCTGAGCGCCCGTTCGCAACGGCAGCTGCTGCAGTGGATGGTGGACGATCGGGTCGCCGGACCGTTGATCCGCTCCGTGCTGCCGGCGGGCTGGTTTATCGCCGATAAGACCGGAGCTAGCAAGCGGGGTGCGCGCGGGATTGTCGCCCTGCTTGGCCCGAATAACAAAGCAGAGCGCATTGTGGTGATTTATCTGCGGGATACGCCGGCGAGCATGGCCGAGCG
gb|AF201828.2|+|115-937|ARO:3001422|OXA-27 [Acinetobacter baumannii] 	0	767	80	847	822	254088-	767	ATGAATAAATATTTTACTTGCTATGTGGTTGCTTCTCTTTTTCTTTCTGGTTGTACGGTTCAGCATAATTTAATAAATGAAACCCCGAGTCAGATTGTTCAAGGACATAATCAGGTGATTCATCAATACTTTGATGAAAAAAACACCTCAGGTGTGCTGGTTATTCAAACAGATAAAAAAATTAATCTATATGGTAATGCTCTAAGCCGCGCAAATACAGAATATGTGCCAGCCTCTACATTTAAAATGTTGAATGCCCTGATCGGATTGGAGAACCAGAAAACGGATATTAATGAAATATTTAAATGGAAGGGCGAGAAAAGGTCATTTACCGCTTGGGAAAAAGACATGACACTAGGAGAAGCCATGAAGCTTTCTGCAGTCCCAGTCTATCAGGAACTTGCGCGACGTATCGGTCTTGATCTCATGCAAAAAGAAGTAAAACGTATTGGTTTCGGTAATGCTGAAATTGGACAGCAGGTTGATAATTTCTGGTTGGTAGGACCATTAAAGGTTACGCCTATTCAAGAGGTAGAGTTTGTTTCCCAATTAGCACATACACAGCTTCCATTTAGTGAAAAAGTGCAGGCTAATGTAAAAAATATGCTTCTTTTAGAAGAGAGTAATGGCTACAAAATTTTTGGAAAGACTGGTTGGGCAATGGATATAAAACCACAAGTGGGCTGGTTGACCGGCTGGGTTGAGCAGCCAGATGGAAAAATTGTCGCTTTTGCATTAAATATGGAAATGCGGTCAGAAATGCCGGC
gb|AY136758|+|377-947|ARO:3002582|AAC(6')-Ib11 [Salmonella enterica subsp. enterica serovar Typhimurium] 	20	515	82	577	570	104606+	495	CAACAGCAACGATTCCGTCACACTGCGCCTCATGACTGAGCATGACCTTGCGATGCTCTATGAGTGGCTAAATCGATCTCATATCGTCGAGTGGTGGGGCGGAGAAGAAGCACGCCCGACACTTGCTGACGTACAGGAACAGTACTTGCCAAGCGTTTTAGCGCAAGAGTCCGTCACTCCATACATTGCAATGCTGAATGGAGAGCCGATTGGGTATGCCCAGTCGTACGTTGCTCTTGGAAGCGGGGACGGATGGTGGGAAGAAGAAACCGATCCAGGAGTACGCGGAATAGACCAGTCACTGGCGAATGCATCACAACTGGGCAAAGGCTTGGGAACCAAGCTGGTTCGAGCTCTGGTTGAGTTGCTGTTCAATGATCCCGAGGTCACCAAGATCCAAACGGACCCGTCGCCGAGCAACTTGCGAGCGATCCGATGCTACGAGAAAGCGGGGTTTGAGAGGCAAGGTACCGTAACCACCCCAGATGGTCCAGC
gb|KP144324|+|0-822|ARO:3003162|OXA-435 [Acinetobacter baumannii] 	0	767	80	847	822	254088-	767	ATGAATAAATATTTTACTTGCTATGTGGTTGCTTCTCTTTTTCTTTCTGGTTGTACGGTTCAGCATAATTTAATAAATGAAACCCCGAGTCAGATTGTTCAAGGACATAATCAGGTGATTCATCAATACTTTGATGAAAAAAACACCTCAGGTGTGCTGGTTATTCAAACAGATAAAAAAATTAATCTATATGGTAATGCTCTAAGCCGCGCAAATACAGAATATGTGCCAGCCTCTACATTTAAAATGTTGAATGCCCTGATCGGATTGGAGAACCAGAAAACGGATATTAATGAAATATTTAAATGGAAGGGCGAGAAAAGGTCATTTACCGCTTGGGAAAAAGACATGACACTAGGAGAAGCCATGAAGCTTTCTGCAGTCCCAGTCTATCAGGAACTTGCGCGACGTATCGGTCTTGATCTCATGCAAAAAGAAGTAAAACGTATTGGTTTCGGTAATGCTGAAATTGGACAGCAGGTTGATAATTTCTGGTTGGTAGGACCATTAAAGGTTACGCCTATTCAAGAGGTAGAGTTTGTTTCCCAATTAGCACATACACAGCTTCCATTTAGTGAAAAAGTGCAGGCTAATGTAAAAAATATGCTTCTTTTAGAAGAGAGTAATGGCTACAAAATTTTTGGAAAGACTGGTTGGGCAATGGATATAAAACCACAAGTGGGCTGGTTGACCGGCTGGGTTGAGCAGCCAGATGGAAAAATTGTCGCTTTTGCATTAAATATGGAAATGCGGTCAGAAATGCCGGC
gb|EU375515|+|0-825|ARO:3001648|OXA-128 [Acinetobacter baumannii] 	0	770	54149	54919	825	246080-	770	ATGAACATTAAAGCACTCTTACTTATAACAAGCGCTATTTTTATTTCAGCCTGCTCACCTTATATAGTGACTGCTAATCCAAATCACAGCGCTTCAAAATCTGATGTAAAAGCAGAGAAAATTAAAAATTTATTTAACGAAGCACACACTACGGGTGTTTTAGTTATCCAACAAGGCCAAACTCAACAAAGCTATGGTAATGATCTTGCTCGTGCTTCGACCGAGTATGTACCTGCTTCGACCTTCAAAATGCTTAATGCTTTGATCGGCCTTGAGCACCATAAGGCAACCACCACAGAAGTATTTAAGTGGGATGGTAAAAAAAGGTTATTCCCAGAATGGGAAAAGGACATGACCCTAGGCGATGCCATGAAAGCTTCCGCTATTCCAGTTTATCAAGATTTAGCTCGTCGTATTGGACTTGAGCTCATGTCTAAGGAAGTGAAGCGTGTTGGTTATGGCAATGCAGATATCGGTACCCAAGTCGATAATTTTTGGCTGGTGGGTCCTTTAAAAATTACTCCTCAGCAAGAGGCACAGTTTGCTTACAAGCTAGCTAATAAAACGCTTCCATTTAGCCAAAAAGTCCAAGATGAAGTGCAATCCATGCTATTCATAGAAGAAAAGAATGGAAACAAAATATACGCAAAAAGTGGTTGGGGATGGGATGTAAACCCACAAGTAGGCTGGTTAACTGGATGGGTTGTTCAGCCTCAAGGGAATATTGTAGCGTTCTCCCTTAACTTAGAAATGAAAAAAGGAATACCTAG
gb|FJ666066|+|0-1194|ARO:3002500|PDC-3 [Pseudomonas aeruginosa] 	0	1139	35513	36652	1194	232416+	1139	ATGCGCGATACCAGATTCCCCTGCCTGTGCGGCATCGCCGCTTCCACACTGCTGTTCGCCACCACCCCGGCCATTGCCGATGAGGCCCCGGCGGATCGCCTGAAGGCACTGGTCGACGCCGCCGTACAACCGGTGATGAAGGCCAATGACATTCCGGGCCTGGCCGTAGCCATCAGCCTGAAAGGAGAACCGCATTACTTCAGCTATGGGCTGGCCTCGAAAGAGGACGGCCGCCGGGTGACGCCGGAGACCCTGTTCGAGATCGGCTCGGTGAGCAAGACCTTCACCGTCACCCTCGCCGGCTATGCCCTGGCCCAGGACAAGATGCGCCTCGACGACCGCGCCAGCCAGCACTGGCCGGCACTGCAGGGCAGCCGCTTCGACGGCATCAGCCTGCTCGACCTCGCGACCTATACCGCCGGCGGCTTGCCGCTGCAGTTCCCCGACTCGGTGCAGAAGGACCAGGCACAGATCCGCGACTACTACCGCCAGTGGCAGCCGACCTACGCGCCGGGCAGCCAGCGCCTCTATTCCAACCCGAGCATCGGCCTGTTCGGCTATCTCGCCGCGCGCAGCCTGGGCCAGCCGTTCGAACGGCTCATGGAGCAGCAATTGTTCCCGGCACTGGGCCTCGAACAGACCCACCTCGACGTGCCCGAGGCGGCGCTGGCGCAGTACGCCCAGGGCTACGGCAAGGACGACCGCCCGCTACGGGTCGGTCCCGGCCCGCTGGATGCCGAAGGCTACGGGGTGAAGACCAGCGCGGCCGACCTGCTGCGCTTCGTCGATGCCAACCTGCATCCGGAGCGCCTGGACAGGCCCTGGGCGCAGGCGCTCGATGCCACCCATCGCGGTTACTACAAGGTCGGCGACATGACCCAGGGCCTGGGCTGGGAAGCCTACGACTGGCCGATCTCCCTGAAGCGCCTGCAGGCCGGCAACTCGACGCCGATGGCGCTGCAACCACACAGGATCGCCAGGCTGCCCGCGCCACAGGCGCTGGAGGGCCAGCGCCTGCTGAACAAGACCGGCTCCACCAACGGCTTCGGCGCCTACGTGGCGTTCGTCCCGGGCCGCGACCTGGGCCTGGTGATCCTGGCCAACCGCAACTATCCCAATGCCGAGCGGGTGAAGATCGC
gb|KP050494|+|0-861|ARO:3003156|SHV-189 [Klebsiella pneumoniae] 	0	806	16	822	861	1612535+	806	ATGCGTTATATTCGCCTGTGTATTATCACCCTGTGAGCCACCCTGCCGCTGGCGGTACACGCCAGCCCGCAGCCGCTTGAGCAAATTAAACAAAGCGAAAGCCAGCTGTCGGGCCGCGTAGGCATGATAGAAATGGATCTGGCCAGCGGCCGCACGCTGACCGCCTGGCGCGCCGATGAACGCTTTCCCATGATGAGCACCTTTAAAGTAGTGCTCTGCGGCGCAGTGCTGGCGCGGGTGGATGCCGGTGACGAACAGCTGGAGCGAAAGATCCACTATCGCCAGCAGGATCTGGTGGACTACTCGCCGGTCAGCGAAAAACACCTTGCCGACGGCATGACGGTCGGCGAACTCTGCGCCGCCGCCATTACCATGAGCGATAACAGCGCCGCCAATCTGCTGCTGGCCACCGTCGGCGGCCCCGCAGGATTGACTGCCTTTTTGCGCCAGATCGGCGACAACGTCACCCGCCTTGACCGCTGGGAAACGGAACTGAATGAGGCGCTTCCCGGCGACGCCCGCGACACCACTACCCCGGCCAGCATGGCCGCGACCCTGCGCAAGCTGCTGACCAGCCAGCGTCTGAGCGCCCGTTCGCAACGGCAGCTGCTGCAGTGGATGGTGGACGATCGGGTCGCCGGACCGTTGATCCGCTCCGTGCTGCCGGCGGGCTGGTTTATCGCCGATAAGACCGGAGCTAGCAAGCGGGGTGCGCGCGGGATTGTCGCCCTGCTTGGCCCGAATAACAAAGCAGAGCGCATTGTGGTGATTTATCTGCGGGATACGCCGGCGAGCATGGCCGAGCG
gb|GQ390808|+|0-813|ARO:3001173|SHV-126 [Escherichia coli] 	0	758	16	774	813	1612535+	758	ATGCGTTATATTCGCCTGTGTATTATCACCCTGTGAGCCACCCTGCCGCTGGCGGTACACGCCAGCCCGCAGCCGCTTGAGCAAATTAAACAAAGCGAAAGCCAGCTGTCGGGCCGCGTAGGCATGATAGAAATGGATCTGGCCAGCGGCCGCACGCTGACCGCCTGGCGCGCCGATGAACGCTTTCCCATGATGAGCACCTTTAAAGTAGTGCTCTGCGGCGCAGTGCTGGCGCGGGTGGATGCCGGTGACGAACAGCTGGAGCGAAAGATCCACTATCGCCAGCAGGATCTGGTGGACTACTCGCCGGTCAGCGAAAAACACCTTGCCGACGGCATGACGGTCGGCGAACTCTGCGCCGCCGCCATTACCATGAGCGATAACAGCGCCGCCAATCTGCTGCTGGCCACCGTCGGCGGCCCCGCAGGATTGACTGCCTTTTTGCGCCAGATCGGCGACAACGTCACCCGCCTTGACCGCTGGGAAACGGAACTGAATGAGGCGCTTCCCGGCGACGCCCGCGACACCACTACCCCGGCCAGCATGGCCGCGACCCTGCGCAAGCTGCTGACCAGCCAGCGTCTGAGCGCCCGTTCGCAACGGCAGCTGCTGCAGTGGATGGTGGACGATCGGGTCGCCGGACCGTTGATCCGCTCCGTGCTGCCGGCGGGCTGGTTTATCGCCGATAAGACCGGAGCTAGCAAGCGGGGTGCGCGCGGGATTGTCGCCCTGCTTGGCCCGAATAACAAAGCAGAGCG
gb|KP727574.1|+|0-822|ARO:3003596|OXA-440 [Acinetobacter baumannii] 	0	767	80	847	822	254088-	767	ATGAATAAATATTTTACTTGCTATGTGGTTGCTTCTCTTTTTCTTTCTGGTTGTACGGTTCAGCATAATTTAATAAATGAAACCCCGAGTCAGATTGTTCAAGGACATAATCAGGTGATTCATCAATACTTTGATGAAAAAAACACCTCAGGTGTGCTGGTTATTCAAACAGATAAAAAAATTAATCTATATGGTAATGCTCTAAGCCGCGCAAATACAGAATATGTGCCAGCCTCTACATTTAAAATGTTGAATGCCCTGATCGGATTGGAGAACCAGAAAACGGATATTAATGAAATATTTAAATGGAAGGGCGAGAAAAGGTCATTTACCGCTTGGGAAAAAGACATGACACTAGGAGAAGCCATGAAGCTTTCTGCAGTCCCAGTCTATCAGGAACTTGCGCGACGTATCGGTCTTGATCTCATGCAAAAAGAAGTAAAACGTATTGGTTTCGGTAATGCTGAAATTGGACAGCAGGTTGATAATTTCTGGTTGGTAGGACCATTAAAGGTTACGCCTATTCAAGAGGTAGAGTTTGTTTCCCAATTAGCACATACACAGCTTCCATTTAGTGAAAAAGTGCAGGCTAATGTAAAAAATATGCTTCTTTTAGAAGAGAGTAATGGCTACAAAATTTTTGGAAAGACTGGTTGGGCAATGGATATAAAACCACAAGTGGGCTGGTTGACCGGCTGGGTTGAGCAGCCAGATGGAAAAATTGTCGCTTTTGCATTAAATATGGAAATGCGGTCAGAAATGCCGGC
gb|FJ854362|+|1702-2257|ARO:3002576|AAC(6')-Ib3 [Acinetobacter baumannii] 	0	500	77	577	555	104606+	500	GTGACCAACAGCAACGATTCCGTCACACTGCGCCTCATGACTGAGCATGACCTTGCGATGCTCTATGAGTGGCTAAATCGATCTCATATCGTCGAGTGGTGGGGCGGAGAAGAAGCACGCCCGACACTTGCTGACGTACAGGAACAGTACTTGCCAAGCGTTTTAGCGCAAGAGTCCGTCACTCCATACATTGCAATGCTGAATGGAGAGCCGATTGGGTATGCCCAGTCGTACGTTGCTCTTGGAAGCGGGGACGGATGGTGGGAAGAAGAAACCGATCCAGGAGTACGCGGAATAGACCAGTCACTGGCGAATGCATCACAACTGGGCAAAGGCTTGGGAACCAAGCTGGTTCGAGCTCTGGTTGAGTTGCTGTTCAATGATCCCGAGGTCACCAAGATCCAAACGGACCCGTCGCCGAGCAACTTGCGAGCGATCCGATGCTACGAGAAAGCGGGGTTTGAGAGGCAAGGTACCGTAACCACCCCAGATGGTCCAGC
gb|DQ174306|+|4-865|ARO:3001121|SHV-66 [Klebsiella pneumoniae] 	0	806	16	822	861	1612535+	806	ATGCGTTATATTCGCCTGTGTATTATCACCCTGTGAGCCACCCTGCCGCTGGCGGTACACGCCAGCCCGCAGCCGCTTGAGCAAATTAAACAAAGCGAAAGCCAGCTGTCGGGCCGCGTAGGCATGATAGAAATGGATCTGGCCAGCGGCCGCACGCTGACCGCCTGGCGCGCCGATGAACGCTTTCCCATGATGAGCACCTTTAAAGTAGTGCTCTGCGGCGCAGTGCTGGCGCGGGTGGATGCCGGTGACGAACAGCTGGAGCGAAAGATCCACTATCGCCAGCAGGATCTGGTGGACTACTCGCCGGTCAGCGAAAAACACCTTGCCGACGGCATGACGGTCGGCGAACTCTGCGCCGCCGCCATTACCATGAGCGATAACAGCGCCGCCAATCTGCTGCTGGCCACCGTCGGCGGCCCCGCAGGATTGACTGCCTTTTTGCGCCAGATCGGCGACAACGTCACCCGCCTTGACCGCTGGGAAACGGAACTGAATGAGGCGCTTCCCGGCGACGCCCGCGACACCACTACCCCGGCCAGCATGGCCGCGACCCTGCGCAAGCTGCTGACCAGCCAGCGTCTGAGCGCCCGTTCGCAACGGCAGCTGCTGCAGTGGATGGTGGACGATCGGGTCGCCGGACCGTTGATCCGCTCCGTGCTGCCGGCGGGCTGGTTTATCGCCGATAAGACCGGAGCTAGCAAGCGGGGTGCGCGCGGGATTGTCGCCCTGCTTGGCCCGAATAACAAAGCAGAGCGCATTGTGGTGATTTATCTGCGGGATACGCCGGCGAGCATGGCCGAGCG
gb|AF445082|+|2788-3343|ARO:3002577|AAC(6')-Ib4 [Acinetobacter baumannii] 	0	500	77	577	555	104606+	500	GTGACCAACAGCAACGATTCCGTCACACTGCGCCTCATGACTGAGCATGACCTTGCGATGCTCTATGAGTGGCTAAATCGATCTCATATCGTCGAGTGGTGGGGCGGAGAAGAAGCACGCCCGACACTTGCTGACGTACAGGAACAGTACTTGCCAAGCGTTTTAGCGCAAGAGTCCGTCACTCCATACATTGCAATGCTGAATGGAGAGCCGATTGGGTATGCCCAGTCGTACGTTGCTCTTGGAAGCGGGGACGGATGGTGGGAAGAAGAAACCGATCCAGGAGTACGCGGAATAGACCAGTCACTGGCGAATGCATCACAACTGGGCAAAGGCTTGGGAACCAAGCTGGTTCGAGCTCTGGTTGAGTTGCTGTTCAATGATCCCGAGGTCACCAAGATCCAAACGGACCCGTCGCCGAGCAACTTGCGAGCGATCCGATGCTACGAGAAAGCGGGGTTTGAGAGGCAAGGTACCGTAACCACCCCAGATGGTCCAGC
gb|AF117743|+|0-780|ARO:3001077|SHV-19 [Klebsiella pneumoniae] 	5	725	51	771	780	1612535+	720	AGCCACCCTGCCGCTGGCGGTACACGCCAGCCCGCAGCCGCTTGAGCAAATTAAACAAAGCGAAAGCCAGCTGTCGGGCCGCGTAGGCATGATAGAAATGGATCTGGCCAGCGGCCGCACGCTGACCGCCTGGCGCGCCGATGAACGCTTTCCCATGATGAGCACCTTTAAAGTAGTGCTCTGCGGCGCAGTGCTGGCGCGGGTGGATGCCGGTGACGAACAGCTGGAGCGAAAGATCCACTATCGCCAGCAGGATCTGGTGGACTACTCGCCGGTCAGCGAAAAACACCTTGCCGACGGCATGACGGTCGGCGAACTCTGCGCCGCCGCCATTACCATGAGCGATAACAGCGCCGCCAATCTGCTGCTGGCCACCGTCGGCGGCCCCGCAGGATTGACTGCCTTTTTGCGCCAGATCGGCGACAACGTCACCCGCCTTGACCGCTGGGAAACGGAACTGAATGAGGCGCTTCCCGGCGACGCCCGCGACACCACTACCCCGGCCAGCATGGCCGCGACCCTGCGCAAGCTGCTGACCAGCCAGCGTCTGAGCGCCCGTTCGCAACGGCAGCTGCTGCAGTGGATGGTGGACGATCGGGTCGCCGGACCGTTGATCCGCTCCGTGCTGCCGGCGGGCTGGTTTATCGCCGATAAGACCGGAGCTAGCAAGCGGGGTGCGCGCGGGATTGTCGCCCTGCTTGGCCCGAATAACAAAGCAGA
gb|GQ390809|+|0-813|ARO:3001174|SHV-127 [Klebsiella pneumoniae] 	0	758	16	774	813	1612535+	758	ATGCGTTATATTCGCCTGTGTATTATCACCCTGTGAGCCACCCTGCCGCTGGCGGTACACGCCAGCCCGCAGCCGCTTGAGCAAATTAAACAAAGCGAAAGCCAGCTGTCGGGCCGCGTAGGCATGATAGAAATGGATCTGGCCAGCGGCCGCACGCTGACCGCCTGGCGCGCCGATGAACGCTTTCCCATGATGAGCACCTTTAAAGTAGTGCTCTGCGGCGCAGTGCTGGCGCGGGTGGATGCCGGTGACGAACAGCTGGAGCGAAAGATCCACTATCGCCAGCAGGATCTGGTGGACTACTCGCCGGTCAGCGAAAAACACCTTGCCGACGGCATGACGGTCGGCGAACTCTGCGCCGCCGCCATTACCATGAGCGATAACAGCGCCGCCAATCTGCTGCTGGCCACCGTCGGCGGCCCCGCAGGATTGACTGCCTTTTTGCGCCAGATCGGCGACAACGTCACCCGCCTTGACCGCTGGGAAACGGAACTGAATGAGGCGCTTCCCGGCGACGCCCGCGACACCACTACCCCGGCCAGCATGGCCGCGACCCTGCGCAAGCTGCTGACCAGCCAGCGTCTGAGCGCCCGTTCGCAACGGCAGCTGCTGCAGTGGATGGTGGACGATCGGGTCGCCGGACCGTTGATCCGCTCCGTGCTGCCGGCGGGCTGGTTTATCGCCGATAAGACCGGAGCTAGCAAGCGGGGTGCGCGCGGGATTGTCGCCCTGCTTGGCCCGAATAACAAAGCAGAGCG
gb|JX865394.1|+|0-825|ARO:3003597|OXA-441 [Acinetobacter baumannii] 	0	770	54149	54919	825	246080-	770	ATGAACATTAAAGCACTCTTACTTATAACAAGCGCTATTTTTATTTCAGCCTGCTCACCTTATATAGTGACTGCTAATCCAAATCACAGCGCTTCAAAATCTGATGTAAAAGCAGAGAAAATTAAAAATTTATTTAACGAAGCACACACTACGGGTGTTTTAGTTATCCAACAAGGCCAAACTCAACAAAGCTATGGTAATGATCTTGCTCGTGCTTCGACCGAGTATGTACCTGCTTCGACCTTCAAAATGCTTAATGCTTTGATCGGCCTTGAGCACCATAAGGCAACCACCACAGAAGTATTTAAGTGGGATGGTAAAAAAAGGTTATTCCCAGAATGGGAAAAGGACATGACCCTAGGCGATGCCATGAAAGCTTCCGCTATTCCAGTTTATCAAGATTTAGCTCGTCGTATTGGACTTGAGCTCATGTCTAAGGAAGTGAAGCGTGTTGGTTATGGCAATGCAGATATCGGTACCCAAGTCGATAATTTTTGGCTGGTGGGTCCTTTAAAAATTACTCCTCAGCAAGAGGCACAGTTTGCTTACAAGCTAGCTAATAAAACGCTTCCATTTAGCCAAAAAGTCCAAGATGAAGTGCAATCCATGCTATTCATAGAAGAAAAGAATGGAAACAAAATATACGCAAAAAGTGGTTGGGGATGGGATGTAAACCCACAAGTAGGCTGGTTAACTGGATGGGTTGTTCAGCCTCAAGGGAATATTGTAGCGTTCTCCCTTAACTTAGAAATGAAAAAAGGAATACCTAG
gb|U59183|+|939-1740|ARO:3001408|OXA-13 [Pseudomonas aeruginosa] 	0	746	659	1405	801	104604+	746	ATGAAAACATTTGCCGCATATGTAATTATCGCGTGTCTTTCGAGTACGGCATTAGCTGGTTCAATTACAGAAAATACGTCTTGGAACAAAGAGTTCTCTGCCGAAGCCGTCAATGGTGTCTTCGTGCTTTGTAAAAGTAGCAGTAAATCCTGCGCTACCAATGACTTAGCTCGTGCATCAAAGGAATATCTTCCAGCATCAACATTTAAGATCCCCAACGCAATTATCGGCCTAGAAACTGGTGTCATAAAGAATGAGCATCAGGTTTTCAAATGGGACGGAAAGCCAAGAGCCATGAAGCAATGGGAAAGAGACTTGACCTTAAGAGGGGCAATACAAGTTTCAGCTGTTCCCGTATTTCAACAAATCGCCAGAGAAGTTGGCGAAGTAAGAATGCAGAAATACCTTAAAAAATTTTCCTATGGCAACCAGAATATCAGTGGTGGCATTGACAAATTCTGGTTGGAAGGCCAGCTTAGAATTTCCGCAGTTAATCAAGTGGAGTTTCTAGAGTCTCTATATTTAAATAAATTGTCAGCATCTAAAGAAAACCAGCTAATAGTAAAAGAGGCTTTGGTAACGGAGGCGGCACCTGAATATCTAGTGCATTCAAAAACTGGTTTTTCTGGTGTGGGAACTGAGTCAAATCCTGGTGTCGCATGGTGGGTTGGGTGGGTTGAGAAGGAGACAGAGGTTTACTTTTTCGCCTTTAACATGGATATAGACAACGAAAGTAAGTTGCCGCT
gb|DQ174307|+|4-865|ARO:3001122|SHV-67 [Klebsiella pneumoniae] 	0	806	16	822	861	1612535+	806	ATGCGTTATATTCGCCTGTGTATTATCACCCTGTGAGCCACCCTGCCGCTGGCGGTACACGCCAGCCCGCAGCCGCTTGAGCAAATTAAACAAAGCGAAAGCCAGCTGTCGGGCCGCGTAGGCATGATAGAAATGGATCTGGCCAGCGGCCGCACGCTGACCGCCTGGCGCGCCGATGAACGCTTTCCCATGATGAGCACCTTTAAAGTAGTGCTCTGCGGCGCAGTGCTGGCGCGGGTGGATGCCGGTGACGAACAGCTGGAGCGAAAGATCCACTATCGCCAGCAGGATCTGGTGGACTACTCGCCGGTCAGCGAAAAACACCTTGCCGACGGCATGACGGTCGGCGAACTCTGCGCCGCCGCCATTACCATGAGCGATAACAGCGCCGCCAATCTGCTGCTGGCCACCGTCGGCGGCCCCGCAGGATTGACTGCCTTTTTGCGCCAGATCGGCGACAACGTCACCCGCCTTGACCGCTGGGAAACGGAACTGAATGAGGCGCTTCCCGGCGACGCCCGCGACACCACTACCCCGGCCAGCATGGCCGCGACCCTGCGCAAGCTGCTGACCAGCCAGCGTCTGAGCGCCCGTTCGCAACGGCAGCTGCTGCAGTGGATGGTGGACGATCGGGTCGCCGGACCGTTGATCCGCTCCGTGCTGCCGGCGGGCTGGTTTATCGCCGATAAGACCGGAGCTAGCAAGCGGGGTGCGCGCGGGATTGTCGCCCTGCTTGGCCCGAATAACAAAGCAGAGCGCATTGTGGTGATTTATCTGCGGGATACGCCGGCGAGCATGGCCGAGCG
gb|AF148851|+|5-866|ARO:3001060|SHV-2 [Escherichia coli] 	0	806	16	822	861	1612535+	806	ATGCGTTATATTCGCCTGTGTATTATCACCCTGTGAGCCACCCTGCCGCTGGCGGTACACGCCAGCCCGCAGCCGCTTGAGCAAATTAAACAAAGCGAAAGCCAGCTGTCGGGCCGCGTAGGCATGATAGAAATGGATCTGGCCAGCGGCCGCACGCTGACCGCCTGGCGCGCCGATGAACGCTTTCCCATGATGAGCACCTTTAAAGTAGTGCTCTGCGGCGCAGTGCTGGCGCGGGTGGATGCCGGTGACGAACAGCTGGAGCGAAAGATCCACTATCGCCAGCAGGATCTGGTGGACTACTCGCCGGTCAGCGAAAAACACCTTGCCGACGGCATGACGGTCGGCGAACTCTGCGCCGCCGCCATTACCATGAGCGATAACAGCGCCGCCAATCTGCTGCTGGCCACCGTCGGCGGCCCCGCAGGATTGACTGCCTTTTTGCGCCAGATCGGCGACAACGTCACCCGCCTTGACCGCTGGGAAACGGAACTGAATGAGGCGCTTCCCGGCGACGCCCGCGACACCACTACCCCGGCCAGCATGGCCGCGACCCTGCGCAAGCTGCTGACCAGCCAGCGTCTGAGCGCCCGTTCGCAACGGCAGCTGCTGCAGTGGATGGTGGACGATCGGGTCGCCGGACCGTTGATCCGCTCCGTGCTGCCGGCGGGCTGGTTTATCGCCGATAAGACCGGAGCTAGCAAGCGGGGTGCGCGCGGGATTGTCGCCCTGCTTGGCCCGAATAACAAAGCAGAGCGCATTGTGGTGATTTATCTGCGGGATACGCCGGCGAGCATGGCCGAGCG
gb|GU932590|+|0-861|ARO:3001175|SHV-128 [Enterobacter cloacae] 	0	806	16	822	861	1612535+	806	ATGCGTTATATTCGCCTGTGTATTATCACCCTGTGAGCCACCCTGCCGCTGGCGGTACACGCCAGCCCGCAGCCGCTTGAGCAAATTAAACAAAGCGAAAGCCAGCTGTCGGGCCGCGTAGGCATGATAGAAATGGATCTGGCCAGCGGCCGCACGCTGACCGCCTGGCGCGCCGATGAACGCTTTCCCATGATGAGCACCTTTAAAGTAGTGCTCTGCGGCGCAGTGCTGGCGCGGGTGGATGCCGGTGACGAACAGCTGGAGCGAAAGATCCACTATCGCCAGCAGGATCTGGTGGACTACTCGCCGGTCAGCGAAAAACACCTTGCCGACGGCATGACGGTCGGCGAACTCTGCGCCGCCGCCATTACCATGAGCGATAACAGCGCCGCCAATCTGCTGCTGGCCACCGTCGGCGGCCCCGCAGGATTGACTGCCTTTTTGCGCCAGATCGGCGACAACGTCACCCGCCTTGACCGCTGGGAAACGGAACTGAATGAGGCGCTTCCCGGCGACGCCCGCGACACCACTACCCCGGCCAGCATGGCCGCGACCCTGCGCAAGCTGCTGACCAGCCAGCGTCTGAGCGCCCGTTCGCAACGGCAGCTGCTGCAGTGGATGGTGGACGATCGGGTCGCCGGACCGTTGATCCGCTCCGTGCTGCCGGCGGGCTGGTTTATCGCCGATAAGACCGGAGCTAGCAAGCGGGGTGCGCGCGGGATTGTCGCCCTGCTTGGCCCGAATAACAAAGCAGAGCGCATTGTGGTGATTTATCTGCGGGATACGCCGGCGAGCATGGCCGAGCG
gb|AF231133|+|1345-2146|ARO:3001423|OXA-28 [Pseudomonas aeruginosa] 	0	746	659	1405	801	104604+	746	ATGAAAACATTTGCCGCATATGTAATTATCGCGTGTCTTTCGAGTACGGCATTAGCTGGTTCAATTACAGAAAATACGTCTTGGAACAAAGAGTTCTCTGCCGAAGCCGTCAATGGTGTCTTCGTGCTTTGTAAAAGTAGCAGTAAATCCTGCGCTACCAATGACTTAGCTCGTGCATCAAAGGAATATCTTCCAGCATCAACATTTAAGATCCCCAACGCAATTATCGGCCTAGAAACTGGTGTCATAAAGAATGAGCATCAGGTTTTCAAATGGGACGGAAAGCCAAGAGCCATGAAGCAATGGGAAAGAGACTTGACCTTAAGAGGGGCAATACAAGTTTCAGCTGTTCCCGTATTTCAACAAATCGCCAGAGAAGTTGGCGAAGTAAGAATGCAGAAATACCTTAAAAAATTTTCCTATGGCAACCAGAATATCAGTGGTGGCATTGACAAATTCTGGTTGGAAGGCCAGCTTAGAATTTCCGCAGTTAATCAAGTGGAGTTTCTAGAGTCTCTATATTTAAATAAATTGTCAGCATCTAAAGAAAACCAGCTAATAGTAAAAGAGGCTTTGGTAACGGAGGCGGCACCTGAATATCTAGTGCATTCAAAAACTGGTTTTTCTGGTGTGGGAACTGAGTCAAATCCTGGTGTCGCATGGTGGGTTGGGTGGGTTGAGAAGGAGACAGAGGTTTACTTTTTCGCCTTTAACATGGATATAGACAACGAAAGTAAGTTGCCGCT
gb|KR091911.1|-|74564-75350|ARO:3002578|AAC(6')-Ib7 [Salmonella enterica subsp. enterica serovar Corvallis] 	162	731	8	577	786	104606+	569	AGCAGCAACGATGTTACGCAGCAGGGCAGTCGCCCTAAAACAAAGTTAGGCATCACAAAGTACAGCATCGTGACCAACAGCAACGATTCCGTCACACTGCGCCTCATGACTGAGCATGACCTTGCGATGCTCTATGAGTGGCTAAATCGATCTCATATCGTCGAGTGGTGGGGCGGAGAAGAAGCACGCCCGACACTTGCTGACGTACAGGAACAGTACTTGCCAAGCGTTTTAGCGCAAGAGTCCGTCACTCCATACATTGCAATGCTGAATGGAGAGCCGATTGGGTATGCCCAGTCGTACGTTGCTCTTGGAAGCGGGGACGGATGGTGGGAAGAAGAAACCGATCCAGGAGTACGCGGAATAGACCAGTCACTGGCGAATGCATCACAACTGGGCAAAGGCTTGGGAACCAAGCTGGTTCGAGCTCTGGTTGAGTTGCTGTTCAATGATCCCGAGGTCACCAAGATCCAAACGGACCCGTCGCCGAGCAACTTGCGAGCGATCCGATGCTACGAGAAAGCGGGGTTTGAGAGGCAAGGTACCGTAACCACCCCAGATGGTCCAGC
gb|FJ666067|+|0-1194|ARO:3002501|PDC-4 [Pseudomonas aeruginosa] 	0	1139	35513	36652	1194	232416+	1139	ATGCGCGATACCAGATTCCCCTGCCTGTGCGGCATCGCCGCTTCCACACTGCTGTTCGCCACCACCCCGGCCATTGCCGATGAGGCCCCGGCGGATCGCCTGAAGGCACTGGTCGACGCCGCCGTACAACCGGTGATGAAGGCCAATGACATTCCGGGCCTGGCCGTAGCCATCAGCCTGAAAGGAGAACCGCATTACTTCAGCTATGGGCTGGCCTCGAAAGAGGACGGCCGCCGGGTGACGCCGGAGACCCTGTTCGAGATCGGCTCGGTGAGCAAGACCTTCACCGTCACCCTCGCCGGCTATGCCCTGGCCCAGGACAAGATGCGCCTCGACGACCGCGCCAGCCAGCACTGGCCGGCACTGCAGGGCAGCCGCTTCGACGGCATCAGCCTGCTCGACCTCGCGACCTATACCGCCGGCGGCTTGCCGCTGCAGTTCCCCGACTCGGTGCAGAAGGACCAGGCACAGATCCGCGACTACTACCGCCAGTGGCAGCCGACCTACGCGCCGGGCAGCCAGCGCCTCTATTCCAACCCGAGCATCGGCCTGTTCGGCTATCTCGCCGCGCGCAGCCTGGGCCAGCCGTTCGAACGGCTCATGGAGCAGCAATTGTTCCCGGCACTGGGCCTCGAACAGACCCACCTCGACGTGCCCGAGGCGGCGCTGGCGCAGTACGCCCAGGGCTACGGCAAGGACGACCGCCCGCTACGGGTCGGTCCCGGCCCGCTGGATGCCGAAGGCTACGGGGTGAAGACCAGCGCGGCCGACCTGCTGCGCTTCGTCGATGCCAACCTGCATCCGGAGCGCCTGGACAGGCCCTGGGCGCAGGCGCTCGATGCCACCCATCGCGGTTACTACAAGGTCGGCGACATGACCCAGGGCCTGGGCTGGGAAGCCTACGACTGGCCGATCTCCCTGAAGCGCCTGCAGGCCGGCAACTCGACGCCGATGGCGCTGCAACCACACAGGATCGCCAGGCTGCCCGCGCCACAGGCGCTGGAGGGCCAGCGCCTGCTGAACAAGACCGGCTCCACCAACGGCTTCGGCGCCTACGTGGCGTTCGTCCCGGGCCGCGACCTGGGCCTGGTGATCCTGGCCAACCGCAACTATCCCAATGCCGAGCGGGTGAAGATCGC
gb|KP844571.1|+|0-825|ARO:3003598|OXA-442 [Acinetobacter baumannii] 	0	770	54149	54919	825	246080-	770	ATGAACATTAAAGCACTCTTACTTATAACAAGCGCTATTTTTATTTCAGCCTGCTCACCTTATATAGTGACTGCTAATCCAAATCACAGCGCTTCAAAATCTGATGTAAAAGCAGAGAAAATTAAAAATTTATTTAACGAAGCACACACTACGGGTGTTTTAGTTATCCAACAAGGCCAAACTCAACAAAGCTATGGTAATGATCTTGCTCGTGCTTCGACCGAGTATGTACCTGCTTCGACCTTCAAAATGCTTAATGCTTTGATCGGCCTTGAGCACCATAAGGCAACCACCACAGAAGTATTTAAGTGGGATGGTAAAAAAAGGTTATTCCCAGAATGGGAAAAGGACATGACCCTAGGCGATGCCATGAAAGCTTCCGCTATTCCAGTTTATCAAGATTTAGCTCGTCGTATTGGACTTGAGCTCATGTCTAAGGAAGTGAAGCGTGTTGGTTATGGCAATGCAGATATCGGTACCCAAGTCGATAATTTTTGGCTGGTGGGTCCTTTAAAAATTACTCCTCAGCAAGAGGCACAGTTTGCTTACAAGCTAGCTAATAAAACGCTTCCATTTAGCCAAAAAGTCCAAGATGAAGTGCAATCCATGCTATTCATAGAAGAAAAGAATGGAAACAAAATATACGCAAAAAGTGGTTGGGGATGGGATGTAAACCCACAAGTAGGCTGGTTAACTGGATGGGTTGTTCAGCCTCAAGGGAATATTGTAGCGTTCTCCCTTAACTTAGAAATGAAAAAAGGAATACCTAG
gb|AF043381|+|251-863|ARO:3002580|AAC(6')-Ib9 [Pseudomonas aeruginosa] 	0	557	18	577	612	104606+	559	ATGTTACGCAGCAGGGCAGTCGCCCTAAAACAAAGTTAGGCATCACAAAGTACAGCATCGTGACCAACAGCAACGATTCCGTCACACTGCGCCTCATGACTGAGCATGACCTTGCGATGCTCTATGAGTGGCTAAATCGATCTCATATCGTCGAGTGGTGGGGCGGAGAAGAAGCACGCCCGACACTTGCTGACGTACAGGAACAGTACTTGCCAAGCGTTTTAGCGCAAGAGTCCGTCACTCCATACATTGCAATGCTGAATGGAGAGCCGATTGGGTATGCCCAGTCGTACGTTGCTCTTGGAAGCGGGGACGGATGGTGGGAAGAAGAAACCGATCCAGGAGTACGCGGAATAGACCAGTCACTGGCGAATGCATCACAACTGGGCAAAGGCTTGGGAACCAAGCTGGTTCGAGCTCTGGTTGAGTTGCTGTTCAATGATCCCGAGGTCACCAAGATCCAAACGGACCCGTCGCCGAGCAACTTGCGAGCGATCCGATGCTACGAGAAAGCGGGGTTTGAGAGGCAAGGTACCGTAACCACCCCAGATGGTCCAGC
gb|EU547445|+|0-825|ARO:3001651|OXA-130 [Acinetobacter baumannii] 	0	770	54149	54919	825	246080-	770	ATGAACATTAAAGCACTCTTACTTATAACAAGCGCTATTTTTATTTCAGCCTGCTCACCTTATATAGTGACTGCTAATCCAAATCACAGCGCTTCAAAATCTGATGTAAAAGCAGAGAAAATTAAAAATTTATTTAACGAAGCACACACTACGGGTGTTTTAGTTATCCAACAAGGCCAAACTCAACAAAGCTATGGTAATGATCTTGCTCGTGCTTCGACCGAGTATGTACCTGCTTCGACCTTCAAAATGCTTAATGCTTTGATCGGCCTTGAGCACCATAAGGCAACCACCACAGAAGTATTTAAGTGGGATGGTAAAAAAAGGTTATTCCCAGAATGGGAAAAGGACATGACCCTAGGCGATGCCATGAAAGCTTCCGCTATTCCAGTTTATCAAGATTTAGCTCGTCGTATTGGACTTGAGCTCATGTCTAAGGAAGTGAAGCGTGTTGGTTATGGCAATGCAGATATCGGTACCCAAGTCGATAATTTTTGGCTGGTGGGTCCTTTAAAAATTACTCCTCAGCAAGAGGCACAGTTTGCTTACAAGCTAGCTAATAAAACGCTTCCATTTAGCCAAAAAGTCCAAGATGAAGTGCAATCCATGCTATTCATAGAAGAAAAGAATGGAAACAAAATATACGCAAAAAGTGGTTGGGGATGGGATGTAAACCCACAAGTAGGCTGGTTAACTGGATGGGTTGTTCAGCCTCAAGGGAATATTGTAGCGTTCTCCCTTAACTTAGAAATGAAAAAAGGAATACCTAG
gb|AY660529.1|+|121-676|ARO:3003676|AAC(6')-Ib' [Pseudomonas aeruginosa] 	0	500	77	577	555	104606+	500	GTGACCAACAGCAACGATTCCGTCACACTGCGCCTCATGACTGAGCATGACCTTGCGATGCTCTATGAGTGGCTAAATCGATCTCATATCGTCGAGTGGTGGGGCGGAGAAGAAGCACGCCCGACACTTGCTGACGTACAGGAACAGTACTTGCCAAGCGTTTTAGCGCAAGAGTCCGTCACTCCATACATTGCAATGCTGAATGGAGAGCCGATTGGGTATGCCCAGTCGTACGTTGCTCTTGGAAGCGGGGACGGATGGTGGGAAGAAGAAACCGATCCAGGAGTACGCGGAATAGACCAGTCACTGGCGAATGCATCACAACTGGGCAAAGGCTTGGGAACCAAGCTGGTTCGAGCTCTGGTTGAGTTGCTGTTCAATGATCCCGAGGTCACCAAGATCCAAACGGACCCGTCGCCGAGCAACTTGCGAGCGATCCGATGCTACGAGAAAGCGGGGTTTGAGAGGCAAGGTACCGTAACCACCCCAGATGGTCCAGC
gb|Z54241.1|+|529-1051|ARO:3002559|AAC(6')-Ip [Citrobacter freundii] 	0	467	162	630	522	53314296+	468	ATGCTTAAGAAAAGCTTTCTTGATGCTGGAAATGAATCATGGGGAGATATTAAAAATGCTATTGAAGAAGTTGAAGAATGTATAGAACATCCAAATATATGCTTGGGAATATGTCTGGATGATAAACTGATTGGATGGACCGGATTAAGGCCGATGTACGATAAGACCTGGGAACTTCATCCCATGGTTATAAAAACTGAATATCAAGGCAAGGGTTTTGGGAAAGTACTACTAAGAGAACTAGAGACGAGAGCGAAGAGTAGGGGAATTATCGGAATAGCTCTTGGAACTGATGACGAATATCAGAAAACTAGTTTGTCTATGATTGATATAAACGAACGAAATATCTTCGATGAAATCGGGAATATAAAGAACGTTAATAATCATCCATATGAGTTTTATAAGAAATGTGGTTATATGATCGTTGGAATAATCCCTAATGCTAATGGAAAAAGAAAACCAGATATA
gb|LC037981|+|0-801|ARO:3003610|OXA-454 [Delftia acidovorans] 	0	746	659	1405	801	104604+	746	ATGAAAACATTTGCCGCATATGTAATTATCGCGTGTCTTTCGAGTACGGCATTAGCTGGTTCAATTACAGAAAATACGTCTTGGAACAAAGAGTTCTCTGCCGAAGCCGTCAATGGTGTCTTCGTGCTTTGTAAAAGTAGCAGTAAATCCTGCGCTACCAATGACTTAGCTCGTGCATCAAAGGAATATCTTCCAGCATCAACATTTAAGATCCCCAACGCAATTATCGGCCTAGAAACTGGTGTCATAAAGAATGAGCATCAGGTTTTCAAATGGGACGGAAAGCCAAGAGCCATGAAGCAATGGGAAAGAGACTTGACCTTAAGAGGGGCAATACAAGTTTCAGCTGTTCCCGTATTTCAACAAATCGCCAGAGAAGTTGGCGAAGTAAGAATGCAGAAATACCTTAAAAAATTTTCCTATGGCAACCAGAATATCAGTGGTGGCATTGACAAATTCTGGTTGGAAGGCCAGCTTAGAATTTCCGCAGTTAATCAAGTGGAGTTTCTAGAGTCTCTATATTTAAATAAATTGTCAGCATCTAAAGAAAACCAGCTAATAGTAAAAGAGGCTTTGGTAACGGAGGCGGCACCTGAATATCTAGTGCATTCAAAAACTGGTTTTTCTGGTGTGGGAACTGAGTCAAATCCTGGTGTCGCATGGTGGGTTGGGTGGGTTGAGAAGGAGACAGAGGTTTACTTTTTCGCCTTTAACATGGATATAGACAACGAAAGTAAGTTGCCGCT
gb|DQ174308|+|4-865|ARO:3001123|SHV-69 [Klebsiella pneumoniae] 	0	806	16	822	861	1612535+	806	ATGCGTTATATTCGCCTGTGTATTATCACCCTGTGAGCCACCCTGCCGCTGGCGGTACACGCCAGCCCGCAGCCGCTTGAGCAAATTAAACAAAGCGAAAGCCAGCTGTCGGGCCGCGTAGGCATGATAGAAATGGATCTGGCCAGCGGCCGCACGCTGACCGCCTGGCGCGCCGATGAACGCTTTCCCATGATGAGCACCTTTAAAGTAGTGCTCTGCGGCGCAGTGCTGGCGCGGGTGGATGCCGGTGACGAACAGCTGGAGCGAAAGATCCACTATCGCCAGCAGGATCTGGTGGACTACTCGCCGGTCAGCGAAAAACACCTTGCCGACGGCATGACGGTCGGCGAACTCTGCGCCGCCGCCATTACCATGAGCGATAACAGCGCCGCCAATCTGCTGCTGGCCACCGTCGGCGGCCCCGCAGGATTGACTGCCTTTTTGCGCCAGATCGGCGACAACGTCACCCGCCTTGACCGCTGGGAAACGGAACTGAATGAGGCGCTTCCCGGCGACGCCCGCGACACCACTACCCCGGCCAGCATGGCCGCGACCCTGCGCAAGCTGCTGACCAGCCAGCGTCTGAGCGCCCGTTCGCAACGGCAGCTGCTGCAGTGGATGGTGGACGATCGGGTCGCCGGACCGTTGATCCGCTCCGTGCTGCCGGCGGGCTGGTTTATCGCCGATAAGACCGGAGCTAGCAAGCGGGGTGCGCGCGGGATTGTCGCCCTGCTTGGCCCGAATAACAAAGCAGAGCGCATTGTGGTGATTTATCTGCGGGATACGCCGGCGAGCATGGCCGAGCG
gb|GU827715|+|0-861|ARO:3001176|SHV-129 [Escherichia coli] 	0	806	16	822	861	1612535+	806	ATGCGTTATATTCGCCTGTGTATTATCACCCTGTGAGCCACCCTGCCGCTGGCGGTACACGCCAGCCCGCAGCCGCTTGAGCAAATTAAACAAAGCGAAAGCCAGCTGTCGGGCCGCGTAGGCATGATAGAAATGGATCTGGCCAGCGGCCGCACGCTGACCGCCTGGCGCGCCGATGAACGCTTTCCCATGATGAGCACCTTTAAAGTAGTGCTCTGCGGCGCAGTGCTGGCGCGGGTGGATGCCGGTGACGAACAGCTGGAGCGAAAGATCCACTATCGCCAGCAGGATCTGGTGGACTACTCGCCGGTCAGCGAAAAACACCTTGCCGACGGCATGACGGTCGGCGAACTCTGCGCCGCCGCCATTACCATGAGCGATAACAGCGCCGCCAATCTGCTGCTGGCCACCGTCGGCGGCCCCGCAGGATTGACTGCCTTTTTGCGCCAGATCGGCGACAACGTCACCCGCCTTGACCGCTGGGAAACGGAACTGAATGAGGCGCTTCCCGGCGACGCCCGCGACACCACTACCCCGGCCAGCATGGCCGCGACCCTGCGCAAGCTGCTGACCAGCCAGCGTCTGAGCGCCCGTTCGCAACGGCAGCTGCTGCAGTGGATGGTGGACGATCGGGTCGCCGGACCGTTGATCCGCTCCGTGCTGCCGGCGGGCTGGTTTATCGCCGATAAGACCGGAGCTAGCAAGCGGGGTGCGCGCGGGATTGTCGCCCTGCTTGGCCCGAATAACAAAGCAGAGCGCATTGTGGTGATTTATCTGCGGGATACGCCGGCGAGCATGGCCGAGCG
gb|APPZ01000001.1|+|7525-8353|ARO:3001735|OXA-280 [Acinetobacter johnsonii ANC 3681] 	0	773	156	929	828	5350482-	773	ATGAAAACTTTACAGTTGGGCCTCATCGTCCTCATTACTACCTTCGGTTCTGCATGTACCATAATAAGAAGCCCCTCCATAGAAACAGCTAAAAACCATGAGCAACAAAGTGCGCAGCAGCAGATCCAACAGGCCTTCGATCAACTCCAAACCACGGGGGTGATTGTCATAAAGGATAAGCATGGCTTACACAGCTACGGCAATGACTTGAGCCGTGCTCAGACACCCTATGTACCCGCCTCTACCTTTAAAATGCTGAATGCCTTAATCGGACTAGAACATGGTAAAGCAACCAGCACCGAGGTGTTTAAATGGGATGGTCAAAAGAACAGCTTCCCTGCTTGGGAAAAAGACATGACTTTAGGGCAAGCCATGCAAGCATCTGCCGTTCCTGTTTATCAGGAGCTAGCACGGCGCATTGGCCTAGATCTAATGCAAAAAGAAGTACAGCGCATTGGATATGGCAATCAACAGATTGGCACCGTTGTCGATAATTTTTGGTTAGTCGGTCCACTGCAAATTACGCCTGTTCAAGAAGTCCTTTTTGTAGAGAAGCTGGCCAATACGCAACTCGCTTTTAAGCCAGATGTGCAACATACCGTACAAGACATGCTGCTGATTGAACAAAAACCGAATTATAAACTCTACGCCAAATCTGGTTGGGGCATGGACCTAGAACCGCAAGTGGGCTGGTGGACAGGCTGGGTCGAAACAGCAACAGGTGAAAAAGTGTATTTTGCTTTGAATATGCATATGAAAACAGGAATTTCAGC
gb|KR872296.1|+|0-825|ARO:3003637|OXA-480 [Acinetobacter baumannii] 	0	770	54149	54919	825	246080-	770	ATGAACATTAAAGCACTCTTACTTATAACAAGCGCTATTTTTATTTCAGCCTGCTCACCTTATATAGTGACTGCTAATCCAAATCACAGCGCTTCAAAATCTGATGTAAAAGCAGAGAAAATTAAAAATTTATTTAACGAAGCACACACTACGGGTGTTTTAGTTATCCAACAAGGCCAAACTCAACAAAGCTATGGTAATGATCTTGCTCGTGCTTCGACCGAGTATGTACCTGCTTCGACCTTCAAAATGCTTAATGCTTTGATCGGCCTTGAGCACCATAAGGCAACCACCACAGAAGTATTTAAGTGGGATGGTAAAAAAAGGTTATTCCCAGAATGGGAAAAGGACATGACCCTAGGCGATGCCATGAAAGCTTCCGCTATTCCAGTTTATCAAGATTTAGCTCGTCGTATTGGACTTGAGCTCATGTCTAAGGAAGTGAAGCGTGTTGGTTATGGCAATGCAGATATCGGTACCCAAGTCGATAATTTTTGGCTGGTGGGTCCTTTAAAAATTACTCCTCAGCAAGAGGCACAGTTTGCTTACAAGCTAGCTAATAAAACGCTTCCATTTAGCCAAAAAGTCCAAGATGAAGTGCAATCCATGCTATTCATAGAAGAAAAGAATGGAAACAAAATATACGCAAAAAGTGGTTGGGGATGGGATGTAAACCCACAAGTAGGCTGGTTAACTGGATGGGTTGTTCAGCCTCAAGGGAATATTGTAGCGTTCTCCCTTAACTTAGAAATGAAAAAAGGAATACCTAG
gb|EU547446|+|0-825|ARO:3001652|OXA-131 [Acinetobacter baumannii] 	0	770	54149	54919	825	246080-	770	ATGAACATTAAAGCACTCTTACTTATAACAAGCGCTATTTTTATTTCAGCCTGCTCACCTTATATAGTGACTGCTAATCCAAATCACAGCGCTTCAAAATCTGATGTAAAAGCAGAGAAAATTAAAAATTTATTTAACGAAGCACACACTACGGGTGTTTTAGTTATCCAACAAGGCCAAACTCAACAAAGCTATGGTAATGATCTTGCTCGTGCTTCGACCGAGTATGTACCTGCTTCGACCTTCAAAATGCTTAATGCTTTGATCGGCCTTGAGCACCATAAGGCAACCACCACAGAAGTATTTAAGTGGGATGGTAAAAAAAGGTTATTCCCAGAATGGGAAAAGGACATGACCCTAGGCGATGCCATGAAAGCTTCCGCTATTCCAGTTTATCAAGATTTAGCTCGTCGTATTGGACTTGAGCTCATGTCTAAGGAAGTGAAGCGTGTTGGTTATGGCAATGCAGATATCGGTACCCAAGTCGATAATTTTTGGCTGGTGGGTCCTTTAAAAATTACTCCTCAGCAAGAGGCACAGTTTGCTTACAAGCTAGCTAATAAAACGCTTCCATTTAGCCAAAAAGTCCAAGATGAAGTGCAATCCATGCTATTCATAGAAGAAAAGAATGGAAACAAAATATACGCAAAAAGTGGTTGGGGATGGGATGTAAACCCACAAGTAGGCTGGTTAACTGGATGGGTTGTTCAGCCTCAAGGGAATATTGTAGCGTTCTCCCTTAACTTAGAAATGAAAAAAGGAATACCTAG
gb|AF144880|+|3541-3979|ARO:3002569|AAC(6')-Iy [Salmonella enterica subsp. enterica serovar Enteritidis] 	129	383	0	254	438	55192214+	254	GCATCATTTATTGCGATGGCAGACGGGGTGGCGATTGGCTTTGCGGATGCCTCAATCCGCCACGATTATGTCAATGGCTGTGACAGTTCGCCCGTGGTTTTCCTTGAAGGTATTTTTGTTCTCCCCTCGTTCCGTCAACGCGGCTTAGCGAAACAATTGATTGCAGCAGTGCAACGATGGGGAACGAATAAAGGGTGTCGGGAAATGGCTTCCGATACCTCGCCGGAAAATACAATTTCACAGAAAGTTCACCT
gb|AF117744|+|0-780|ARO:3001078|SHV-20 [Klebsiella pneumoniae] 	5	725	51	771	780	1612535+	720	AGCCACCCTGCCGCTGGCGGTACACGCCAGCCCGCAGCCGCTTGAGCAAATTAAACAAAGCGAAAGCCAGCTGTCGGGCCGCGTAGGCATGATAGAAATGGATCTGGCCAGCGGCCGCACGCTGACCGCCTGGCGCGCCGATGAACGCTTTCCCATGATGAGCACCTTTAAAGTAGTGCTCTGCGGCGCAGTGCTGGCGCGGGTGGATGCCGGTGACGAACAGCTGGAGCGAAAGATCCACTATCGCCAGCAGGATCTGGTGGACTACTCGCCGGTCAGCGAAAAACACCTTGCCGACGGCATGACGGTCGGCGAACTCTGCGCCGCCGCCATTACCATGAGCGATAACAGCGCCGCCAATCTGCTGCTGGCCACCGTCGGCGGCCCCGCAGGATTGACTGCCTTTTTGCGCCAGATCGGCGACAACGTCACCCGCCTTGACCGCTGGGAAACGGAACTGAATGAGGCGCTTCCCGGCGACGCCCGCGACACCACTACCCCGGCCAGCATGGCCGCGACCCTGCGCAAGCTGCTGACCAGCCAGCGTCTGAGCGCCCGTTCGCAACGGCAGCTGCTGCAGTGGATGGTGGACGATCGGGTCGCCGGACCGTTGATCCGCTCCGTGCTGCCGGCGGGCTGGTTTATCGCCGATAAGACCGGAGCTAGCAAGCGGGGTGCGCGCGGGATTGTCGCCCTGCTTGGCCCGAATAACAAAGCAGA
gb|AF164577|+|0-861|ARO:3001072|SHV-13 [Klebsiella pneumoniae] 	0	806	16	822	861	1612535+	806	ATGCGTTATATTCGCCTGTGTATTATCACCCTGTGAGCCACCCTGCCGCTGGCGGTACACGCCAGCCCGCAGCCGCTTGAGCAAATTAAACAAAGCGAAAGCCAGCTGTCGGGCCGCGTAGGCATGATAGAAATGGATCTGGCCAGCGGCCGCACGCTGACCGCCTGGCGCGCCGATGAACGCTTTCCCATGATGAGCACCTTTAAAGTAGTGCTCTGCGGCGCAGTGCTGGCGCGGGTGGATGCCGGTGACGAACAGCTGGAGCGAAAGATCCACTATCGCCAGCAGGATCTGGTGGACTACTCGCCGGTCAGCGAAAAACACCTTGCCGACGGCATGACGGTCGGCGAACTCTGCGCCGCCGCCATTACCATGAGCGATAACAGCGCCGCCAATCTGCTGCTGGCCACCGTCGGCGGCCCCGCAGGATTGACTGCCTTTTTGCGCCAGATCGGCGACAACGTCACCCGCCTTGACCGCTGGGAAACGGAACTGAATGAGGCGCTTCCCGGCGACGCCCGCGACACCACTACCCCGGCCAGCATGGCCGCGACCCTGCGCAAGCTGCTGACCAGCCAGCGTCTGAGCGCCCGTTCGCAACGGCAGCTGCTGCAGTGGATGGTGGACGATCGGGTCGCCGGACCGTTGATCCGCTCCGTGCTGCCGGCGGGCTGGTTTATCGCCGATAAGACCGGAGCTAGCAAGCGGGGTGCGCGCGGGATTGTCGCCCTGCTTGGCCCGAATAACAAAGCAGAGCGCATTGTGGTGATTTATCTGCGGGATACGCCGGCGAGCATGGCCGAGCG
gb|KP264124.1|+|76-898|ARO:3003639|OXA-482 [Acinetobacter baumannii] 	0	767	80	847	822	254088-	767	ATGAATAAATATTTTACTTGCTATGTGGTTGCTTCTCTTTTTCTTTCTGGTTGTACGGTTCAGCATAATTTAATAAATGAAACCCCGAGTCAGATTGTTCAAGGACATAATCAGGTGATTCATCAATACTTTGATGAAAAAAACACCTCAGGTGTGCTGGTTATTCAAACAGATAAAAAAATTAATCTATATGGTAATGCTCTAAGCCGCGCAAATACAGAATATGTGCCAGCCTCTACATTTAAAATGTTGAATGCCCTGATCGGATTGGAGAACCAGAAAACGGATATTAATGAAATATTTAAATGGAAGGGCGAGAAAAGGTCATTTACCGCTTGGGAAAAAGACATGACACTAGGAGAAGCCATGAAGCTTTCTGCAGTCCCAGTCTATCAGGAACTTGCGCGACGTATCGGTCTTGATCTCATGCAAAAAGAAGTAAAACGTATTGGTTTCGGTAATGCTGAAATTGGACAGCAGGTTGATAATTTCTGGTTGGTAGGACCATTAAAGGTTACGCCTATTCAAGAGGTAGAGTTTGTTTCCCAATTAGCACATACACAGCTTCCATTTAGTGAAAAAGTGCAGGCTAATGTAAAAAATATGCTTCTTTTAGAAGAGAGTAATGGCTACAAAATTTTTGGAAAGACTGGTTGGGCAATGGATATAAAACCACAAGTGGGCTGGTTGACCGGCTGGGTTGAGCAGCCAGATGGAAAAATTGTCGCTTTTGCATTAAATATGGAAATGCGGTCAGAAATGCCGGC
gb|EU547447|+|0-825|ARO:3001653|OXA-132 [Acinetobacter baumannii] 	0	770	54149	54919	825	246080-	770	ATGAACATTAAAGCACTCTTACTTATAACAAGCGCTATTTTTATTTCAGCCTGCTCACCTTATATAGTGACTGCTAATCCAAATCACAGCGCTTCAAAATCTGATGTAAAAGCAGAGAAAATTAAAAATTTATTTAACGAAGCACACACTACGGGTGTTTTAGTTATCCAACAAGGCCAAACTCAACAAAGCTATGGTAATGATCTTGCTCGTGCTTCGACCGAGTATGTACCTGCTTCGACCTTCAAAATGCTTAATGCTTTGATCGGCCTTGAGCACCATAAGGCAACCACCACAGAAGTATTTAAGTGGGATGGTAAAAAAAGGTTATTCCCAGAATGGGAAAAGGACATGACCCTAGGCGATGCCATGAAAGCTTCCGCTATTCCAGTTTATCAAGATTTAGCTCGTCGTATTGGACTTGAGCTCATGTCTAAGGAAGTGAAGCGTGTTGGTTATGGCAATGCAGATATCGGTACCCAAGTCGATAATTTTTGGCTGGTGGGTCCTTTAAAAATTACTCCTCAGCAAGAGGCACAGTTTGCTTACAAGCTAGCTAATAAAACGCTTCCATTTAGCCAAAAAGTCCAAGATGAAGTGCAATCCATGCTATTCATAGAAGAAAAGAATGGAAACAAAATATACGCAAAAAGTGGTTGGGGATGGGATGTAAACCCACAAGTAGGCTGGTTAACTGGATGGGTTGTTCAGCCTCAAGGGAATATTGTAGCGTTCTCCCTTAACTTAGAAATGAAAAAAGGAATACCTAG
gb|U20270|+|124-985|ARO:3001066|SHV-7 [Escherichia coli] 	0	806	16	822	861	1612535+	806	ATGCGTTATATTCGCCTGTGTATTATCACCCTGTGAGCCACCCTGCCGCTGGCGGTACACGCCAGCCCGCAGCCGCTTGAGCAAATTAAACAAAGCGAAAGCCAGCTGTCGGGCCGCGTAGGCATGATAGAAATGGATCTGGCCAGCGGCCGCACGCTGACCGCCTGGCGCGCCGATGAACGCTTTCCCATGATGAGCACCTTTAAAGTAGTGCTCTGCGGCGCAGTGCTGGCGCGGGTGGATGCCGGTGACGAACAGCTGGAGCGAAAGATCCACTATCGCCAGCAGGATCTGGTGGACTACTCGCCGGTCAGCGAAAAACACCTTGCCGACGGCATGACGGTCGGCGAACTCTGCGCCGCCGCCATTACCATGAGCGATAACAGCGCCGCCAATCTGCTGCTGGCCACCGTCGGCGGCCCCGCAGGATTGACTGCCTTTTTGCGCCAGATCGGCGACAACGTCACCCGCCTTGACCGCTGGGAAACGGAACTGAATGAGGCGCTTCCCGGCGACGCCCGCGACACCACTACCCCGGCCAGCATGGCCGCGACCCTGCGCAAGCTGCTGACCAGCCAGCGTCTGAGCGCCCGTTCGCAACGGCAGCTGCTGCAGTGGATGGTGGACGATCGGGTCGCCGGACCGTTGATCCGCTCCGTGCTGCCGGCGGGCTGGTTTATCGCCGATAAGACCGGAGCTAGCAAGCGGGGTGCGCGCGGGATTGTCGCCCTGCTTGGCCCGAATAACAAAGCAGAGCGCATTGTGGTGATTTATCTGCGGGATACGCCGGCGAGCATGGCCGAGCG
gb|AB551737|+|14-875|ARO:3001177|SHV-133 [Klebsiella pneumoniae] 	0	806	16	822	861	1612535+	806	ATGCGTTATATTCGCCTGTGTATTATCACCCTGTGAGCCACCCTGCCGCTGGCGGTACACGCCAGCCCGCAGCCGCTTGAGCAAATTAAACAAAGCGAAAGCCAGCTGTCGGGCCGCGTAGGCATGATAGAAATGGATCTGGCCAGCGGCCGCACGCTGACCGCCTGGCGCGCCGATGAACGCTTTCCCATGATGAGCACCTTTAAAGTAGTGCTCTGCGGCGCAGTGCTGGCGCGGGTGGATGCCGGTGACGAACAGCTGGAGCGAAAGATCCACTATCGCCAGCAGGATCTGGTGGACTACTCGCCGGTCAGCGAAAAACACCTTGCCGACGGCATGACGGTCGGCGAACTCTGCGCCGCCGCCATTACCATGAGCGATAACAGCGCCGCCAATCTGCTGCTGGCCACCGTCGGCGGCCCCGCAGGATTGACTGCCTTTTTGCGCCAGATCGGCGACAACGTCACCCGCCTTGACCGCTGGGAAACGGAACTGAATGAGGCGCTTCCCGGCGACGCCCGCGACACCACTACCCCGGCCAGCATGGCCGCGACCCTGCGCAAGCTGCTGACCAGCCAGCGTCTGAGCGCCCGTTCGCAACGGCAGCTGCTGCAGTGGATGGTGGACGATCGGGTCGCCGGACCGTTGATCCGCTCCGTGCTGCCGGCGGGCTGGTTTATCGCCGATAAGACCGGAGCTAGCAAGCGGGGTGCGCGCGGGATTGTCGCCCTGCTTGGCCCGAATAACAAAGCAGAGCGCATTGTGGTGATTTATCTGCGGGATACGCCGGCGAGCATGGCCGAGCG
gb|FJ666068|+|0-1194|ARO:3002502|PDC-5 [Pseudomonas aeruginosa] 	0	1139	35513	36652	1194	232416+	1139	ATGCGCGATACCAGATTCCCCTGCCTGTGCGGCATCGCCGCTTCCACACTGCTGTTCGCCACCACCCCGGCCATTGCCGATGAGGCCCCGGCGGATCGCCTGAAGGCACTGGTCGACGCCGCCGTACAACCGGTGATGAAGGCCAATGACATTCCGGGCCTGGCCGTAGCCATCAGCCTGAAAGGAGAACCGCATTACTTCAGCTATGGGCTGGCCTCGAAAGAGGACGGCCGCCGGGTGACGCCGGAGACCCTGTTCGAGATCGGCTCGGTGAGCAAGACCTTCACCGTCACCCTCGCCGGCTATGCCCTGGCCCAGGACAAGATGCGCCTCGACGACCGCGCCAGCCAGCACTGGCCGGCACTGCAGGGCAGCCGCTTCGACGGCATCAGCCTGCTCGACCTCGCGACCTATACCGCCGGCGGCTTGCCGCTGCAGTTCCCCGACTCGGTGCAGAAGGACCAGGCACAGATCCGCGACTACTACCGCCAGTGGCAGCCGACCTACGCGCCGGGCAGCCAGCGCCTCTATTCCAACCCGAGCATCGGCCTGTTCGGCTATCTCGCCGCGCGCAGCCTGGGCCAGCCGTTCGAACGGCTCATGGAGCAGCAATTGTTCCCGGCACTGGGCCTCGAACAGACCCACCTCGACGTGCCCGAGGCGGCGCTGGCGCAGTACGCCCAGGGCTACGGCAAGGACGACCGCCCGCTACGGGTCGGTCCCGGCCCGCTGGATGCCGAAGGCTACGGGGTGAAGACCAGCGCGGCCGACCTGCTGCGCTTCGTCGATGCCAACCTGCATCCGGAGCGCCTGGACAGGCCCTGGGCGCAGGCGCTCGATGCCACCCATCGCGGTTACTACAAGGTCGGCGACATGACCCAGGGCCTGGGCTGGGAAGCCTACGACTGGCCGATCTCCCTGAAGCGCCTGCAGGCCGGCAACTCGACGCCGATGGCGCTGCAACCACACAGGATCGCCAGGCTGCCCGCGCCACAGGCGCTGGAGGGCCAGCGCCTGCTGAACAAGACCGGCTCCACCAACGGCTTCGGCGCCTACGTGGCGTTCGTCCCGGGCCGCGACCTGGGCCTGGTGATCCTGGCCAACCGCAACTATCCCAATGCCGAGCGGGTGAAGATCGC
gb|APON01000041.1|+|10443-11268|ARO:3001736|OXA-281 [Acinetobacter johnsonii CIP 64.6] 	0	770	156	929	825	5350482-	773	ATGAAAACTTTACAGTTGGGCCTCATCGTCCTCATTACTACCTTCGGTTCTGCATGTACCATAATAAGAAGCCCCTCCATAGAAACAGCTAAAAACCATGAGCAACAAAGTGCGCAGCAGCAGATCCAACAGGCCTTCGATCAACTCCAAACCACGGGGGTGATTGTCATAAAGGATAAGCATGGCTTACACAGCTACGGCAATGACTTGAGCCGTGCTCAGACACCCTATGTACCCGCCTCTACCTTTAAAATGCTGAATGCCTTAATCGGACTAGAACATGGTAAAGCAACCAGCACCGAGGTGTTTAAATGGGATGGTCAAAAGAACAGCTTCCCTGCTTGGGAAAAAGACATGACTTTAGGGCAAGCCATGCAAGCATCTGCCGTTCCTGTTTATCAGGAGCTAGCACGGCGCATTGGCCTAGATCTAATGCAAAAAGAAGTACAGCGCATTGGATATGGCAATCAACAGATTGGCACCGTTGTCGATAATTTTTGGTTAGTCGGTCCACTGCAAATTACGCCTGTTCAAGAAGTCCTTTTTGTAGAGAAGCTGGCCAATACGCAACTCGCTTTTAAGCCAGATGTGCAACATACCGTACAAGACATGCTGCTGATTGAACAAAAACCGAATTATAAACTCTACGCCAAATCTGGTTGGGGCATGGACCTAGAACCGCAAGTGGGCTGGTGGACAGGCTGGGTCGAAACAGCAACAGGTGAAAAAGTGTATTTTGCTTTGAATATGCATATGAAAACAGGAATTTCAGC
gb|AJ009979.1|+|0-1152|ARO:3003847|ADC-1 [Acinetobacter baumannii] 	0	1097	63	1160	1152	126080+	1097	ATGCGATTTAAAAAAATTTCTTGTCTACTTTTATCCCCGCTTTTTATTTTTAGTACCTCAATTTATGCGGGCAATACACCAAAAGACCAAGAAATTAAAAAACTGGTAGATCAAAACTTTAAACCGTTATTAGAAAAATATGATGTGCCAGGTATGGCTGTGGGTGTTATTCAAAATAATAAAAAGTATGAAATGTATTATGGTCTTCAATCTGTTCAAGATAAAAAAGCCGTAAATAGCAGTACTATTTTTGAGCTAGGTTCTGTCAGTAAATTATTTACCGCGACAGCAGGTGGATATGCAAAAAATAAAGGAAAAATCTCTTTTGACGATACGCCTGGTAAGTATTGGAAAGAACTAAAAAATACACCGATTGACCAAGTTAACTTACTTCAACTCGCGACGTATACAAGTGGTAACCTTGCCTTGCAATTTCCAGATGAAGTAAAAACAGATCAGCAAGTTTTAACATTTTTTAAAGACTGGAAACCTAAAAACTCAATCGGTGAATATCGACAATATTCAAACCCAAGCATTGGTTTATTTGGAAAAGTTGTAGCTTTGTCTATGAATAAACCTTTCGACCAAGTCTTAGAAAAAACAATTTTTCCGGCCCTTGGCTTAAAACATAGCTATGTAAATGTACCTAAGACCCAGATGCAAAACTATGCTTTTGGCTATAACCAAGAAAATCAGCCGATTCGAGTTAACCCCGGCCCACTCGATGCCCCAGCATATGGCGTCAAATCGACACTACCCGACATGTTGAGTTTTATTCATGCCAACCTAAATCCACAAAAATATCCAGCAGATATTCAACGGGCAATTAATGAAACACATCAGGGTCGCTATCAAGTAAATACCATGTATCAGGCACTCGGTTGGGAAGAGTTTTCTTATCCGGCAACGTTACAAACTTTATTAGACAGTAATTCAGAACAGATTGTGATGAAACCTAATAAAGTGACTGCTATTTCAAAGGAACCTTCAGTTAAGATGTACCATAAAACTGGCTCAACTACCGGTTTCGGAACATATGTGGTGTTTATTCCTAAAGAAAATATTGGTTTAGTCATGTTAACCAATAAACGTATTCC
gb|AF117745|+|0-780|ARO:3001079|SHV-21 [Klebsiella pneumoniae] 	5	725	51	771	780	1612535+	720	AGCCACCCTGCCGCTGGCGGTACACGCCAGCCCGCAGCCGCTTGAGCAAATTAAACAAAGCGAAAGCCAGCTGTCGGGCCGCGTAGGCATGATAGAAATGGATCTGGCCAGCGGCCGCACGCTGACCGCCTGGCGCGCCGATGAACGCTTTCCCATGATGAGCACCTTTAAAGTAGTGCTCTGCGGCGCAGTGCTGGCGCGGGTGGATGCCGGTGACGAACAGCTGGAGCGAAAGATCCACTATCGCCAGCAGGATCTGGTGGACTACTCGCCGGTCAGCGAAAAACACCTTGCCGACGGCATGACGGTCGGCGAACTCTGCGCCGCCGCCATTACCATGAGCGATAACAGCGCCGCCAATCTGCTGCTGGCCACCGTCGGCGGCCCCGCAGGATTGACTGCCTTTTTGCGCCAGATCGGCGACAACGTCACCCGCCTTGACCGCTGGGAAACGGAACTGAATGAGGCGCTTCCCGGCGACGCCCGCGACACCACTACCCCGGCCAGCATGGCCGCGACCCTGCGCAAGCTGCTGACCAGCCAGCGTCTGAGCGCCCGTTCGCAACGGCAGCTGCTGCAGTGGATGGTGGACGATCGGGTCGCCGGACCGTTGATCCGCTCCGTGCTGCCGGCGGGCTGGTTTATCGCCGATAAGACCGGAGCTAGCAAGCGGGGTGCGCGCGGGATTGTCGCCCTGCTTGGCCCGAATAACAAAGCAGA
gb|KP264125.1|+|83-905|ARO:3003640|OXA-483 [Acinetobacter baumannii] 	0	767	80	847	822	254088-	767	ATGAATAAATATTTTACTTGCTATGTGGTTGCTTCTCTTTTTCTTTCTGGTTGTACGGTTCAGCATAATTTAATAAATGAAACCCCGAGTCAGATTGTTCAAGGACATAATCAGGTGATTCATCAATACTTTGATGAAAAAAACACCTCAGGTGTGCTGGTTATTCAAACAGATAAAAAAATTAATCTATATGGTAATGCTCTAAGCCGCGCAAATACAGAATATGTGCCAGCCTCTACATTTAAAATGTTGAATGCCCTGATCGGATTGGAGAACCAGAAAACGGATATTAATGAAATATTTAAATGGAAGGGCGAGAAAAGGTCATTTACCGCTTGGGAAAAAGACATGACACTAGGAGAAGCCATGAAGCTTTCTGCAGTCCCAGTCTATCAGGAACTTGCGCGACGTATCGGTCTTGATCTCATGCAAAAAGAAGTAAAACGTATTGGTTTCGGTAATGCTGAAATTGGACAGCAGGTTGATAATTTCTGGTTGGTAGGACCATTAAAGGTTACGCCTATTCAAGAGGTAGAGTTTGTTTCCCAATTAGCACATACACAGCTTCCATTTAGTGAAAAAGTGCAGGCTAATGTAAAAAATATGCTTCTTTTAGAAGAGAGTAATGGCTACAAAATTTTTGGAAAGACTGGTTGGGCAATGGATATAAAACCACAAGTGGGCTGGTTGACCGGCTGGGTTGAGCAGCCAGATGGAAAAATTGTCGCTTTTGCATTAAATATGGAAATGCGGTCAGAAATGCCGGC
gb|HM559945|+|0-861|ARO:3001178|SHV-134 [Klebsiella pneumoniae] 	0	806	16	822	861	1612535+	806	ATGCGTTATATTCGCCTGTGTATTATCACCCTGTGAGCCACCCTGCCGCTGGCGGTACACGCCAGCCCGCAGCCGCTTGAGCAAATTAAACAAAGCGAAAGCCAGCTGTCGGGCCGCGTAGGCATGATAGAAATGGATCTGGCCAGCGGCCGCACGCTGACCGCCTGGCGCGCCGATGAACGCTTTCCCATGATGAGCACCTTTAAAGTAGTGCTCTGCGGCGCAGTGCTGGCGCGGGTGGATGCCGGTGACGAACAGCTGGAGCGAAAGATCCACTATCGCCAGCAGGATCTGGTGGACTACTCGCCGGTCAGCGAAAAACACCTTGCCGACGGCATGACGGTCGGCGAACTCTGCGCCGCCGCCATTACCATGAGCGATAACAGCGCCGCCAATCTGCTGCTGGCCACCGTCGGCGGCCCCGCAGGATTGACTGCCTTTTTGCGCCAGATCGGCGACAACGTCACCCGCCTTGACCGCTGGGAAACGGAACTGAATGAGGCGCTTCCCGGCGACGCCCGCGACACCACTACCCCGGCCAGCATGGCCGCGACCCTGCGCAAGCTGCTGACCAGCCAGCGTCTGAGCGCCCGTTCGCAACGGCAGCTGCTGCAGTGGATGGTGGACGATCGGGTCGCCGGACCGTTGATCCGCTCCGTGCTGCCGGCGGGCTGGTTTATCGCCGATAAGACCGGAGCTAGCAAGCGGGGTGCGCGCGGGATTGTCGCCCTGCTTGGCCCGAATAACAAAGCAGAGCGCATTGTGGTGATTTATCTGCGGGATACGCCGGCGAGCATGGCCGAGCG
gb|EU571228|+|822-1644|ARO:3001702|OXA-133 [Acinetobacter radioresistens] 	0	767	80	847	822	254088-	767	ATGAATAAATATTTTACTTGCTATGTGGTTGCTTCTCTTTTTCTTTCTGGTTGTACGGTTCAGCATAATTTAATAAATGAAACCCCGAGTCAGATTGTTCAAGGACATAATCAGGTGATTCATCAATACTTTGATGAAAAAAACACCTCAGGTGTGCTGGTTATTCAAACAGATAAAAAAATTAATCTATATGGTAATGCTCTAAGCCGCGCAAATACAGAATATGTGCCAGCCTCTACATTTAAAATGTTGAATGCCCTGATCGGATTGGAGAACCAGAAAACGGATATTAATGAAATATTTAAATGGAAGGGCGAGAAAAGGTCATTTACCGCTTGGGAAAAAGACATGACACTAGGAGAAGCCATGAAGCTTTCTGCAGTCCCAGTCTATCAGGAACTTGCGCGACGTATCGGTCTTGATCTCATGCAAAAAGAAGTAAAACGTATTGGTTTCGGTAATGCTGAAATTGGACAGCAGGTTGATAATTTCTGGTTGGTAGGACCATTAAAGGTTACGCCTATTCAAGAGGTAGAGTTTGTTTCCCAATTAGCACATACACAGCTTCCATTTAGTGAAAAAGTGCAGGCTAATGTAAAAAATATGCTTCTTTTAGAAGAGAGTAATGGCTACAAAATTTTTGGAAAGACTGGTTGGGCAATGGATATAAAACCACAAGTGGGCTGGTTGACCGGCTGGGTTGAGCAGCCAGATGGAAAAATTGTCGCTTTTGCATTAAATATGGAAATGCGGTCAGAAATGCCGGC
gb|DQ013287|+|0-861|ARO:3001124|SHV-70 [Enterobacter cloacae] 	0	806	16	822	861	1612535+	806	ATGCGTTATATTCGCCTGTGTATTATCACCCTGTGAGCCACCCTGCCGCTGGCGGTACACGCCAGCCCGCAGCCGCTTGAGCAAATTAAACAAAGCGAAAGCCAGCTGTCGGGCCGCGTAGGCATGATAGAAATGGATCTGGCCAGCGGCCGCACGCTGACCGCCTGGCGCGCCGATGAACGCTTTCCCATGATGAGCACCTTTAAAGTAGTGCTCTGCGGCGCAGTGCTGGCGCGGGTGGATGCCGGTGACGAACAGCTGGAGCGAAAGATCCACTATCGCCAGCAGGATCTGGTGGACTACTCGCCGGTCAGCGAAAAACACCTTGCCGACGGCATGACGGTCGGCGAACTCTGCGCCGCCGCCATTACCATGAGCGATAACAGCGCCGCCAATCTGCTGCTGGCCACCGTCGGCGGCCCCGCAGGATTGACTGCCTTTTTGCGCCAGATCGGCGACAACGTCACCCGCCTTGACCGCTGGGAAACGGAACTGAATGAGGCGCTTCCCGGCGACGCCCGCGACACCACTACCCCGGCCAGCATGGCCGCGACCCTGCGCAAGCTGCTGACCAGCCAGCGTCTGAGCGCCCGTTCGCAACGGCAGCTGCTGCAGTGGATGGTGGACGATCGGGTCGCCGGACCGTTGATCCGCTCCGTGCTGCCGGCGGGCTGGTTTATCGCCGATAAGACCGGAGCTAGCAAGCGGGGTGCGCGCGGGATTGTCGCCCTGCTTGGCCCGAATAACAAAGCAGAGCGCATTGTGGTGATTTATCTGCGGGATACGCCGGCGAGCATGGCCGAGCG
gb|HF947514|+|0-825|ARO:3001504|OXA-309 [Acinetobacter johnsonii] 	0	770	156	929	825	5350482-	773	ATGAAAACTTTACAGTTGGGCCTCATCGTCCTCATTACTACCTTCGGTTCTGCATGTACCATAATAAGAAGCCCCTCCATAGAAACAGCTAAAAACCATGAGCAACAAAGTGCGCAGCAGCAGATCCAACAGGCCTTCGATCAACTCCAAACCACGGGGGTGATTGTCATAAAGGATAAGCATGGCTTACACAGCTACGGCAATGACTTGAGCCGTGCTCAGACACCCTATGTACCCGCCTCTACCTTTAAAATGCTGAATGCCTTAATCGGACTAGAACATGGTAAAGCAACCAGCACCGAGGTGTTTAAATGGGATGGTCAAAAGAACAGCTTCCCTGCTTGGGAAAAAGACATGACTTTAGGGCAAGCCATGCAAGCATCTGCCGTTCCTGTTTATCAGGAGCTAGCACGGCGCATTGGCCTAGATCTAATGCAAAAAGAAGTACAGCGCATTGGATATGGCAATCAACAGATTGGCACCGTTGTCGATAATTTTTGGTTAGTCGGTCCACTGCAAATTACGCCTGTTCAAGAAGTCCTTTTTGTAGAGAAGCTGGCCAATACGCAACTCGCTTTTAAGCCAGATGTGCAACATACCGTACAAGACATGCTGCTGATTGAACAAAAACCGAATTATAAACTCTACGCCAAATCTGGTTGGGGCATGGACCTAGAACCGCAAGTGGGCTGGTGGACAGGCTGGGTCGAAACAGCAACAGGTGAAAAAGTGTATTTTGCTTTGAATATGCATATGAAAACAGGAATTTCAGC
gb|HQ637576|+|0-861|ARO:3001179|SHV-135 [Escherichia coli] 	0	806	16	822	861	1612535+	806	ATGCGTTATATTCGCCTGTGTATTATCACCCTGTGAGCCACCCTGCCGCTGGCGGTACACGCCAGCCCGCAGCCGCTTGAGCAAATTAAACAAAGCGAAAGCCAGCTGTCGGGCCGCGTAGGCATGATAGAAATGGATCTGGCCAGCGGCCGCACGCTGACCGCCTGGCGCGCCGATGAACGCTTTCCCATGATGAGCACCTTTAAAGTAGTGCTCTGCGGCGCAGTGCTGGCGCGGGTGGATGCCGGTGACGAACAGCTGGAGCGAAAGATCCACTATCGCCAGCAGGATCTGGTGGACTACTCGCCGGTCAGCGAAAAACACCTTGCCGACGGCATGACGGTCGGCGAACTCTGCGCCGCCGCCATTACCATGAGCGATAACAGCGCCGCCAATCTGCTGCTGGCCACCGTCGGCGGCCCCGCAGGATTGACTGCCTTTTTGCGCCAGATCGGCGACAACGTCACCCGCCTTGACCGCTGGGAAACGGAACTGAATGAGGCGCTTCCCGGCGACGCCCGCGACACCACTACCCCGGCCAGCATGGCCGCGACCCTGCGCAAGCTGCTGACCAGCCAGCGTCTGAGCGCCCGTTCGCAACGGCAGCTGCTGCAGTGGATGGTGGACGATCGGGTCGCCGGACCGTTGATCCGCTCCGTGCTGCCGGCGGGCTGGTTTATCGCCGATAAGACCGGAGCTAGCAAGCGGGGTGCGCGCGGGATTGTCGCCCTGCTTGGCCCGAATAACAAAGCAGAGCGCATTGTGGTGATTTATCTGCGGGATACGCCGGCGAGCATGGCCGAGCG
gb|AF117746|+|0-780|ARO:3001080|SHV-22 [Klebsiella pneumoniae] 	5	725	51	771	780	1612535+	720	AGCCACCCTGCCGCTGGCGGTACACGCCAGCCCGCAGCCGCTTGAGCAAATTAAACAAAGCGAAAGCCAGCTGTCGGGCCGCGTAGGCATGATAGAAATGGATCTGGCCAGCGGCCGCACGCTGACCGCCTGGCGCGCCGATGAACGCTTTCCCATGATGAGCACCTTTAAAGTAGTGCTCTGCGGCGCAGTGCTGGCGCGGGTGGATGCCGGTGACGAACAGCTGGAGCGAAAGATCCACTATCGCCAGCAGGATCTGGTGGACTACTCGCCGGTCAGCGAAAAACACCTTGCCGACGGCATGACGGTCGGCGAACTCTGCGCCGCCGCCATTACCATGAGCGATAACAGCGCCGCCAATCTGCTGCTGGCCACCGTCGGCGGCCCCGCAGGATTGACTGCCTTTTTGCGCCAGATCGGCGACAACGTCACCCGCCTTGACCGCTGGGAAACGGAACTGAATGAGGCGCTTCCCGGCGACGCCCGCGACACCACTACCCCGGCCAGCATGGCCGCGACCCTGCGCAAGCTGCTGACCAGCCAGCGTCTGAGCGCCCGTTCGCAACGGCAGCTGCTGCAGTGGATGGTGGACGATCGGGTCGCCGGACCGTTGATCCGCTCCGTGCTGCCGGCGGGCTGGTTTATCGCCGATAAGACCGGAGCTAGCAAGCGGGGTGCGCGCGGGATTGTCGCCCTGCTTGGCCCGAATAACAAAGCAGA
gb|EU670845|+|1594-2419|ARO:3001655|OXA-138 [Acinetobacter nosocomialis] 	0	770	54149	54919	825	246080-	770	ATGAACATTAAAGCACTCTTACTTATAACAAGCGCTATTTTTATTTCAGCCTGCTCACCTTATATAGTGACTGCTAATCCAAATCACAGCGCTTCAAAATCTGATGTAAAAGCAGAGAAAATTAAAAATTTATTTAACGAAGCACACACTACGGGTGTTTTAGTTATCCAACAAGGCCAAACTCAACAAAGCTATGGTAATGATCTTGCTCGTGCTTCGACCGAGTATGTACCTGCTTCGACCTTCAAAATGCTTAATGCTTTGATCGGCCTTGAGCACCATAAGGCAACCACCACAGAAGTATTTAAGTGGGATGGTAAAAAAAGGTTATTCCCAGAATGGGAAAAGGACATGACCCTAGGCGATGCCATGAAAGCTTCCGCTATTCCAGTTTATCAAGATTTAGCTCGTCGTATTGGACTTGAGCTCATGTCTAAGGAAGTGAAGCGTGTTGGTTATGGCAATGCAGATATCGGTACCCAAGTCGATAATTTTTGGCTGGTGGGTCCTTTAAAAATTACTCCTCAGCAAGAGGCACAGTTTGCTTACAAGCTAGCTAATAAAACGCTTCCATTTAGCCAAAAAGTCCAAGATGAAGTGCAATCCATGCTATTCATAGAAGAAAAGAATGGAAACAAAATATACGCAAAAAGTGGTTGGGGATGGGATGTAAACCCACAAGTAGGCTGGTTAACTGGATGGGTTGTTCAGCCTCAAGGGAATATTGTAGCGTTCTCCCTTAACTTAGAAATGAAAAAAGGAATACCTAG
gb|LLNM01000004.1|-|97677-98466|ARO:3003642|OXA-485 [Pseudomonas aeruginosa] 	0	734	19143	19877	789	237664-	734	ATGCGCCCTCTCCTCTTCAGCGCCCTTCTCCTGCTCTCCGGGCATGCCCAGGCCAGCGAATGGAACGACAGCCGGGCCGTGGACAAGCTATTCGGAGCGGCCGGTGTGAAAGGCACCTTCGTCCTTTACGATGTGCAGCGGCAGCGCTATGTCGGCCATGACCGGGAGCGCGCGGAAACCCGCTTCGTTCCCGCTTCCACCTACAAGGTGGCGAACAGCCTGATCGGCTTATCCACAGGGGCGGTTAGATCCGCCGACGAGGTTCTTCCCTATGGCGGCAAACCCCAGCGCTTCAAGGCCTGGGAGCACGACATGAGCCTGCGCGACGCGATCAAGGCATCGAACGTACCGGTCTACCAGGAACTGGCGCGGCGCATCGGCCTGGAGCGGATGCGCGCCAATGTCTCGCGCCTGGGTTACGGCAACGCGGAAATCGGCCAGGTTGTGGATAACTTCTGGTTGGTGGGACCGCTGAAGATCAGCGCGATGGAACAGACCCGCTTTCTGCTCCGACTGGCGCAGGGAGAATTGCCATTCCCCGCCCCGGTGCAGTCCACCGTGCGCGCCATGACCCTGCTGGAAAGCGGCCCGGGCTGGGAGCTGCACGGCAAGACCGGCTGGTGCTTCGACTGCACGCCGGAACTCGGCTGGTGGGTGGGCTGGGTGAAGCGCAACGAGCGGCTCTACGGCTTCGCCCTGAACATCGACATGCCCGGCGGCGAGGCCGACATCGG
gb|KF057029|+|0-825|ARO:3001683|OXA-312 [Acinetobacter baumannii] 	0	770	54149	54919	825	246080-	770	ATGAACATTAAAGCACTCTTACTTATAACAAGCGCTATTTTTATTTCAGCCTGCTCACCTTATATAGTGACTGCTAATCCAAATCACAGCGCTTCAAAATCTGATGTAAAAGCAGAGAAAATTAAAAATTTATTTAACGAAGCACACACTACGGGTGTTTTAGTTATCCAACAAGGCCAAACTCAACAAAGCTATGGTAATGATCTTGCTCGTGCTTCGACCGAGTATGTACCTGCTTCGACCTTCAAAATGCTTAATGCTTTGATCGGCCTTGAGCACCATAAGGCAACCACCACAGAAGTATTTAAGTGGGATGGTAAAAAAAGGTTATTCCCAGAATGGGAAAAGGACATGACCCTAGGCGATGCCATGAAAGCTTCCGCTATTCCAGTTTATCAAGATTTAGCTCGTCGTATTGGACTTGAGCTCATGTCTAAGGAAGTGAAGCGTGTTGGTTATGGCAATGCAGATATCGGTACCCAAGTCGATAATTTTTGGCTGGTGGGTCCTTTAAAAATTACTCCTCAGCAAGAGGCACAGTTTGCTTACAAGCTAGCTAATAAAACGCTTCCATTTAGCCAAAAAGTCCAAGATGAAGTGCAATCCATGCTATTCATAGAAGAAAAGAATGGAAACAAAATATACGCAAAAAGTGGTTGGGGATGGGATGTAAACCCACAAGTAGGCTGGTTAACTGGATGGGTTGTTCAGCCTCAAGGGAATATTGTAGCGTTCTCCCTTAACTTAGAAATGAAAAAAGGAATACCTAG
gb|KJ420612.1|+|1821-2622|ARO:3001409|OXA-14 [Pseudomonas aeruginosa] 	0	746	659	1405	801	104604+	746	ATGAAAACATTTGCCGCATATGTAATTATCGCGTGTCTTTCGAGTACGGCATTAGCTGGTTCAATTACAGAAAATACGTCTTGGAACAAAGAGTTCTCTGCCGAAGCCGTCAATGGTGTCTTCGTGCTTTGTAAAAGTAGCAGTAAATCCTGCGCTACCAATGACTTAGCTCGTGCATCAAAGGAATATCTTCCAGCATCAACATTTAAGATCCCCAACGCAATTATCGGCCTAGAAACTGGTGTCATAAAGAATGAGCATCAGGTTTTCAAATGGGACGGAAAGCCAAGAGCCATGAAGCAATGGGAAAGAGACTTGACCTTAAGAGGGGCAATACAAGTTTCAGCTGTTCCCGTATTTCAACAAATCGCCAGAGAAGTTGGCGAAGTAAGAATGCAGAAATACCTTAAAAAATTTTCCTATGGCAACCAGAATATCAGTGGTGGCATTGACAAATTCTGGTTGGAAGGCCAGCTTAGAATTTCCGCAGTTAATCAAGTGGAGTTTCTAGAGTCTCTATATTTAAATAAATTGTCAGCATCTAAAGAAAACCAGCTAATAGTAAAAGAGGCTTTGGTAACGGAGGCGGCACCTGAATATCTAGTGCATTCAAAAACTGGTTTTTCTGGTGTGGGAACTGAGTCAAATCCTGGTGTCGCATGGTGGGTTGGGTGGGTTGAGAAGGAGACAGAGGTTTACTTTTTCGCCTTTAACATGGATATAGACAACGAAAGTAAGTTGCCGCT
gb|AF117747|+|0-780|ARO:3001081|SHV-23 [Klebsiella pneumoniae] 	5	725	51	771	780	1612535+	720	AGCCACCCTGCCGCTGGCGGTACACGCCAGCCCGCAGCCGCTTGAGCAAATTAAACAAAGCGAAAGCCAGCTGTCGGGCCGCGTAGGCATGATAGAAATGGATCTGGCCAGCGGCCGCACGCTGACCGCCTGGCGCGCCGATGAACGCTTTCCCATGATGAGCACCTTTAAAGTAGTGCTCTGCGGCGCAGTGCTGGCGCGGGTGGATGCCGGTGACGAACAGCTGGAGCGAAAGATCCACTATCGCCAGCAGGATCTGGTGGACTACTCGCCGGTCAGCGAAAAACACCTTGCCGACGGCATGACGGTCGGCGAACTCTGCGCCGCCGCCATTACCATGAGCGATAACAGCGCCGCCAATCTGCTGCTGGCCACCGTCGGCGGCCCCGCAGGATTGACTGCCTTTTTGCGCCAGATCGGCGACAACGTCACCCGCCTTGACCGCTGGGAAACGGAACTGAATGAGGCGCTTCCCGGCGACGCCCGCGACACCACTACCCCGGCCAGCATGGCCGCGACCCTGCGCAAGCTGCTGACCAGCCAGCGTCTGAGCGCCCGTTCGCAACGGCAGCTGCTGCAGTGGATGGTGGACGATCGGGTCGCCGGACCGTTGATCCGCTCCGTGCTGCCGGCGGGCTGGTTTATCGCCGATAAGACCGGAGCTAGCAAGCGGGGTGCGCGCGGGATTGTCGCCCTGCTTGGCCCGAATAACAAAGCAGA
gb|KJ949070.1|+|0-1215|ARO:3005039|PDC-55 [Pseudomonas aeruginosa] 	0	1160	35513	36681	1215	232416+	1168	ATGCGCGATACCAGATTCCCCTGCCTGTGCGGCATCGCCGCTTCCACACTGCTGTTCGCCACCACCCCGGCCATTGCCGATGAGGCCCCGGCGGATCGCCTGAAGGCACTGGTCGACGCCGCCGTACAACCGGTGATGAAGGCCAATGACATTCCGGGCCTGGCCGTAGCCATCAGCCTGAAAGGAGAACCGCATTACTTCAGCTATGGGCTGGCCTCGAAAGAGGACGGCCGCCGGGTGACGCCGGAGACCCTGTTCGAGATCGGCTCGGTGAGCAAGACCTTCACCGTCACCCTCGCCGGCTATGCCCTGGCCCAGGACAAGATGCGCCTCGACGACCGCGCCAGCCAGCACTGGCCGGCACTGCAGGGCAGCCGCTTCGACGGCATCAGCCTGCTCGACCTCGCGACCTATACCGCCGGCGGCTTGCCGCTGCAGTTCCCCGACTCGGTGCAGAAGGACCAGGCACAGATCCGCGACTACTACCGCCAGTGGCAGCCGACCTACGCGCCGGGCAGCCAGCGCCTCTATTCCAACCCGAGCATCGGCCTGTTCGGCTATCTCGCCGCGCGCAGCCTGGGCCAGCCGTTCGAACGGCTCATGGAGCAGCAATTGTTCCCGGCACTGGGCCTCGAACAGACCCACCTCGACGTGCCCGAGGCGGCGCTGGCGCAGTACGCCCAGGGCTACGGCAAGGACGACCGCCCGCTACGGGTCGGTCCCGGCCCGCTGGATGCCGAAGGCTACGGGGTGAAGACCAGCGCGGCCGACCTGCTGCGCTTCGTCGATGCCAACCTGCATCCGGAGCGCCTGGACAGGCCCTGGGCGCAGGCGCTCGATGCCACCCATCGCGGTTACTACAAGGTCGGCGACATGACCCAGGGCCTGGGCTGGGAAGCCTACGACTGGCCGATCTCCCTGAAGCGCCTGCAGGCCGGCAACTCGACGCCGATGGCGCTGCAACCACACAGGATCGCCAGGCTGCCCGCGCCACAGGCGCTGGAGGGCCAGCGCCTGCTGAACAAGACCGGCTCCACCAACGGCTTCGGCGCCTACGTGGCGTTCGTCCCGGGCCGCGACCTGGGCCTGGTGATCCTGGCCAACCGCAACTATCCCAATGCCGAGCGGGTGAAGATCGCCTACGCCATCCTCAGCGGCCTGGAGCAGC
gb|AM176546|+|0-861|ARO:3001125|SHV-71 [Klebsiella pneumoniae] 	0	806	16	822	861	1612535+	806	ATGCGTTATATTCGCCTGTGTATTATCACCCTGTGAGCCACCCTGCCGCTGGCGGTACACGCCAGCCCGCAGCCGCTTGAGCAAATTAAACAAAGCGAAAGCCAGCTGTCGGGCCGCGTAGGCATGATAGAAATGGATCTGGCCAGCGGCCGCACGCTGACCGCCTGGCGCGCCGATGAACGCTTTCCCATGATGAGCACCTTTAAAGTAGTGCTCTGCGGCGCAGTGCTGGCGCGGGTGGATGCCGGTGACGAACAGCTGGAGCGAAAGATCCACTATCGCCAGCAGGATCTGGTGGACTACTCGCCGGTCAGCGAAAAACACCTTGCCGACGGCATGACGGTCGGCGAACTCTGCGCCGCCGCCATTACCATGAGCGATAACAGCGCCGCCAATCTGCTGCTGGCCACCGTCGGCGGCCCCGCAGGATTGACTGCCTTTTTGCGCCAGATCGGCGACAACGTCACCCGCCTTGACCGCTGGGAAACGGAACTGAATGAGGCGCTTCCCGGCGACGCCCGCGACACCACTACCCCGGCCAGCATGGCCGCGACCCTGCGCAAGCTGCTGACCAGCCAGCGTCTGAGCGCCCGTTCGCAACGGCAGCTGCTGCAGTGGATGGTGGACGATCGGGTCGCCGGACCGTTGATCCGCTCCGTGCTGCCGGCGGGCTGGTTTATCGCCGATAAGACCGGAGCTAGCAAGCGGGGTGCGCGCGGGATTGTCGCCCTGCTTGGCCCGAATAACAAAGCAGAGCGCATTGTGGTGATTTATCTGCGGGATACGCCGGCGAGCATGGCCGAGCG
gb|DQ883640.1|+|0-1167|ARO:3003855|ADC-10 [Acinetobacter baumannii] 	0	1112	63	1160	1167	126080+	1097	ATGCGATTTAAAAAAATTTCTTGTCTACTTTTATCCCCGCTTTTTATTTTTAGTACCTCAATTTATGCGGGCAATACACCAAAAGACCAAGAAATTAAAAAACTGGTAGATCAAAACTTTAAACCGTTATTAGAAAAATATGATGTGCCAGGTATGGCTGTGGGTGTTATTCAAAATAATAAAAAGTATGAAATGTATTATGGTCTTCAATCTGTTCAAGATAAAAAAGCCGTAAATAGCAGTACTATTTTTGAGCTAGGTTCTGTCAGTAAATTATTTACCGCGACAGCAGGTGGATATGCAAAAAATAAAGGAAAAATCTCTTTTGACGATACGCCTGGTAAGTATTGGAAAGAACTAAAAAATACACCGATTGACCAAGTTAACTTACTTCAACTCGCGACGTATACAAGTGGTAACCTTGCCTTGCAATTTCCAGATGAAGTAAAAACAGATCAGCAAGTTTTAACATTTTTTAAAGACTGGAAACCTAAAAACTCAATCGGTGAATATCGACAATATTCAAACCCAAGCATTGGTTTATTTGGAAAAGTTGTAGCTTTGTCTATGAATAAACCTTTCGACCAAGTCTTAGAAAAAACAATTTTTCCGGCCCTTGGCTTAAAACATAGCTATGTAAATGTACCTAAGACCCAGATGCAAAACTATGCTTTTGGCTATAACCAAGAAAATCAGCCGATTCGAGTTAACCCCGGCCCACTCGATGCCCCAGCATATGGCGTCAAATCGACACTACCCGACATGTTGAGTTTTATTCATGCCAACCTAAATCCACAAAAATATCCAGCAGATATTCAACGGGCAATTAATGAAACACATCAGGGTCGCTATCAAGTAAATACCATGTATCAGGCACTCGGTTGGGAAGAGTTTTCTTATCCGGCAACGTTACAAACTTTATTAGACAGTAATTCAGAACAGATTGTGATGAAACCTAATAAAGTGACTGCTATTTCAAAGGAACCTTCAGTTAAGATGTACCATAAAACTGGCTCAACTACCGGTTTCGGAACATATGTGGTGTTTATTCCTAAAGAAAATATTGGTTTAGTCATGTTAACCAATAAACGTATTCC
gb|CP038661.1|+|6223618-6224407|ARO:3003643|OXA-486 [Pseudomonas aeruginosa] 	0	734	19143	19877	789	237664-	734	ATGCGCCCTCTCCTCTTCAGCGCCCTTCTCCTGCTCTCCGGGCATGCCCAGGCCAGCGAATGGAACGACAGCCGGGCCGTGGACAAGCTATTCGGAGCGGCCGGTGTGAAAGGCACCTTCGTCCTTTACGATGTGCAGCGGCAGCGCTATGTCGGCCATGACCGGGAGCGCGCGGAAACCCGCTTCGTTCCCGCTTCCACCTACAAGGTGGCGAACAGCCTGATCGGCTTATCCACAGGGGCGGTTAGATCCGCCGACGAGGTTCTTCCCTATGGCGGCAAACCCCAGCGCTTCAAGGCCTGGGAGCACGACATGAGCCTGCGCGACGCGATCAAGGCATCGAACGTACCGGTCTACCAGGAACTGGCGCGGCGCATCGGCCTGGAGCGGATGCGCGCCAATGTCTCGCGCCTGGGTTACGGCAACGCGGAAATCGGCCAGGTTGTGGATAACTTCTGGTTGGTGGGACCGCTGAAGATCAGCGCGATGGAACAGACCCGCTTTCTGCTCCGACTGGCGCAGGGAGAATTGCCATTCCCCGCCCCGGTGCAGTCCACCGTGCGCGCCATGACCCTGCTGGAAAGCGGCCCGGGCTGGGAGCTGCACGGCAAGACCGGCTGGTGCTTCGACTGCACGCCGGAACTCGGCTGGTGGGTGGGCTGGGTGAAGCGCAACGAGCGGCTCTACGGCTTCGCCCTGAACATCGACATGCCCGGCGGCGAGGCCGACATCGG
gb|AM176547|+|30-891|ARO:3001126|SHV-72 [Klebsiella pneumoniae] 	0	806	16	822	861	1612535+	806	ATGCGTTATATTCGCCTGTGTATTATCACCCTGTGAGCCACCCTGCCGCTGGCGGTACACGCCAGCCCGCAGCCGCTTGAGCAAATTAAACAAAGCGAAAGCCAGCTGTCGGGCCGCGTAGGCATGATAGAAATGGATCTGGCCAGCGGCCGCACGCTGACCGCCTGGCGCGCCGATGAACGCTTTCCCATGATGAGCACCTTTAAAGTAGTGCTCTGCGGCGCAGTGCTGGCGCGGGTGGATGCCGGTGACGAACAGCTGGAGCGAAAGATCCACTATCGCCAGCAGGATCTGGTGGACTACTCGCCGGTCAGCGAAAAACACCTTGCCGACGGCATGACGGTCGGCGAACTCTGCGCCGCCGCCATTACCATGAGCGATAACAGCGCCGCCAATCTGCTGCTGGCCACCGTCGGCGGCCCCGCAGGATTGACTGCCTTTTTGCGCCAGATCGGCGACAACGTCACCCGCCTTGACCGCTGGGAAACGGAACTGAATGAGGCGCTTCCCGGCGACGCCCGCGACACCACTACCCCGGCCAGCATGGCCGCGACCCTGCGCAAGCTGCTGACCAGCCAGCGTCTGAGCGCCCGTTCGCAACGGCAGCTGCTGCAGTGGATGGTGGACGATCGGGTCGCCGGACCGTTGATCCGCTCCGTGCTGCCGGCGGGCTGGTTTATCGCCGATAAGACCGGAGCTAGCAAGCGGGGTGCGCGCGGGATTGTCGCCCTGCTTGGCCCGAATAACAAAGCAGAGCGCATTGTGGTGATTTATCTGCGGGATACGCCGGCGAGCATGGCCGAGCG
gb|AB023477|+|0-861|ARO:3001082|SHV-24 [Escherichia coli] 	0	806	16	822	861	1612535+	806	ATGCGTTATATTCGCCTGTGTATTATCACCCTGTGAGCCACCCTGCCGCTGGCGGTACACGCCAGCCCGCAGCCGCTTGAGCAAATTAAACAAAGCGAAAGCCAGCTGTCGGGCCGCGTAGGCATGATAGAAATGGATCTGGCCAGCGGCCGCACGCTGACCGCCTGGCGCGCCGATGAACGCTTTCCCATGATGAGCACCTTTAAAGTAGTGCTCTGCGGCGCAGTGCTGGCGCGGGTGGATGCCGGTGACGAACAGCTGGAGCGAAAGATCCACTATCGCCAGCAGGATCTGGTGGACTACTCGCCGGTCAGCGAAAAACACCTTGCCGACGGCATGACGGTCGGCGAACTCTGCGCCGCCGCCATTACCATGAGCGATAACAGCGCCGCCAATCTGCTGCTGGCCACCGTCGGCGGCCCCGCAGGATTGACTGCCTTTTTGCGCCAGATCGGCGACAACGTCACCCGCCTTGACCGCTGGGAAACGGAACTGAATGAGGCGCTTCCCGGCGACGCCCGCGACACCACTACCCCGGCCAGCATGGCCGCGACCCTGCGCAAGCTGCTGACCAGCCAGCGTCTGAGCGCCCGTTCGCAACGGCAGCTGCTGCAGTGGATGGTGGACGATCGGGTCGCCGGACCGTTGATCCGCTCCGTGCTGCCGGCGGGCTGGTTTATCGCCGATAAGACCGGAGCTAGCAAGCGGGGTGCGCGCGGGATTGTCGCCCTGCTTGGCCCGAATAACAAAGCAGAGCGCATTGTGGTGATTTATCTGCGGGATACGCCGGCGAGCATGGCCGAGCG
gb|HQ661363|+|71-932|ARO:3001181|SHV-137 [Klebsiella pneumoniae] 	0	806	16	822	861	1612535+	806	ATGCGTTATATTCGCCTGTGTATTATCACCCTGTGAGCCACCCTGCCGCTGGCGGTACACGCCAGCCCGCAGCCGCTTGAGCAAATTAAACAAAGCGAAAGCCAGCTGTCGGGCCGCGTAGGCATGATAGAAATGGATCTGGCCAGCGGCCGCACGCTGACCGCCTGGCGCGCCGATGAACGCTTTCCCATGATGAGCACCTTTAAAGTAGTGCTCTGCGGCGCAGTGCTGGCGCGGGTGGATGCCGGTGACGAACAGCTGGAGCGAAAGATCCACTATCGCCAGCAGGATCTGGTGGACTACTCGCCGGTCAGCGAAAAACACCTTGCCGACGGCATGACGGTCGGCGAACTCTGCGCCGCCGCCATTACCATGAGCGATAACAGCGCCGCCAATCTGCTGCTGGCCACCGTCGGCGGCCCCGCAGGATTGACTGCCTTTTTGCGCCAGATCGGCGACAACGTCACCCGCCTTGACCGCTGGGAAACGGAACTGAATGAGGCGCTTCCCGGCGACGCCCGCGACACCACTACCCCGGCCAGCATGGCCGCGACCCTGCGCAAGCTGCTGACCAGCCAGCGTCTGAGCGCCCGTTCGCAACGGCAGCTGCTGCAGTGGATGGTGGACGATCGGGTCGCCGGACCGTTGATCCGCTCCGTGCTGCCGGCGGGCTGGTTTATCGCCGATAAGACCGGAGCTAGCAAGCGGGGTGCGCGCGGGATTGTCGCCCTGCTTGGCCCGAATAACAAAGCAGAGCGCATTGTGGTGATTTATCTGCGGGATACGCCGGCGAGCATGGCCGAGCG
gb|EU358785|+|720-1521|ARO:3001803|OXA-142 [Pseudomonas aeruginosa] 	0	746	659	1405	801	104604+	746	ATGAAAACATTTGCCGCATATGTAATTATCGCGTGTCTTTCGAGTACGGCATTAGCTGGTTCAATTACAGAAAATACGTCTTGGAACAAAGAGTTCTCTGCCGAAGCCGTCAATGGTGTCTTCGTGCTTTGTAAAAGTAGCAGTAAATCCTGCGCTACCAATGACTTAGCTCGTGCATCAAAGGAATATCTTCCAGCATCAACATTTAAGATCCCCAACGCAATTATCGGCCTAGAAACTGGTGTCATAAAGAATGAGCATCAGGTTTTCAAATGGGACGGAAAGCCAAGAGCCATGAAGCAATGGGAAAGAGACTTGACCTTAAGAGGGGCAATACAAGTTTCAGCTGTTCCCGTATTTCAACAAATCGCCAGAGAAGTTGGCGAAGTAAGAATGCAGAAATACCTTAAAAAATTTTCCTATGGCAACCAGAATATCAGTGGTGGCATTGACAAATTCTGGTTGGAAGGCCAGCTTAGAATTTCCGCAGTTAATCAAGTGGAGTTTCTAGAGTCTCTATATTTAAATAAATTGTCAGCATCTAAAGAAAACCAGCTAATAGTAAAAGAGGCTTTGGTAACGGAGGCGGCACCTGAATATCTAGTGCATTCAAAAACTGGTTTTTCTGGTGTGGGAACTGAGTCAAATCCTGGTGTCGCATGGTGGGTTGGGTGGGTTGAGAAGGAGACAGAGGTTTACTTTTTCGCCTTTAACATGGATATAGACAACGAAAGTAAGTTGCCGCT
gb|SMRY02000082.1|-|17219-18008|ARO:3003645|OXA-488 [Pseudomonas aeruginosa] 	0	734	19143	19877	789	237664-	734	ATGCGCCCTCTCCTCTTCAGCGCCCTTCTCCTGCTCTCCGGGCATGCCCAGGCCAGCGAATGGAACGACAGCCGGGCCGTGGACAAGCTATTCGGAGCGGCCGGTGTGAAAGGCACCTTCGTCCTTTACGATGTGCAGCGGCAGCGCTATGTCGGCCATGACCGGGAGCGCGCGGAAACCCGCTTCGTTCCCGCTTCCACCTACAAGGTGGCGAACAGCCTGATCGGCTTATCCACAGGGGCGGTTAGATCCGCCGACGAGGTTCTTCCCTATGGCGGCAAACCCCAGCGCTTCAAGGCCTGGGAGCACGACATGAGCCTGCGCGACGCGATCAAGGCATCGAACGTACCGGTCTACCAGGAACTGGCGCGGCGCATCGGCCTGGAGCGGATGCGCGCCAATGTCTCGCGCCTGGGTTACGGCAACGCGGAAATCGGCCAGGTTGTGGATAACTTCTGGTTGGTGGGACCGCTGAAGATCAGCGCGATGGAACAGACCCGCTTTCTGCTCCGACTGGCGCAGGGAGAATTGCCATTCCCCGCCCCGGTGCAGTCCACCGTGCGCGCCATGACCCTGCTGGAAAGCGGCCCGGGCTGGGAGCTGCACGGCAAGACCGGCTGGTGCTTCGACTGCACGCCGGAACTCGGCTGGTGGGTGGGCTGGGTGAAGCGCAACGAGCGGCTCTACGGCTTCGCCCTGAACATCGACATGCCCGGCGGCGAGGCCGACATCGG
gb|AM176548|+|16-874|ARO:3001127|SHV-73 [Klebsiella pneumoniae] 	0	803	16	822	858	1612535+	806	ATGCGTTATATTCGCCTGTGTATTATCACCCTGTGAGCCACCCTGCCGCTGGCGGTACACGCCAGCCCGCAGCCGCTTGAGCAAATTAAACAAAGCGAAAGCCAGCTGTCGGGCCGCGTAGGCATGATAGAAATGGATCTGGCCAGCGGCCGCACGCTGACCGCCTGGCGCGCCGATGAACGCTTTCCCATGATGAGCACCTTTAAAGTAGTGCTCTGCGGCGCAGTGCTGGCGCGGGTGGATGCCGGTGACGAACAGCTGGAGCGAAAGATCCACTATCGCCAGCAGGATCTGGTGGACTACTCGCCGGTCAGCGAAAAACACCTTGCCGACGGCATGACGGTCGGCGAACTCTGCGCCGCCGCCATTACCATGAGCGATAACAGCGCCGCCAATCTGCTGCTGGCCACCGTCGGCGGCCCCGCAGGATTGACTGCCTTTTTGCGCCAGATCGGCGACAACGTCACCCGCCTTGACCGCTGGGAAACGGAACTGAATGAGGCGCTTCCCGGCGACGCCCGCGACACCACTACCCCGGCCAGCATGGCCGCGACCCTGCGCAAGCTGCTGACCAGCCAGCGTCTGAGCGCCCGTTCGCAACGGCAGCTGCTGCAGTGGATGGTGGACGATCGGGTCGCCGGACCGTTGATCCGCTCCGTGCTGCCGGCGGGCTGGTTTATCGCCGATAAGACCGGAGCTAGCAAGCGGGGTGCGCGCGGGATTGTCGCCCTGCTTGGCCCGAATAACAAAGCAGAGCGCATTGTGGTGATTTATCTGCGGGATACGCCGGCGAGCATGGCCGAGCG
gb|FJ666069|+|0-1194|ARO:3002505|PDC-6 [Pseudomonas aeruginosa] 	0	1139	35513	36652	1194	232416+	1139	ATGCGCGATACCAGATTCCCCTGCCTGTGCGGCATCGCCGCTTCCACACTGCTGTTCGCCACCACCCCGGCCATTGCCGATGAGGCCCCGGCGGATCGCCTGAAGGCACTGGTCGACGCCGCCGTACAACCGGTGATGAAGGCCAATGACATTCCGGGCCTGGCCGTAGCCATCAGCCTGAAAGGAGAACCGCATTACTTCAGCTATGGGCTGGCCTCGAAAGAGGACGGCCGCCGGGTGACGCCGGAGACCCTGTTCGAGATCGGCTCGGTGAGCAAGACCTTCACCGTCACCCTCGCCGGCTATGCCCTGGCCCAGGACAAGATGCGCCTCGACGACCGCGCCAGCCAGCACTGGCCGGCACTGCAGGGCAGCCGCTTCGACGGCATCAGCCTGCTCGACCTCGCGACCTATACCGCCGGCGGCTTGCCGCTGCAGTTCCCCGACTCGGTGCAGAAGGACCAGGCACAGATCCGCGACTACTACCGCCAGTGGCAGCCGACCTACGCGCCGGGCAGCCAGCGCCTCTATTCCAACCCGAGCATCGGCCTGTTCGGCTATCTCGCCGCGCGCAGCCTGGGCCAGCCGTTCGAACGGCTCATGGAGCAGCAATTGTTCCCGGCACTGGGCCTCGAACAGACCCACCTCGACGTGCCCGAGGCGGCGCTGGCGCAGTACGCCCAGGGCTACGGCAAGGACGACCGCCCGCTACGGGTCGGTCCCGGCCCGCTGGATGCCGAAGGCTACGGGGTGAAGACCAGCGCGGCCGACCTGCTGCGCTTCGTCGATGCCAACCTGCATCCGGAGCGCCTGGACAGGCCCTGGGCGCAGGCGCTCGATGCCACCCATCGCGGTTACTACAAGGTCGGCGACATGACCCAGGGCCTGGGCTGGGAAGCCTACGACTGGCCGATCTCCCTGAAGCGCCTGCAGGCCGGCAACTCGACGCCGATGGCGCTGCAACCACACAGGATCGCCAGGCTGCCCGCGCCACAGGCGCTGGAGGGCCAGCGCCTGCTGAACAAGACCGGCTCCACCAACGGCTTCGGCGCCTACGTGGCGTTCGTCCCGGGCCGCGACCTGGGCCTGGTGATCCTGGCCAACCGCAACTATCCCAATGCCGAGCGGGTGAAGATCGC
gb|AF226622|+|54-915|ARO:3001073|SHV-14 [Klebsiella pneumoniae] 	0	806	16	822	861	1612535+	806	ATGCGTTATATTCGCCTGTGTATTATCACCCTGTGAGCCACCCTGCCGCTGGCGGTACACGCCAGCCCGCAGCCGCTTGAGCAAATTAAACAAAGCGAAAGCCAGCTGTCGGGCCGCGTAGGCATGATAGAAATGGATCTGGCCAGCGGCCGCACGCTGACCGCCTGGCGCGCCGATGAACGCTTTCCCATGATGAGCACCTTTAAAGTAGTGCTCTGCGGCGCAGTGCTGGCGCGGGTGGATGCCGGTGACGAACAGCTGGAGCGAAAGATCCACTATCGCCAGCAGGATCTGGTGGACTACTCGCCGGTCAGCGAAAAACACCTTGCCGACGGCATGACGGTCGGCGAACTCTGCGCCGCCGCCATTACCATGAGCGATAACAGCGCCGCCAATCTGCTGCTGGCCACCGTCGGCGGCCCCGCAGGATTGACTGCCTTTTTGCGCCAGATCGGCGACAACGTCACCCGCCTTGACCGCTGGGAAACGGAACTGAATGAGGCGCTTCCCGGCGACGCCCGCGACACCACTACCCCGGCCAGCATGGCCGCGACCCTGCGCAAGCTGCTGACCAGCCAGCGTCTGAGCGCCCGTTCGCAACGGCAGCTGCTGCAGTGGATGGTGGACGATCGGGTCGCCGGACCGTTGATCCGCTCCGTGCTGCCGGCGGGCTGGTTTATCGCCGATAAGACCGGAGCTAGCAAGCGGGGTGCGCGCGGGATTGTCGCCCTGCTTGGCCCGAATAACAAAGCAGAGCGCATTGTGGTGATTTATCTGCGGGATACGCCGGCGAGCATGGCCGAGCG
gb|AY288523|+|0-825|ARO:3001671|OXA-49 [Acinetobacter baumannii] 	0	770	80	847	825	254088-	767	ATGAATAAATATTTTACTTGCTATGTGGTTGCTTCTCTTTTTCTTTCTGGTTGTACGGTTCAGCATAATTTAATAAATGAAACCCCGAGTCAGATTGTTCAAGGACATAATCAGGTGATTCATCAATACTTTGATGAAAAAAACACCTCAGGTGTGCTGGTTATTCAAACAGATAAAAAAATTAATCTATATGGTAATGCTCTAAGCCGCGCAAATACAGAATATGTGCCAGCCTCTACATTTAAAATGTTGAATGCCCTGATCGGATTGGAGAACCAGAAAACGGATATTAATGAAATATTTAAATGGAAGGGCGAGAAAAGGTCATTTACCGCTTGGGAAAAAGACATGACACTAGGAGAAGCCATGAAGCTTTCTGCAGTCCCAGTCTATCAGGAACTTGCGCGACGTATCGGTCTTGATCTCATGCAAAAAGAAGTAAAACGTATTGGTTTCGGTAATGCTGAAATTGGACAGCAGGTTGATAATTTCTGGTTGGTAGGACCATTAAAGGTTACGCCTATTCAAGAGGTAGAGTTTGTTTCCCAATTAGCACATACACAGCTTCCATTTAGTGAAAAAGTGCAGGCTAATGTAAAAAATATGCTTCTTTTAGAAGAGAGTAATGGCTACAAAATTTTTGGAAAGACTGGTTGGGCAATGGATATAAAACCACAAGTGGGCTGGTTGACCGGCTGGGTTGAGCAGCCAGATGGAAAAATTGTCGCTTTTGCATTAAATATGGAAATGCGGTCAGAAATGCCGGC
gb|AF208796|+|0-861|ARO:3001083|SHV-25 [Klebsiella pneumoniae] 	0	806	16	822	861	1612535+	806	ATGCGTTATATTCGCCTGTGTATTATCACCCTGTGAGCCACCCTGCCGCTGGCGGTACACGCCAGCCCGCAGCCGCTTGAGCAAATTAAACAAAGCGAAAGCCAGCTGTCGGGCCGCGTAGGCATGATAGAAATGGATCTGGCCAGCGGCCGCACGCTGACCGCCTGGCGCGCCGATGAACGCTTTCCCATGATGAGCACCTTTAAAGTAGTGCTCTGCGGCGCAGTGCTGGCGCGGGTGGATGCCGGTGACGAACAGCTGGAGCGAAAGATCCACTATCGCCAGCAGGATCTGGTGGACTACTCGCCGGTCAGCGAAAAACACCTTGCCGACGGCATGACGGTCGGCGAACTCTGCGCCGCCGCCATTACCATGAGCGATAACAGCGCCGCCAATCTGCTGCTGGCCACCGTCGGCGGCCCCGCAGGATTGACTGCCTTTTTGCGCCAGATCGGCGACAACGTCACCCGCCTTGACCGCTGGGAAACGGAACTGAATGAGGCGCTTCCCGGCGACGCCCGCGACACCACTACCCCGGCCAGCATGGCCGCGACCCTGCGCAAGCTGCTGACCAGCCAGCGTCTGAGCGCCCGTTCGCAACGGCAGCTGCTGCAGTGGATGGTGGACGATCGGGTCGCCGGACCGTTGATCCGCTCCGTGCTGCCGGCGGGCTGGTTTATCGCCGATAAGACCGGAGCTAGCAAGCGGGGTGCGCGCGGGATTGTCGCCCTGCTTGGCCCGAATAACAAAGCAGAGCGCATTGTGGTGATTTATCTGCGGGATACGCCGGCGAGCATGGCCGAGCG
gb|AM176549|+|30-891|ARO:3001128|SHV-74 [Klebsiella pneumoniae] 	0	806	16	822	861	1612535+	806	ATGCGTTATATTCGCCTGTGTATTATCACCCTGTGAGCCACCCTGCCGCTGGCGGTACACGCCAGCCCGCAGCCGCTTGAGCAAATTAAACAAAGCGAAAGCCAGCTGTCGGGCCGCGTAGGCATGATAGAAATGGATCTGGCCAGCGGCCGCACGCTGACCGCCTGGCGCGCCGATGAACGCTTTCCCATGATGAGCACCTTTAAAGTAGTGCTCTGCGGCGCAGTGCTGGCGCGGGTGGATGCCGGTGACGAACAGCTGGAGCGAAAGATCCACTATCGCCAGCAGGATCTGGTGGACTACTCGCCGGTCAGCGAAAAACACCTTGCCGACGGCATGACGGTCGGCGAACTCTGCGCCGCCGCCATTACCATGAGCGATAACAGCGCCGCCAATCTGCTGCTGGCCACCGTCGGCGGCCCCGCAGGATTGACTGCCTTTTTGCGCCAGATCGGCGACAACGTCACCCGCCTTGACCGCTGGGAAACGGAACTGAATGAGGCGCTTCCCGGCGACGCCCGCGACACCACTACCCCGGCCAGCATGGCCGCGACCCTGCGCAAGCTGCTGACCAGCCAGCGTCTGAGCGCCCGTTCGCAACGGCAGCTGCTGCAGTGGATGGTGGACGATCGGGTCGCCGGACCGTTGATCCGCTCCGTGCTGCCGGCGGGCTGGTTTATCGCCGATAAGACCGGAGCTAGCAAGCGGGGTGCGCGCGGGATTGTCGCCCTGCTTGGCCCGAATAACAAAGCAGAGCGCATTGTGGTGATTTATCTGCGGGATACGCCGGCGAGCATGGCCGAGCG
gb|FJ872530|+|0-825|ARO:3002480|OXA-144 [Acinetobacter baumannii] 	0	770	54149	54919	825	246080-	770	ATGAACATTAAAGCACTCTTACTTATAACAAGCGCTATTTTTATTTCAGCCTGCTCACCTTATATAGTGACTGCTAATCCAAATCACAGCGCTTCAAAATCTGATGTAAAAGCAGAGAAAATTAAAAATTTATTTAACGAAGCACACACTACGGGTGTTTTAGTTATCCAACAAGGCCAAACTCAACAAAGCTATGGTAATGATCTTGCTCGTGCTTCGACCGAGTATGTACCTGCTTCGACCTTCAAAATGCTTAATGCTTTGATCGGCCTTGAGCACCATAAGGCAACCACCACAGAAGTATTTAAGTGGGATGGTAAAAAAAGGTTATTCCCAGAATGGGAAAAGGACATGACCCTAGGCGATGCCATGAAAGCTTCCGCTATTCCAGTTTATCAAGATTTAGCTCGTCGTATTGGACTTGAGCTCATGTCTAAGGAAGTGAAGCGTGTTGGTTATGGCAATGCAGATATCGGTACCCAAGTCGATAATTTTTGGCTGGTGGGTCCTTTAAAAATTACTCCTCAGCAAGAGGCACAGTTTGCTTACAAGCTAGCTAATAAAACGCTTCCATTTAGCCAAAAAGTCCAAGATGAAGTGCAATCCATGCTATTCATAGAAGAAAAGAATGGAAACAAAATATACGCAAAAAGTGGTTGGGGATGGGATGTAAACCCACAAGTAGGCTGGTTAACTGGATGGGTTGTTCAGCCTCAAGGGAATATTGTAGCGTTCTCCCTTAACTTAGAAATGAAAAAAGGAATACCTAG
gb|KF057030|+|0-825|ARO:3001684|OXA-313 [Acinetobacter baumannii] 	0	770	54149	54919	825	246080-	770	ATGAACATTAAAGCACTCTTACTTATAACAAGCGCTATTTTTATTTCAGCCTGCTCACCTTATATAGTGACTGCTAATCCAAATCACAGCGCTTCAAAATCTGATGTAAAAGCAGAGAAAATTAAAAATTTATTTAACGAAGCACACACTACGGGTGTTTTAGTTATCCAACAAGGCCAAACTCAACAAAGCTATGGTAATGATCTTGCTCGTGCTTCGACCGAGTATGTACCTGCTTCGACCTTCAAAATGCTTAATGCTTTGATCGGCCTTGAGCACCATAAGGCAACCACCACAGAAGTATTTAAGTGGGATGGTAAAAAAAGGTTATTCCCAGAATGGGAAAAGGACATGACCCTAGGCGATGCCATGAAAGCTTCCGCTATTCCAGTTTATCAAGATTTAGCTCGTCGTATTGGACTTGAGCTCATGTCTAAGGAAGTGAAGCGTGTTGGTTATGGCAATGCAGATATCGGTACCCAAGTCGATAATTTTTGGCTGGTGGGTCCTTTAAAAATTACTCCTCAGCAAGAGGCACAGTTTGCTTACAAGCTAGCTAATAAAACGCTTCCATTTAGCCAAAAAGTCCAAGATGAAGTGCAATCCATGCTATTCATAGAAGAAAAGAATGGAAACAAAATATACGCAAAAAGTGGTTGGGGATGGGATGTAAACCCACAAGTAGGCTGGTTAACTGGATGGGTTGTTCAGCCTCAAGGGAATATTGTAGCGTTCTCCCTTAACTTAGAAATGAAAAAAGGAATACCTAG
gb|AY306130|+|0-789|ARO:3001796|OXA-50 [Pseudomonas aeruginosa] 	0	734	19143	19877	789	237664-	734	ATGCGCCCTCTCCTCTTCAGCGCCCTTCTCCTGCTCTCCGGGCATGCCCAGGCCAGCGAATGGAACGACAGCCGGGCCGTGGACAAGCTATTCGGAGCGGCCGGTGTGAAAGGCACCTTCGTCCTTTACGATGTGCAGCGGCAGCGCTATGTCGGCCATGACCGGGAGCGCGCGGAAACCCGCTTCGTTCCCGCTTCCACCTACAAGGTGGCGAACAGCCTGATCGGCTTATCCACAGGGGCGGTTAGATCCGCCGACGAGGTTCTTCCCTATGGCGGCAAACCCCAGCGCTTCAAGGCCTGGGAGCACGACATGAGCCTGCGCGACGCGATCAAGGCATCGAACGTACCGGTCTACCAGGAACTGGCGCGGCGCATCGGCCTGGAGCGGATGCGCGCCAATGTCTCGCGCCTGGGTTACGGCAACGCGGAAATCGGCCAGGTTGTGGATAACTTCTGGTTGGTGGGACCGCTGAAGATCAGCGCGATGGAACAGACCCGCTTTCTGCTCCGACTGGCGCAGGGAGAATTGCCATTCCCCGCCCCGGTGCAGTCCACCGTGCGCGCCATGACCCTGCTGGAAAGCGGCCCGGGCTGGGAGCTGCACGGCAAGACCGGCTGGTGCTTCGACTGCACGCCGGAACTCGGCTGGTGGGTGGGCTGGGTGAAGCGCAACGAGCGGCTCTACGGCTTCGCCCTGAACATCGACATGCCCGGCGGCGAGGCCGACATCGG
gb|GU591983.1|+|0-1152|ARO:3004615|ADC-11 [Acinetobacter baumannii AYE] 	0	1097	63	1160	1152	126080+	1097	ATGCGATTTAAAAAAATTTCTTGTCTACTTTTATCCCCGCTTTTTATTTTTAGTACCTCAATTTATGCGGGCAATACACCAAAAGACCAAGAAATTAAAAAACTGGTAGATCAAAACTTTAAACCGTTATTAGAAAAATATGATGTGCCAGGTATGGCTGTGGGTGTTATTCAAAATAATAAAAAGTATGAAATGTATTATGGTCTTCAATCTGTTCAAGATAAAAAAGCCGTAAATAGCAGTACTATTTTTGAGCTAGGTTCTGTCAGTAAATTATTTACCGCGACAGCAGGTGGATATGCAAAAAATAAAGGAAAAATCTCTTTTGACGATACGCCTGGTAAGTATTGGAAAGAACTAAAAAATACACCGATTGACCAAGTTAACTTACTTCAACTCGCGACGTATACAAGTGGTAACCTTGCCTTGCAATTTCCAGATGAAGTAAAAACAGATCAGCAAGTTTTAACATTTTTTAAAGACTGGAAACCTAAAAACTCAATCGGTGAATATCGACAATATTCAAACCCAAGCATTGGTTTATTTGGAAAAGTTGTAGCTTTGTCTATGAATAAACCTTTCGACCAAGTCTTAGAAAAAACAATTTTTCCGGCCCTTGGCTTAAAACATAGCTATGTAAATGTACCTAAGACCCAGATGCAAAACTATGCTTTTGGCTATAACCAAGAAAATCAGCCGATTCGAGTTAACCCCGGCCCACTCGATGCCCCAGCATATGGCGTCAAATCGACACTACCCGACATGTTGAGTTTTATTCATGCCAACCTAAATCCACAAAAATATCCAGCAGATATTCAACGGGCAATTAATGAAACACATCAGGGTCGCTATCAAGTAAATACCATGTATCAGGCACTCGGTTGGGAAGAGTTTTCTTATCCGGCAACGTTACAAACTTTATTAGACAGTAATTCAGAACAGATTGTGATGAAACCTAATAAAGTGACTGCTATTTCAAAGGAACCTTCAGTTAAGATGTACCATAAAACTGGCTCAACTACCGGTTTCGGAACATATGTGGTGTTTATTCCTAAAGAAAATATTGGTTTAGTCATGTTAACCAATAAACGTATTCC
gb|AM176550|+|30-891|ARO:3001129|SHV-75 [Klebsiella pneumoniae] 	0	806	16	822	861	1612535+	806	ATGCGTTATATTCGCCTGTGTATTATCACCCTGTGAGCCACCCTGCCGCTGGCGGTACACGCCAGCCCGCAGCCGCTTGAGCAAATTAAACAAAGCGAAAGCCAGCTGTCGGGCCGCGTAGGCATGATAGAAATGGATCTGGCCAGCGGCCGCACGCTGACCGCCTGGCGCGCCGATGAACGCTTTCCCATGATGAGCACCTTTAAAGTAGTGCTCTGCGGCGCAGTGCTGGCGCGGGTGGATGCCGGTGACGAACAGCTGGAGCGAAAGATCCACTATCGCCAGCAGGATCTGGTGGACTACTCGCCGGTCAGCGAAAAACACCTTGCCGACGGCATGACGGTCGGCGAACTCTGCGCCGCCGCCATTACCATGAGCGATAACAGCGCCGCCAATCTGCTGCTGGCCACCGTCGGCGGCCCCGCAGGATTGACTGCCTTTTTGCGCCAGATCGGCGACAACGTCACCCGCCTTGACCGCTGGGAAACGGAACTGAATGAGGCGCTTCCCGGCGACGCCCGCGACACCACTACCCCGGCCAGCATGGCCGCGACCCTGCGCAAGCTGCTGACCAGCCAGCGTCTGAGCGCCCGTTCGCAACGGCAGCTGCTGCAGTGGATGGTGGACGATCGGGTCGCCGGACCGTTGATCCGCTCCGTGCTGCCGGCGGGCTGGTTTATCGCCGATAAGACCGGAGCTAGCAAGCGGGGTGCGCGCGGGATTGTCGCCCTGCTTGGCCCGAATAACAAAGCAGAGCGCATTGTGGTGATTTATCTGCGGGATACGCCGGCGAGCATGGCCGAGCG
gb|AF227204|+|73-934|ARO:3001084|SHV-26 [Klebsiella pneumoniae] 	0	806	16	822	861	1612535+	806	ATGCGTTATATTCGCCTGTGTATTATCACCCTGTGAGCCACCCTGCCGCTGGCGGTACACGCCAGCCCGCAGCCGCTTGAGCAAATTAAACAAAGCGAAAGCCAGCTGTCGGGCCGCGTAGGCATGATAGAAATGGATCTGGCCAGCGGCCGCACGCTGACCGCCTGGCGCGCCGATGAACGCTTTCCCATGATGAGCACCTTTAAAGTAGTGCTCTGCGGCGCAGTGCTGGCGCGGGTGGATGCCGGTGACGAACAGCTGGAGCGAAAGATCCACTATCGCCAGCAGGATCTGGTGGACTACTCGCCGGTCAGCGAAAAACACCTTGCCGACGGCATGACGGTCGGCGAACTCTGCGCCGCCGCCATTACCATGAGCGATAACAGCGCCGCCAATCTGCTGCTGGCCACCGTCGGCGGCCCCGCAGGATTGACTGCCTTTTTGCGCCAGATCGGCGACAACGTCACCCGCCTTGACCGCTGGGAAACGGAACTGAATGAGGCGCTTCCCGGCGACGCCCGCGACACCACTACCCCGGCCAGCATGGCCGCGACCCTGCGCAAGCTGCTGACCAGCCAGCGTCTGAGCGCCCGTTCGCAACGGCAGCTGCTGCAGTGGATGGTGGACGATCGGGTCGCCGGACCGTTGATCCGCTCCGTGCTGCCGGCGGGCTGGTTTATCGCCGATAAGACCGGAGCTAGCAAGCGGGGTGCGCGCGGGATTGTCGCCCTGCTTGGCCCGAATAACAAAGCAGAGCGCATTGTGGTGATTTATCTGCGGGATACGCCGGCGAGCATGGCCGAGCG
gb|JN051143|+|0-861|ARO:3001182|SHV-140 [Klebsiella pneumoniae] 	2	806	18	822	861	1612535+	804	GCGTTATATTCGCCTGTGTATTATCACCCTGTGAGCCACCCTGCCGCTGGCGGTACACGCCAGCCCGCAGCCGCTTGAGCAAATTAAACAAAGCGAAAGCCAGCTGTCGGGCCGCGTAGGCATGATAGAAATGGATCTGGCCAGCGGCCGCACGCTGACCGCCTGGCGCGCCGATGAACGCTTTCCCATGATGAGCACCTTTAAAGTAGTGCTCTGCGGCGCAGTGCTGGCGCGGGTGGATGCCGGTGACGAACAGCTGGAGCGAAAGATCCACTATCGCCAGCAGGATCTGGTGGACTACTCGCCGGTCAGCGAAAAACACCTTGCCGACGGCATGACGGTCGGCGAACTCTGCGCCGCCGCCATTACCATGAGCGATAACAGCGCCGCCAATCTGCTGCTGGCCACCGTCGGCGGCCCCGCAGGATTGACTGCCTTTTTGCGCCAGATCGGCGACAACGTCACCCGCCTTGACCGCTGGGAAACGGAACTGAATGAGGCGCTTCCCGGCGACGCCCGCGACACCACTACCCCGGCCAGCATGGCCGCGACCCTGCGCAAGCTGCTGACCAGCCAGCGTCTGAGCGCCCGTTCGCAACGGCAGCTGCTGCAGTGGATGGTGGACGATCGGGTCGCCGGACCGTTGATCCGCTCCGTGCTGCCGGCGGGCTGGTTTATCGCCGATAAGACCGGAGCTAGCAAGCGGGGTGCGCGCGGGATTGTCGCCCTGCTTGGCCCGAATAACAAAGCAGAGCGCATTGTGGTGATTTATCTGCGGGATACGCCGGCGAGCATGGCCGAGCG
gb|AM176551|+|30-891|ARO:3001130|SHV-76 [Klebsiella pneumoniae] 	0	806	16	822	861	1612535+	806	ATGCGTTATATTCGCCTGTGTATTATCACCCTGTGAGCCACCCTGCCGCTGGCGGTACACGCCAGCCCGCAGCCGCTTGAGCAAATTAAACAAAGCGAAAGCCAGCTGTCGGGCCGCGTAGGCATGATAGAAATGGATCTGGCCAGCGGCCGCACGCTGACCGCCTGGCGCGCCGATGAACGCTTTCCCATGATGAGCACCTTTAAAGTAGTGCTCTGCGGCGCAGTGCTGGCGCGGGTGGATGCCGGTGACGAACAGCTGGAGCGAAAGATCCACTATCGCCAGCAGGATCTGGTGGACTACTCGCCGGTCAGCGAAAAACACCTTGCCGACGGCATGACGGTCGGCGAACTCTGCGCCGCCGCCATTACCATGAGCGATAACAGCGCCGCCAATCTGCTGCTGGCCACCGTCGGCGGCCCCGCAGGATTGACTGCCTTTTTGCGCCAGATCGGCGACAACGTCACCCGCCTTGACCGCTGGGAAACGGAACTGAATGAGGCGCTTCCCGGCGACGCCCGCGACACCACTACCCCGGCCAGCATGGCCGCGACCCTGCGCAAGCTGCTGACCAGCCAGCGTCTGAGCGCCCGTTCGCAACGGCAGCTGCTGCAGTGGATGGTGGACGATCGGGTCGCCGGACCGTTGATCCGCTCCGTGCTGCCGGCGGGCTGGTTTATCGCCGATAAGACCGGAGCTAGCAAGCGGGGTGCGCGCGGGATTGTCGCCCTGCTTGGCCCGAATAACAAAGCAGAGCGCATTGTGGTGATTTATCTGCGGGATACGCCGGCGAGCATGGCCGAGCG
gb|AJ309734|+|0-825|ARO:3001612|OXA-51 [Acinetobacter baumannii] 	0	770	54149	54919	825	246080-	770	ATGAACATTAAAGCACTCTTACTTATAACAAGCGCTATTTTTATTTCAGCCTGCTCACCTTATATAGTGACTGCTAATCCAAATCACAGCGCTTCAAAATCTGATGTAAAAGCAGAGAAAATTAAAAATTTATTTAACGAAGCACACACTACGGGTGTTTTAGTTATCCAACAAGGCCAAACTCAACAAAGCTATGGTAATGATCTTGCTCGTGCTTCGACCGAGTATGTACCTGCTTCGACCTTCAAAATGCTTAATGCTTTGATCGGCCTTGAGCACCATAAGGCAACCACCACAGAAGTATTTAAGTGGGATGGTAAAAAAAGGTTATTCCCAGAATGGGAAAAGGACATGACCCTAGGCGATGCCATGAAAGCTTCCGCTATTCCAGTTTATCAAGATTTAGCTCGTCGTATTGGACTTGAGCTCATGTCTAAGGAAGTGAAGCGTGTTGGTTATGGCAATGCAGATATCGGTACCCAAGTCGATAATTTTTGGCTGGTGGGTCCTTTAAAAATTACTCCTCAGCAAGAGGCACAGTTTGCTTACAAGCTAGCTAATAAAACGCTTCCATTTAGCCAAAAAGTCCAAGATGAAGTGCAATCCATGCTATTCATAGAAGAAAAGAATGGAAACAAAATATACGCAAAAAGTGGTTGGGGATGGGATGTAAACCCACAAGTAGGCTGGTTAACTGGATGGGTTGTTCAGCCTCAAGGGAATATTGTAGCGTTCTCCCTTAACTTAGAAATGAAAAAAGGAATACCTAG
gb|FJ790516|+|1287-2085|ARO:3001804|OXA-145 [Pseudomonas aeruginosa] 	0	743	659	1405	798	104604+	746	ATGAAAACATTTGCCGCATATGTAATTATCGCGTGTCTTTCGAGTACGGCATTAGCTGGTTCAATTACAGAAAATACGTCTTGGAACAAAGAGTTCTCTGCCGAAGCCGTCAATGGTGTCTTCGTGCTTTGTAAAAGTAGCAGTAAATCCTGCGCTACCAATGACTTAGCTCGTGCATCAAAGGAATATCTTCCAGCATCAACATTTAAGATCCCCAACGCAATTATCGGCCTAGAAACTGGTGTCATAAAGAATGAGCATCAGGTTTTCAAATGGGACGGAAAGCCAAGAGCCATGAAGCAATGGGAAAGAGACTTGACCTTAAGAGGGGCAATACAAGTTTCAGCTGTTCCCGTATTTCAACAAATCGCCAGAGAAGTTGGCGAAGTAAGAATGCAGAAATACCTTAAAAAATTTTCCTATGGCAACCAGAATATCAGTGGTGGCATTGACAAATTCTGGTTGGAAGGCCAGCTTAGAATTTCCGCAGTTAATCAAGTGGAGTTTCTAGAGTCTCTATATTTAAATAAATTGTCAGCATCTAAAGAAAACCAGCTAATAGTAAAAGAGGCTTTGGTAACGGAGGCGGCACCTGAATATCTAGTGCATTCAAAAACTGGTTTTTCTGGTGTGGGAACTGAGTCAAATCCTGGTGTCGCATGGTGGGTTGGGTGGGTTGAGAAGGAGACAGAGGTTTACTTTTTCGCCTTTAACATGGATATAGACAACGAAAGTAAGTTGCCGCT
gb|KF057031|+|0-825|ARO:3001685|OXA-314 [Acinetobacter baumannii] 	0	770	54149	54919	825	246080-	770	ATGAACATTAAAGCACTCTTACTTATAACAAGCGCTATTTTTATTTCAGCCTGCTCACCTTATATAGTGACTGCTAATCCAAATCACAGCGCTTCAAAATCTGATGTAAAAGCAGAGAAAATTAAAAATTTATTTAACGAAGCACACACTACGGGTGTTTTAGTTATCCAACAAGGCCAAACTCAACAAAGCTATGGTAATGATCTTGCTCGTGCTTCGACCGAGTATGTACCTGCTTCGACCTTCAAAATGCTTAATGCTTTGATCGGCCTTGAGCACCATAAGGCAACCACCACAGAAGTATTTAAGTGGGATGGTAAAAAAAGGTTATTCCCAGAATGGGAAAAGGACATGACCCTAGGCGATGCCATGAAAGCTTCCGCTATTCCAGTTTATCAAGATTTAGCTCGTCGTATTGGACTTGAGCTCATGTCTAAGGAAGTGAAGCGTGTTGGTTATGGCAATGCAGATATCGGTACCCAAGTCGATAATTTTTGGCTGGTGGGTCCTTTAAAAATTACTCCTCAGCAAGAGGCACAGTTTGCTTACAAGCTAGCTAATAAAACGCTTCCATTTAGCCAAAAAGTCCAAGATGAAGTGCAATCCATGCTATTCATAGAAGAAAAGAATGGAAACAAAATATACGCAAAAAGTGGTTGGGGATGGGATGTAAACCCACAAGTAGGCTGGTTAACTGGATGGGTTGTTCAGCCTCAAGGGAATATTGTAGCGTTCTCCCTTAACTTAGAAATGAAAAAAGGAATACCTAG
gb|JQ388884|+|0-861|ARO:3001183|SHV-141 [Klebsiella pneumoniae] 	0	806	16	822	861	1612535+	806	ATGCGTTATATTCGCCTGTGTATTATCACCCTGTGAGCCACCCTGCCGCTGGCGGTACACGCCAGCCCGCAGCCGCTTGAGCAAATTAAACAAAGCGAAAGCCAGCTGTCGGGCCGCGTAGGCATGATAGAAATGGATCTGGCCAGCGGCCGCACGCTGACCGCCTGGCGCGCCGATGAACGCTTTCCCATGATGAGCACCTTTAAAGTAGTGCTCTGCGGCGCAGTGCTGGCGCGGGTGGATGCCGGTGACGAACAGCTGGAGCGAAAGATCCACTATCGCCAGCAGGATCTGGTGGACTACTCGCCGGTCAGCGAAAAACACCTTGCCGACGGCATGACGGTCGGCGAACTCTGCGCCGCCGCCATTACCATGAGCGATAACAGCGCCGCCAATCTGCTGCTGGCCACCGTCGGCGGCCCCGCAGGATTGACTGCCTTTTTGCGCCAGATCGGCGACAACGTCACCCGCCTTGACCGCTGGGAAACGGAACTGAATGAGGCGCTTCCCGGCGACGCCCGCGACACCACTACCCCGGCCAGCATGGCCGCGACCCTGCGCAAGCTGCTGACCAGCCAGCGTCTGAGCGCCCGTTCGCAACGGCAGCTGCTGCAGTGGATGGTGGACGATCGGGTCGCCGGACCGTTGATCCGCTCCGTGCTGCCGGCGGGCTGGTTTATCGCCGATAAGACCGGAGCTAGCAAGCGGGGTGCGCGCGGGATTGTCGCCCTGCTTGGCCCGAATAACAAAGCAGAGCGCATTGTGGTGATTTATCTGCGGGATACGCCGGCGAGCATGGCCGAGCG
gb|KJ949080.1|+|0-1194|ARO:3005038|PDC-65 [Pseudomonas aeruginosa] 	0	1139	35513	36652	1194	232416+	1139	ATGCGCGATACCAGATTCCCCTGCCTGTGCGGCATCGCCGCTTCCACACTGCTGTTCGCCACCACCCCGGCCATTGCCGATGAGGCCCCGGCGGATCGCCTGAAGGCACTGGTCGACGCCGCCGTACAACCGGTGATGAAGGCCAATGACATTCCGGGCCTGGCCGTAGCCATCAGCCTGAAAGGAGAACCGCATTACTTCAGCTATGGGCTGGCCTCGAAAGAGGACGGCCGCCGGGTGACGCCGGAGACCCTGTTCGAGATCGGCTCGGTGAGCAAGACCTTCACCGTCACCCTCGCCGGCTATGCCCTGGCCCAGGACAAGATGCGCCTCGACGACCGCGCCAGCCAGCACTGGCCGGCACTGCAGGGCAGCCGCTTCGACGGCATCAGCCTGCTCGACCTCGCGACCTATACCGCCGGCGGCTTGCCGCTGCAGTTCCCCGACTCGGTGCAGAAGGACCAGGCACAGATCCGCGACTACTACCGCCAGTGGCAGCCGACCTACGCGCCGGGCAGCCAGCGCCTCTATTCCAACCCGAGCATCGGCCTGTTCGGCTATCTCGCCGCGCGCAGCCTGGGCCAGCCGTTCGAACGGCTCATGGAGCAGCAATTGTTCCCGGCACTGGGCCTCGAACAGACCCACCTCGACGTGCCCGAGGCGGCGCTGGCGCAGTACGCCCAGGGCTACGGCAAGGACGACCGCCCGCTACGGGTCGGTCCCGGCCCGCTGGATGCCGAAGGCTACGGGGTGAAGACCAGCGCGGCCGACCTGCTGCGCTTCGTCGATGCCAACCTGCATCCGGAGCGCCTGGACAGGCCCTGGGCGCAGGCGCTCGATGCCACCCATCGCGGTTACTACAAGGTCGGCGACATGACCCAGGGCCTGGGCTGGGAAGCCTACGACTGGCCGATCTCCCTGAAGCGCCTGCAGGCCGGCAACTCGACGCCGATGGCGCTGCAACCACACAGGATCGCCAGGCTGCCCGCGCCACAGGCGCTGGAGGGCCAGCGCCTGCTGAACAAGACCGGCTCCACCAACGGCTTCGGCGCCTACGTGGCGTTCGTCCCGGGCCGCGACCTGGGCCTGGTGATCCTGGCCAACCGCAACTATCCCAATGCCGAGCGGGTGAAGATCGC
gb|FJ194494|+|171-996|ARO:3001779|OXA-146 [Acinetobacter baumannii] 	0	770	80	847	825	254088-	767	ATGAATAAATATTTTACTTGCTATGTGGTTGCTTCTCTTTTTCTTTCTGGTTGTACGGTTCAGCATAATTTAATAAATGAAACCCCGAGTCAGATTGTTCAAGGACATAATCAGGTGATTCATCAATACTTTGATGAAAAAAACACCTCAGGTGTGCTGGTTATTCAAACAGATAAAAAAATTAATCTATATGGTAATGCTCTAAGCCGCGCAAATACAGAATATGTGCCAGCCTCTACATTTAAAATGTTGAATGCCCTGATCGGATTGGAGAACCAGAAAACGGATATTAATGAAATATTTAAATGGAAGGGCGAGAAAAGGTCATTTACCGCTTGGGAAAAAGACATGACACTAGGAGAAGCCATGAAGCTTTCTGCAGTCCCAGTCTATCAGGAACTTGCGCGACGTATCGGTCTTGATCTCATGCAAAAAGAAGTAAAACGTATTGGTTTCGGTAATGCTGAAATTGGACAGCAGGTTGATAATTTCTGGTTGGTAGGACCATTAAAGGTTACGCCTATTCAAGAGGTAGAGTTTGTTTCCCAATTAGCACATACACAGCTTCCATTTAGTGAAAAAGTGCAGGCTAATGTAAAAAATATGCTTCTTTTAGAAGAGAGTAATGGCTACAAAATTTTTGGAAAGACTGGTTGGGCAATGGATATAAAACCACAAGTGGGCTGGTTGACCGGCTGGGTTGAGCAGCCAGATGGAAAAATTGTCGCTTTTGCATTAAATATGGAAATGCGGTCAGAAATGCCGGC
gb|AF293345|+|0-861|ARO:3001085|SHV-27 [Klebsiella pneumoniae] 	0	806	16	822	861	1612535+	806	ATGCGTTATATTCGCCTGTGTATTATCACCCTGTGAGCCACCCTGCCGCTGGCGGTACACGCCAGCCCGCAGCCGCTTGAGCAAATTAAACAAAGCGAAAGCCAGCTGTCGGGCCGCGTAGGCATGATAGAAATGGATCTGGCCAGCGGCCGCACGCTGACCGCCTGGCGCGCCGATGAACGCTTTCCCATGATGAGCACCTTTAAAGTAGTGCTCTGCGGCGCAGTGCTGGCGCGGGTGGATGCCGGTGACGAACAGCTGGAGCGAAAGATCCACTATCGCCAGCAGGATCTGGTGGACTACTCGCCGGTCAGCGAAAAACACCTTGCCGACGGCATGACGGTCGGCGAACTCTGCGCCGCCGCCATTACCATGAGCGATAACAGCGCCGCCAATCTGCTGCTGGCCACCGTCGGCGGCCCCGCAGGATTGACTGCCTTTTTGCGCCAGATCGGCGACAACGTCACCCGCCTTGACCGCTGGGAAACGGAACTGAATGAGGCGCTTCCCGGCGACGCCCGCGACACCACTACCCCGGCCAGCATGGCCGCGACCCTGCGCAAGCTGCTGACCAGCCAGCGTCTGAGCGCCCGTTCGCAACGGCAGCTGCTGCAGTGGATGGTGGACGATCGGGTCGCCGGACCGTTGATCCGCTCCGTGCTGCCGGCGGGCTGGTTTATCGCCGATAAGACCGGAGCTAGCAAGCGGGGTGCGCGCGGGATTGTCGCCCTGCTTGGCCCGAATAACAAAGCAGAGCGCATTGTGGTGATTTATCTGCGGGATACGCCGGCGAGCATGGCCGAGCG
gb|JQ029959|+|28-889|ARO:3001184|SHV-142 [Klebsiella pneumoniae] 	0	806	16	822	861	1612535+	806	ATGCGTTATATTCGCCTGTGTATTATCACCCTGTGAGCCACCCTGCCGCTGGCGGTACACGCCAGCCCGCAGCCGCTTGAGCAAATTAAACAAAGCGAAAGCCAGCTGTCGGGCCGCGTAGGCATGATAGAAATGGATCTGGCCAGCGGCCGCACGCTGACCGCCTGGCGCGCCGATGAACGCTTTCCCATGATGAGCACCTTTAAAGTAGTGCTCTGCGGCGCAGTGCTGGCGCGGGTGGATGCCGGTGACGAACAGCTGGAGCGAAAGATCCACTATCGCCAGCAGGATCTGGTGGACTACTCGCCGGTCAGCGAAAAACACCTTGCCGACGGCATGACGGTCGGCGAACTCTGCGCCGCCGCCATTACCATGAGCGATAACAGCGCCGCCAATCTGCTGCTGGCCACCGTCGGCGGCCCCGCAGGATTGACTGCCTTTTTGCGCCAGATCGGCGACAACGTCACCCGCCTTGACCGCTGGGAAACGGAACTGAATGAGGCGCTTCCCGGCGACGCCCGCGACACCACTACCCCGGCCAGCATGGCCGCGACCCTGCGCAAGCTGCTGACCAGCCAGCGTCTGAGCGCCCGTTCGCAACGGCAGCTGCTGCAGTGGATGGTGGACGATCGGGTCGCCGGACCGTTGATCCGCTCCGTGCTGCCGGCGGGCTGGTTTATCGCCGATAAGACCGGAGCTAGCAAGCGGGGTGCGCGCGGGATTGTCGCCCTGCTTGGCCCGAATAACAAAGCAGAGCGCATTGTGGTGATTTATCTGCGGGATACGCCGGCGAGCATGGCCGAGCG
gb|AY445080|+|0-801|ARO:3001795|OXA-56 [Pseudomonas aeruginosa] 	0	746	659	1405	801	104604+	746	ATGAAAACATTTGCCGCATATGTAATTATCGCGTGTCTTTCGAGTACGGCATTAGCTGGTTCAATTACAGAAAATACGTCTTGGAACAAAGAGTTCTCTGCCGAAGCCGTCAATGGTGTCTTCGTGCTTTGTAAAAGTAGCAGTAAATCCTGCGCTACCAATGACTTAGCTCGTGCATCAAAGGAATATCTTCCAGCATCAACATTTAAGATCCCCAACGCAATTATCGGCCTAGAAACTGGTGTCATAAAGAATGAGCATCAGGTTTTCAAATGGGACGGAAAGCCAAGAGCCATGAAGCAATGGGAAAGAGACTTGACCTTAAGAGGGGCAATACAAGTTTCAGCTGTTCCCGTATTTCAACAAATCGCCAGAGAAGTTGGCGAAGTAAGAATGCAGAAATACCTTAAAAAATTTTCCTATGGCAACCAGAATATCAGTGGTGGCATTGACAAATTCTGGTTGGAAGGCCAGCTTAGAATTTCCGCAGTTAATCAAGTGGAGTTTCTAGAGTCTCTATATTTAAATAAATTGTCAGCATCTAAAGAAAACCAGCTAATAGTAAAAGAGGCTTTGGTAACGGAGGCGGCACCTGAATATCTAGTGCATTCAAAAACTGGTTTTTCTGGTGTGGGAACTGAGTCAAATCCTGGTGTCGCATGGTGGGTTGGGTGGGTTGAGAAGGAGACAGAGGTTTACTTTTTCGCCTTTAACATGGATATAGACAACGAAAGTAAGTTGCCGCT
gb|FJ848783|+|1270-2071|ARO:3001801|OXA-147 [Pseudomonas aeruginosa] 	0	746	659	1405	801	104604+	746	ATGAAAACATTTGCCGCATATGTAATTATCGCGTGTCTTTCGAGTACGGCATTAGCTGGTTCAATTACAGAAAATACGTCTTGGAACAAAGAGTTCTCTGCCGAAGCCGTCAATGGTGTCTTCGTGCTTTGTAAAAGTAGCAGTAAATCCTGCGCTACCAATGACTTAGCTCGTGCATCAAAGGAATATCTTCCAGCATCAACATTTAAGATCCCCAACGCAATTATCGGCCTAGAAACTGGTGTCATAAAGAATGAGCATCAGGTTTTCAAATGGGACGGAAAGCCAAGAGCCATGAAGCAATGGGAAAGAGACTTGACCTTAAGAGGGGCAATACAAGTTTCAGCTGTTCCCGTATTTCAACAAATCGCCAGAGAAGTTGGCGAAGTAAGAATGCAGAAATACCTTAAAAAATTTTCCTATGGCAACCAGAATATCAGTGGTGGCATTGACAAATTCTGGTTGGAAGGCCAGCTTAGAATTTCCGCAGTTAATCAAGTGGAGTTTCTAGAGTCTCTATATTTAAATAAATTGTCAGCATCTAAAGAAAACCAGCTAATAGTAAAAGAGGCTTTGGTAACGGAGGCGGCACCTGAATATCTAGTGCATTCAAAAACTGGTTTTTCTGGTGTGGGAACTGAGTCAAATCCTGGTGTCGCATGGTGGGTTGGGTGGGTTGAGAAGGAGACAGAGGTTTACTTTTTCGCCTTTAACATGGATATAGACAACGAAAGTAAGTTGCCGCT
gb|AM176552|+|30-891|ARO:3001131|SHV-77 [Klebsiella pneumoniae] 	0	806	16	822	861	1612535+	806	ATGCGTTATATTCGCCTGTGTATTATCACCCTGTGAGCCACCCTGCCGCTGGCGGTACACGCCAGCCCGCAGCCGCTTGAGCAAATTAAACAAAGCGAAAGCCAGCTGTCGGGCCGCGTAGGCATGATAGAAATGGATCTGGCCAGCGGCCGCACGCTGACCGCCTGGCGCGCCGATGAACGCTTTCCCATGATGAGCACCTTTAAAGTAGTGCTCTGCGGCGCAGTGCTGGCGCGGGTGGATGCCGGTGACGAACAGCTGGAGCGAAAGATCCACTATCGCCAGCAGGATCTGGTGGACTACTCGCCGGTCAGCGAAAAACACCTTGCCGACGGCATGACGGTCGGCGAACTCTGCGCCGCCGCCATTACCATGAGCGATAACAGCGCCGCCAATCTGCTGCTGGCCACCGTCGGCGGCCCCGCAGGATTGACTGCCTTTTTGCGCCAGATCGGCGACAACGTCACCCGCCTTGACCGCTGGGAAACGGAACTGAATGAGGCGCTTCCCGGCGACGCCCGCGACACCACTACCCCGGCCAGCATGGCCGCGACCCTGCGCAAGCTGCTGACCAGCCAGCGTCTGAGCGCCCGTTCGCAACGGCAGCTGCTGCAGTGGATGGTGGACGATCGGGTCGCCGGACCGTTGATCCGCTCCGTGCTGCCGGCGGGCTGGTTTATCGCCGATAAGACCGGAGCTAGCAAGCGGGGTGCGCGCGGGATTGTCGCCCTGCTTGGCCCGAATAACAAAGCAGAGCGCATTGTGGTGATTTATCTGCGGGATACGCCGGCGAGCATGGCCGAGCG
gb|MG229642.1|+|0-1152|ARO:3005037|ADC-159 [Acinetobacter baumannii] 	0	1097	63	1160	1152	126080+	1097	ATGCGATTTAAAAAAATTTCTTGTCTACTTTTATCCCCGCTTTTTATTTTTAGTACCTCAATTTATGCGGGCAATACACCAAAAGACCAAGAAATTAAAAAACTGGTAGATCAAAACTTTAAACCGTTATTAGAAAAATATGATGTGCCAGGTATGGCTGTGGGTGTTATTCAAAATAATAAAAAGTATGAAATGTATTATGGTCTTCAATCTGTTCAAGATAAAAAAGCCGTAAATAGCAGTACTATTTTTGAGCTAGGTTCTGTCAGTAAATTATTTACCGCGACAGCAGGTGGATATGCAAAAAATAAAGGAAAAATCTCTTTTGACGATACGCCTGGTAAGTATTGGAAAGAACTAAAAAATACACCGATTGACCAAGTTAACTTACTTCAACTCGCGACGTATACAAGTGGTAACCTTGCCTTGCAATTTCCAGATGAAGTAAAAACAGATCAGCAAGTTTTAACATTTTTTAAAGACTGGAAACCTAAAAACTCAATCGGTGAATATCGACAATATTCAAACCCAAGCATTGGTTTATTTGGAAAAGTTGTAGCTTTGTCTATGAATAAACCTTTCGACCAAGTCTTAGAAAAAACAATTTTTCCGGCCCTTGGCTTAAAACATAGCTATGTAAATGTACCTAAGACCCAGATGCAAAACTATGCTTTTGGCTATAACCAAGAAAATCAGCCGATTCGAGTTAACCCCGGCCCACTCGATGCCCCAGCATATGGCGTCAAATCGACACTACCCGACATGTTGAGTTTTATTCATGCCAACCTAAATCCACAAAAATATCCAGCAGATATTCAACGGGCAATTAATGAAACACATCAGGGTCGCTATCAAGTAAATACCATGTATCAGGCACTCGGTTGGGAAGAGTTTTCTTATCCGGCAACGTTACAAACTTTATTAGACAGTAATTCAGAACAGATTGTGATGAAACCTAATAAAGTGACTGCTATTTCAAAGGAACCTTCAGTTAAGATGTACCATAAAACTGGCTCAACTACCGGTTTCGGAACATATGTGGTGTTTATTCCTAAAGAAAATATTGGTTTAGTCATGTTAACCAATAAACGTATTCC
gb|KF057032|+|0-825|ARO:3001686|OXA-315 [Acinetobacter baumannii] 	0	770	54149	54919	825	246080-	770	ATGAACATTAAAGCACTCTTACTTATAACAAGCGCTATTTTTATTTCAGCCTGCTCACCTTATATAGTGACTGCTAATCCAAATCACAGCGCTTCAAAATCTGATGTAAAAGCAGAGAAAATTAAAAATTTATTTAACGAAGCACACACTACGGGTGTTTTAGTTATCCAACAAGGCCAAACTCAACAAAGCTATGGTAATGATCTTGCTCGTGCTTCGACCGAGTATGTACCTGCTTCGACCTTCAAAATGCTTAATGCTTTGATCGGCCTTGAGCACCATAAGGCAACCACCACAGAAGTATTTAAGTGGGATGGTAAAAAAAGGTTATTCCCAGAATGGGAAAAGGACATGACCCTAGGCGATGCCATGAAAGCTTCCGCTATTCCAGTTTATCAAGATTTAGCTCGTCGTATTGGACTTGAGCTCATGTCTAAGGAAGTGAAGCGTGTTGGTTATGGCAATGCAGATATCGGTACCCAAGTCGATAATTTTTGGCTGGTGGGTCCTTTAAAAATTACTCCTCAGCAAGAGGCACAGTTTGCTTACAAGCTAGCTAATAAAACGCTTCCATTTAGCCAAAAAGTCCAAGATGAAGTGCAATCCATGCTATTCATAGAAGAAAAGAATGGAAACAAAATATACGCAAAAAGTGGTTGGGGATGGGATGTAAACCCACAAGTAGGCTGGTTAACTGGATGGGTTGTTCAGCCTCAAGGGAATATTGTAGCGTTCTCCCTTAACTTAGAAATGAAAAAAGGAATACCTAG
gb|AF299299|+|0-861|ARO:3001086|SHV-28 [Klebsiella pneumoniae] 	0	806	16	822	861	1612535+	806	ATGCGTTATATTCGCCTGTGTATTATCACCCTGTGAGCCACCCTGCCGCTGGCGGTACACGCCAGCCCGCAGCCGCTTGAGCAAATTAAACAAAGCGAAAGCCAGCTGTCGGGCCGCGTAGGCATGATAGAAATGGATCTGGCCAGCGGCCGCACGCTGACCGCCTGGCGCGCCGATGAACGCTTTCCCATGATGAGCACCTTTAAAGTAGTGCTCTGCGGCGCAGTGCTGGCGCGGGTGGATGCCGGTGACGAACAGCTGGAGCGAAAGATCCACTATCGCCAGCAGGATCTGGTGGACTACTCGCCGGTCAGCGAAAAACACCTTGCCGACGGCATGACGGTCGGCGAACTCTGCGCCGCCGCCATTACCATGAGCGATAACAGCGCCGCCAATCTGCTGCTGGCCACCGTCGGCGGCCCCGCAGGATTGACTGCCTTTTTGCGCCAGATCGGCGACAACGTCACCCGCCTTGACCGCTGGGAAACGGAACTGAATGAGGCGCTTCCCGGCGACGCCCGCGACACCACTACCCCGGCCAGCATGGCCGCGACCCTGCGCAAGCTGCTGACCAGCCAGCGTCTGAGCGCCCGTTCGCAACGGCAGCTGCTGCAGTGGATGGTGGACGATCGGGTCGCCGGACCGTTGATCCGCTCCGTGCTGCCGGCGGGCTGGTTTATCGCCGATAAGACCGGAGCTAGCAAGCGGGGTGCGCGCGGGATTGTCGCCCTGCTTGGCCCGAATAACAAAGCAGAGCGCATTGTGGTGATTTATCTGCGGGATACGCCGGCGAGCATGGCCGAGCG
gb|JQ341060.1|-|881-1742|ARO:3001344|SHV-143 [Klebsiella pneumoniae] 	0	806	16	822	861	1612535+	806	ATGCGTTATATTCGCCTGTGTATTATCACCCTGTGAGCCACCCTGCCGCTGGCGGTACACGCCAGCCCGCAGCCGCTTGAGCAAATTAAACAAAGCGAAAGCCAGCTGTCGGGCCGCGTAGGCATGATAGAAATGGATCTGGCCAGCGGCCGCACGCTGACCGCCTGGCGCGCCGATGAACGCTTTCCCATGATGAGCACCTTTAAAGTAGTGCTCTGCGGCGCAGTGCTGGCGCGGGTGGATGCCGGTGACGAACAGCTGGAGCGAAAGATCCACTATCGCCAGCAGGATCTGGTGGACTACTCGCCGGTCAGCGAAAAACACCTTGCCGACGGCATGACGGTCGGCGAACTCTGCGCCGCCGCCATTACCATGAGCGATAACAGCGCCGCCAATCTGCTGCTGGCCACCGTCGGCGGCCCCGCAGGATTGACTGCCTTTTTGCGCCAGATCGGCGACAACGTCACCCGCCTTGACCGCTGGGAAACGGAACTGAATGAGGCGCTTCCCGGCGACGCCCGCGACACCACTACCCCGGCCAGCATGGCCGCGACCCTGCGCAAGCTGCTGACCAGCCAGCGTCTGAGCGCCCGTTCGCAACGGCAGCTGCTGCAGTGGATGGTGGACGATCGGGTCGCCGGACCGTTGATCCGCTCCGTGCTGCCGGCGGGCTGGTTTATCGCCGATAAGACCGGAGCTAGCAAGCGGGGTGCGCGCGGGATTGTCGCCCTGCTTGGCCCGAATAACAAAGCAGAGCGCATTGTGGTGATTTATCTGCGGGATACGCCGGCGAGCATGGCCGAGCG
gb|AY750907|+|0-825|ARO:3001613|OXA-64 [Acinetobacter baumannii] 	0	770	54149	54919	825	246080-	770	ATGAACATTAAAGCACTCTTACTTATAACAAGCGCTATTTTTATTTCAGCCTGCTCACCTTATATAGTGACTGCTAATCCAAATCACAGCGCTTCAAAATCTGATGTAAAAGCAGAGAAAATTAAAAATTTATTTAACGAAGCACACACTACGGGTGTTTTAGTTATCCAACAAGGCCAAACTCAACAAAGCTATGGTAATGATCTTGCTCGTGCTTCGACCGAGTATGTACCTGCTTCGACCTTCAAAATGCTTAATGCTTTGATCGGCCTTGAGCACCATAAGGCAACCACCACAGAAGTATTTAAGTGGGATGGTAAAAAAAGGTTATTCCCAGAATGGGAAAAGGACATGACCCTAGGCGATGCCATGAAAGCTTCCGCTATTCCAGTTTATCAAGATTTAGCTCGTCGTATTGGACTTGAGCTCATGTCTAAGGAAGTGAAGCGTGTTGGTTATGGCAATGCAGATATCGGTACCCAAGTCGATAATTTTTGGCTGGTGGGTCCTTTAAAAATTACTCCTCAGCAAGAGGCACAGTTTGCTTACAAGCTAGCTAATAAAACGCTTCCATTTAGCCAAAAAGTCCAAGATGAAGTGCAATCCATGCTATTCATAGAAGAAAAGAATGGAAACAAAATATACGCAAAAAGTGGTTGGGGATGGGATGTAAACCCACAAGTAGGCTGGTTAACTGGATGGGTTGTTCAGCCTCAAGGGAATATTGTAGCGTTCTCCCTTAACTTAGAAATGAAAAAAGGAATACCTAG
gb|GQ853679|+|0-825|ARO:3001453|OXA-148 [Acinetobacter baumannii] 	0	770	54149	54919	825	246080-	770	ATGAACATTAAAGCACTCTTACTTATAACAAGCGCTATTTTTATTTCAGCCTGCTCACCTTATATAGTGACTGCTAATCCAAATCACAGCGCTTCAAAATCTGATGTAAAAGCAGAGAAAATTAAAAATTTATTTAACGAAGCACACACTACGGGTGTTTTAGTTATCCAACAAGGCCAAACTCAACAAAGCTATGGTAATGATCTTGCTCGTGCTTCGACCGAGTATGTACCTGCTTCGACCTTCAAAATGCTTAATGCTTTGATCGGCCTTGAGCACCATAAGGCAACCACCACAGAAGTATTTAAGTGGGATGGTAAAAAAAGGTTATTCCCAGAATGGGAAAAGGACATGACCCTAGGCGATGCCATGAAAGCTTCCGCTATTCCAGTTTATCAAGATTTAGCTCGTCGTATTGGACTTGAGCTCATGTCTAAGGAAGTGAAGCGTGTTGGTTATGGCAATGCAGATATCGGTACCCAAGTCGATAATTTTTGGCTGGTGGGTCCTTTAAAAATTACTCCTCAGCAAGAGGCACAGTTTGCTTACAAGCTAGCTAATAAAACGCTTCCATTTAGCCAAAAAGTCCAAGATGAAGTGCAATCCATGCTATTCATAGAAGAAAAGAATGGAAACAAAATATACGCAAAAAGTGGTTGGGGATGGGATGTAAACCCACAAGTAGGCTGGTTAACTGGATGGGTTGTTCAGCCTCAAGGGAATATTGTAGCGTTCTCCCTTAACTTAGAAATGAAAAAAGGAATACCTAG
gb|AY750908|+|0-825|ARO:3001614|OXA-65 [Acinetobacter baumannii] 	0	770	54149	54919	825	246080-	770	ATGAACATTAAAGCACTCTTACTTATAACAAGCGCTATTTTTATTTCAGCCTGCTCACCTTATATAGTGACTGCTAATCCAAATCACAGCGCTTCAAAATCTGATGTAAAAGCAGAGAAAATTAAAAATTTATTTAACGAAGCACACACTACGGGTGTTTTAGTTATCCAACAAGGCCAAACTCAACAAAGCTATGGTAATGATCTTGCTCGTGCTTCGACCGAGTATGTACCTGCTTCGACCTTCAAAATGCTTAATGCTTTGATCGGCCTTGAGCACCATAAGGCAACCACCACAGAAGTATTTAAGTGGGATGGTAAAAAAAGGTTATTCCCAGAATGGGAAAAGGACATGACCCTAGGCGATGCCATGAAAGCTTCCGCTATTCCAGTTTATCAAGATTTAGCTCGTCGTATTGGACTTGAGCTCATGTCTAAGGAAGTGAAGCGTGTTGGTTATGGCAATGCAGATATCGGTACCCAAGTCGATAATTTTTGGCTGGTGGGTCCTTTAAAAATTACTCCTCAGCAAGAGGCACAGTTTGCTTACAAGCTAGCTAATAAAACGCTTCCATTTAGCCAAAAAGTCCAAGATGAAGTGCAATCCATGCTATTCATAGAAGAAAAGAATGGAAACAAAATATACGCAAAAAGTGGTTGGGGATGGGATGTAAACCCACAAGTAGGCTGGTTAACTGGATGGGTTGTTCAGCCTCAAGGGAATATTGTAGCGTTCTCCCTTAACTTAGAAATGAAAAAAGGAATACCTAG
gb|JQ926986|+|0-861|ARO:3001345|SHV-144 [Klebsiella pneumoniae] 	0	806	16	822	861	1612535+	806	ATGCGTTATATTCGCCTGTGTATTATCACCCTGTGAGCCACCCTGCCGCTGGCGGTACACGCCAGCCCGCAGCCGCTTGAGCAAATTAAACAAAGCGAAAGCCAGCTGTCGGGCCGCGTAGGCATGATAGAAATGGATCTGGCCAGCGGCCGCACGCTGACCGCCTGGCGCGCCGATGAACGCTTTCCCATGATGAGCACCTTTAAAGTAGTGCTCTGCGGCGCAGTGCTGGCGCGGGTGGATGCCGGTGACGAACAGCTGGAGCGAAAGATCCACTATCGCCAGCAGGATCTGGTGGACTACTCGCCGGTCAGCGAAAAACACCTTGCCGACGGCATGACGGTCGGCGAACTCTGCGCCGCCGCCATTACCATGAGCGATAACAGCGCCGCCAATCTGCTGCTGGCCACCGTCGGCGGCCCCGCAGGATTGACTGCCTTTTTGCGCCAGATCGGCGACAACGTCACCCGCCTTGACCGCTGGGAAACGGAACTGAATGAGGCGCTTCCCGGCGACGCCCGCGACACCACTACCCCGGCCAGCATGGCCGCGACCCTGCGCAAGCTGCTGACCAGCCAGCGTCTGAGCGCCCGTTCGCAACGGCAGCTGCTGCAGTGGATGGTGGACGATCGGGTCGCCGGACCGTTGATCCGCTCCGTGCTGCCGGCGGGCTGGTTTATCGCCGATAAGACCGGAGCTAGCAAGCGGGGTGCGCGCGGGATTGTCGCCCTGCTTGGCCCGAATAACAAAGCAGAGCGCATTGTGGTGATTTATCTGCGGGATACGCCGGCGAGCATGGCCGAGCG
gb|AF301532|+|7-868|ARO:3001087|SHV-29 [Klebsiella pneumoniae] 	0	806	16	822	861	1612535+	806	ATGCGTTATATTCGCCTGTGTATTATCACCCTGTGAGCCACCCTGCCGCTGGCGGTACACGCCAGCCCGCAGCCGCTTGAGCAAATTAAACAAAGCGAAAGCCAGCTGTCGGGCCGCGTAGGCATGATAGAAATGGATCTGGCCAGCGGCCGCACGCTGACCGCCTGGCGCGCCGATGAACGCTTTCCCATGATGAGCACCTTTAAAGTAGTGCTCTGCGGCGCAGTGCTGGCGCGGGTGGATGCCGGTGACGAACAGCTGGAGCGAAAGATCCACTATCGCCAGCAGGATCTGGTGGACTACTCGCCGGTCAGCGAAAAACACCTTGCCGACGGCATGACGGTCGGCGAACTCTGCGCCGCCGCCATTACCATGAGCGATAACAGCGCCGCCAATCTGCTGCTGGCCACCGTCGGCGGCCCCGCAGGATTGACTGCCTTTTTGCGCCAGATCGGCGACAACGTCACCCGCCTTGACCGCTGGGAAACGGAACTGAATGAGGCGCTTCCCGGCGACGCCCGCGACACCACTACCCCGGCCAGCATGGCCGCGACCCTGCGCAAGCTGCTGACCAGCCAGCGTCTGAGCGCCCGTTCGCAACGGCAGCTGCTGCAGTGGATGGTGGACGATCGGGTCGCCGGACCGTTGATCCGCTCCGTGCTGCCGGCGGGCTGGTTTATCGCCGATAAGACCGGAGCTAGCAAGCGGGGTGCGCGCGGGATTGTCGCCCTGCTTGGCCCGAATAACAAAGCAGAGCGCATTGTGGTGATTTATCTGCGGGATACGCCGGCGAGCATGGCCGAGCG
gb|EF016356.1|+|0-825|ARO:3001615|OXA-66 [Acinetobacter baumannii] 	0	770	54149	54919	825	246080-	770	ATGAACATTAAAGCACTCTTACTTATAACAAGCGCTATTTTTATTTCAGCCTGCTCACCTTATATAGTGACTGCTAATCCAAATCACAGCGCTTCAAAATCTGATGTAAAAGCAGAGAAAATTAAAAATTTATTTAACGAAGCACACACTACGGGTGTTTTAGTTATCCAACAAGGCCAAACTCAACAAAGCTATGGTAATGATCTTGCTCGTGCTTCGACCGAGTATGTACCTGCTTCGACCTTCAAAATGCTTAATGCTTTGATCGGCCTTGAGCACCATAAGGCAACCACCACAGAAGTATTTAAGTGGGATGGTAAAAAAAGGTTATTCCCAGAATGGGAAAAGGACATGACCCTAGGCGATGCCATGAAAGCTTCCGCTATTCCAGTTTATCAAGATTTAGCTCGTCGTATTGGACTTGAGCTCATGTCTAAGGAAGTGAAGCGTGTTGGTTATGGCAATGCAGATATCGGTACCCAAGTCGATAATTTTTGGCTGGTGGGTCCTTTAAAAATTACTCCTCAGCAAGAGGCACAGTTTGCTTACAAGCTAGCTAATAAAACGCTTCCATTTAGCCAAAAAGTCCAAGATGAAGTGCAATCCATGCTATTCATAGAAGAAAAGAATGGAAACAAAATATACGCAAAAAGTGGTTGGGGATGGGATGTAAACCCACAAGTAGGCTGGTTAACTGGATGGGTTGTTCAGCCTCAAGGGAATATTGTAGCGTTCTCCCTTAACTTAGAAATGAAAAAAGGAATACCTAG
gb|AM176553|+|30-891|ARO:3001132|SHV-78 [Klebsiella pneumoniae] 	0	806	16	822	861	1612535+	806	ATGCGTTATATTCGCCTGTGTATTATCACCCTGTGAGCCACCCTGCCGCTGGCGGTACACGCCAGCCCGCAGCCGCTTGAGCAAATTAAACAAAGCGAAAGCCAGCTGTCGGGCCGCGTAGGCATGATAGAAATGGATCTGGCCAGCGGCCGCACGCTGACCGCCTGGCGCGCCGATGAACGCTTTCCCATGATGAGCACCTTTAAAGTAGTGCTCTGCGGCGCAGTGCTGGCGCGGGTGGATGCCGGTGACGAACAGCTGGAGCGAAAGATCCACTATCGCCAGCAGGATCTGGTGGACTACTCGCCGGTCAGCGAAAAACACCTTGCCGACGGCATGACGGTCGGCGAACTCTGCGCCGCCGCCATTACCATGAGCGATAACAGCGCCGCCAATCTGCTGCTGGCCACCGTCGGCGGCCCCGCAGGATTGACTGCCTTTTTGCGCCAGATCGGCGACAACGTCACCCGCCTTGACCGCTGGGAAACGGAACTGAATGAGGCGCTTCCCGGCGACGCCCGCGACACCACTACCCCGGCCAGCATGGCCGCGACCCTGCGCAAGCTGCTGACCAGCCAGCGTCTGAGCGCCCGTTCGCAACGGCAGCTGCTGCAGTGGATGGTGGACGATCGGGTCGCCGGACCGTTGATCCGCTCCGTGCTGCCGGCGGGCTGGTTTATCGCCGATAAGACCGGAGCTAGCAAGCGGGGTGCGCGCGGGATTGTCGCCCTGCTTGGCCCGAATAACAAAGCAGAGCGCATTGTGGTGATTTATCTGCGGGATACGCCGGCGAGCATGGCCGAGCG
gb|GQ853680|+|0-825|ARO:3001454|OXA-149 [Acinetobacter baumannii] 	0	770	54149	54919	825	246080-	770	ATGAACATTAAAGCACTCTTACTTATAACAAGCGCTATTTTTATTTCAGCCTGCTCACCTTATATAGTGACTGCTAATCCAAATCACAGCGCTTCAAAATCTGATGTAAAAGCAGAGAAAATTAAAAATTTATTTAACGAAGCACACACTACGGGTGTTTTAGTTATCCAACAAGGCCAAACTCAACAAAGCTATGGTAATGATCTTGCTCGTGCTTCGACCGAGTATGTACCTGCTTCGACCTTCAAAATGCTTAATGCTTTGATCGGCCTTGAGCACCATAAGGCAACCACCACAGAAGTATTTAAGTGGGATGGTAAAAAAAGGTTATTCCCAGAATGGGAAAAGGACATGACCCTAGGCGATGCCATGAAAGCTTCCGCTATTCCAGTTTATCAAGATTTAGCTCGTCGTATTGGACTTGAGCTCATGTCTAAGGAAGTGAAGCGTGTTGGTTATGGCAATGCAGATATCGGTACCCAAGTCGATAATTTTTGGCTGGTGGGTCCTTTAAAAATTACTCCTCAGCAAGAGGCACAGTTTGCTTACAAGCTAGCTAATAAAACGCTTCCATTTAGCCAAAAAGTCCAAGATGAAGTGCAATCCATGCTATTCATAGAAGAAAAGAATGGAAACAAAATATACGCAAAAAGTGGTTGGGGATGGGATGTAAACCCACAAGTAGGCTGGTTAACTGGATGGGTTGTTCAGCCTCAAGGGAATATTGTAGCGTTCTCCCTTAACTTAGAAATGAAAAAAGGAATACCTAG
gb|KF057033|+|0-825|ARO:3001687|OXA-316 [Acinetobacter baumannii] 	0	770	54149	54919	825	246080-	770	ATGAACATTAAAGCACTCTTACTTATAACAAGCGCTATTTTTATTTCAGCCTGCTCACCTTATATAGTGACTGCTAATCCAAATCACAGCGCTTCAAAATCTGATGTAAAAGCAGAGAAAATTAAAAATTTATTTAACGAAGCACACACTACGGGTGTTTTAGTTATCCAACAAGGCCAAACTCAACAAAGCTATGGTAATGATCTTGCTCGTGCTTCGACCGAGTATGTACCTGCTTCGACCTTCAAAATGCTTAATGCTTTGATCGGCCTTGAGCACCATAAGGCAACCACCACAGAAGTATTTAAGTGGGATGGTAAAAAAAGGTTATTCCCAGAATGGGAAAAGGACATGACCCTAGGCGATGCCATGAAAGCTTCCGCTATTCCAGTTTATCAAGATTTAGCTCGTCGTATTGGACTTGAGCTCATGTCTAAGGAAGTGAAGCGTGTTGGTTATGGCAATGCAGATATCGGTACCCAAGTCGATAATTTTTGGCTGGTGGGTCCTTTAAAAATTACTCCTCAGCAAGAGGCACAGTTTGCTTACAAGCTAGCTAATAAAACGCTTCCATTTAGCCAAAAAGTCCAAGATGAAGTGCAATCCATGCTATTCATAGAAGAAAAGAATGGAAACAAAATATACGCAAAAAGTGGTTGGGGATGGGATGTAAACCCACAAGTAGGCTGGTTAACTGGATGGGTTGTTCAGCCTCAAGGGAATATTGTAGCGTTCTCCCTTAACTTAGAAATGAAAAAAGGAATACCTAG
gb|JX013655|+|0-861|ARO:3001185|SHV-145 [Klebsiella pneumoniae] 	0	806	16	822	861	1612535+	806	ATGCGTTATATTCGCCTGTGTATTATCACCCTGTGAGCCACCCTGCCGCTGGCGGTACACGCCAGCCCGCAGCCGCTTGAGCAAATTAAACAAAGCGAAAGCCAGCTGTCGGGCCGCGTAGGCATGATAGAAATGGATCTGGCCAGCGGCCGCACGCTGACCGCCTGGCGCGCCGATGAACGCTTTCCCATGATGAGCACCTTTAAAGTAGTGCTCTGCGGCGCAGTGCTGGCGCGGGTGGATGCCGGTGACGAACAGCTGGAGCGAAAGATCCACTATCGCCAGCAGGATCTGGTGGACTACTCGCCGGTCAGCGAAAAACACCTTGCCGACGGCATGACGGTCGGCGAACTCTGCGCCGCCGCCATTACCATGAGCGATAACAGCGCCGCCAATCTGCTGCTGGCCACCGTCGGCGGCCCCGCAGGATTGACTGCCTTTTTGCGCCAGATCGGCGACAACGTCACCCGCCTTGACCGCTGGGAAACGGAACTGAATGAGGCGCTTCCCGGCGACGCCCGCGACACCACTACCCCGGCCAGCATGGCCGCGACCCTGCGCAAGCTGCTGACCAGCCAGCGTCTGAGCGCCCGTTCGCAACGGCAGCTGCTGCAGTGGATGGTGGACGATCGGGTCGCCGGACCGTTGATCCGCTCCGTGCTGCCGGCGGGCTGGTTTATCGCCGATAAGACCGGAGCTAGCAAGCGGGGTGCGCGCGGGATTGTCGCCCTGCTTGGCCCGAATAACAAAGCAGAGCGCATTGTGGTGATTTATCTGCGGGATACGCCGGCGAGCATGGCCGAGCG
gb|X98102|+|73-934|ARO:3001061|SHV-2A [Klebsiella pneumoniae] 	0	806	16	822	861	1612535+	806	ATGCGTTATATTCGCCTGTGTATTATCACCCTGTGAGCCACCCTGCCGCTGGCGGTACACGCCAGCCCGCAGCCGCTTGAGCAAATTAAACAAAGCGAAAGCCAGCTGTCGGGCCGCGTAGGCATGATAGAAATGGATCTGGCCAGCGGCCGCACGCTGACCGCCTGGCGCGCCGATGAACGCTTTCCCATGATGAGCACCTTTAAAGTAGTGCTCTGCGGCGCAGTGCTGGCGCGGGTGGATGCCGGTGACGAACAGCTGGAGCGAAAGATCCACTATCGCCAGCAGGATCTGGTGGACTACTCGCCGGTCAGCGAAAAACACCTTGCCGACGGCATGACGGTCGGCGAACTCTGCGCCGCCGCCATTACCATGAGCGATAACAGCGCCGCCAATCTGCTGCTGGCCACCGTCGGCGGCCCCGCAGGATTGACTGCCTTTTTGCGCCAGATCGGCGACAACGTCACCCGCCTTGACCGCTGGGAAACGGAACTGAATGAGGCGCTTCCCGGCGACGCCCGCGACACCACTACCCCGGCCAGCATGGCCGCGACCCTGCGCAAGCTGCTGACCAGCCAGCGTCTGAGCGCCCGTTCGCAACGGCAGCTGCTGCAGTGGATGGTGGACGATCGGGTCGCCGGACCGTTGATCCGCTCCGTGCTGCCGGCGGGCTGGTTTATCGCCGATAAGACCGGAGCTAGCAAGCGGGGTGCGCGCGGGATTGTCGCCCTGCTTGGCCCGAATAACAAAGCAGAGCGCATTGTGGTGATTTATCTGCGGGATACGCCGGCGAGCATGGCCGAGCG
gb|GQ853681|+|0-825|ARO:3001455|OXA-150 [Acinetobacter baumannii] 	0	770	54149	54919	825	246080-	770	ATGAACATTAAAGCACTCTTACTTATAACAAGCGCTATTTTTATTTCAGCCTGCTCACCTTATATAGTGACTGCTAATCCAAATCACAGCGCTTCAAAATCTGATGTAAAAGCAGAGAAAATTAAAAATTTATTTAACGAAGCACACACTACGGGTGTTTTAGTTATCCAACAAGGCCAAACTCAACAAAGCTATGGTAATGATCTTGCTCGTGCTTCGACCGAGTATGTACCTGCTTCGACCTTCAAAATGCTTAATGCTTTGATCGGCCTTGAGCACCATAAGGCAACCACCACAGAAGTATTTAAGTGGGATGGTAAAAAAAGGTTATTCCCAGAATGGGAAAAGGACATGACCCTAGGCGATGCCATGAAAGCTTCCGCTATTCCAGTTTATCAAGATTTAGCTCGTCGTATTGGACTTGAGCTCATGTCTAAGGAAGTGAAGCGTGTTGGTTATGGCAATGCAGATATCGGTACCCAAGTCGATAATTTTTGGCTGGTGGGTCCTTTAAAAATTACTCCTCAGCAAGAGGCACAGTTTGCTTACAAGCTAGCTAATAAAACGCTTCCATTTAGCCAAAAAGTCCAAGATGAAGTGCAATCCATGCTATTCATAGAAGAAAAGAATGGAAACAAAATATACGCAAAAAGTGGTTGGGGATGGGATGTAAACCCACAAGTAGGCTGGTTAACTGGATGGGTTGTTCAGCCTCAAGGGAATATTGTAGCGTTCTCCCTTAACTTAGAAATGAAAAAAGGAATACCTAG
gb|FJ666070|+|0-1194|ARO:3002506|PDC-7 [Pseudomonas aeruginosa] 	0	1139	35513	36652	1194	232416+	1139	ATGCGCGATACCAGATTCCCCTGCCTGTGCGGCATCGCCGCTTCCACACTGCTGTTCGCCACCACCCCGGCCATTGCCGATGAGGCCCCGGCGGATCGCCTGAAGGCACTGGTCGACGCCGCCGTACAACCGGTGATGAAGGCCAATGACATTCCGGGCCTGGCCGTAGCCATCAGCCTGAAAGGAGAACCGCATTACTTCAGCTATGGGCTGGCCTCGAAAGAGGACGGCCGCCGGGTGACGCCGGAGACCCTGTTCGAGATCGGCTCGGTGAGCAAGACCTTCACCGTCACCCTCGCCGGCTATGCCCTGGCCCAGGACAAGATGCGCCTCGACGACCGCGCCAGCCAGCACTGGCCGGCACTGCAGGGCAGCCGCTTCGACGGCATCAGCCTGCTCGACCTCGCGACCTATACCGCCGGCGGCTTGCCGCTGCAGTTCCCCGACTCGGTGCAGAAGGACCAGGCACAGATCCGCGACTACTACCGCCAGTGGCAGCCGACCTACGCGCCGGGCAGCCAGCGCCTCTATTCCAACCCGAGCATCGGCCTGTTCGGCTATCTCGCCGCGCGCAGCCTGGGCCAGCCGTTCGAACGGCTCATGGAGCAGCAATTGTTCCCGGCACTGGGCCTCGAACAGACCCACCTCGACGTGCCCGAGGCGGCGCTGGCGCAGTACGCCCAGGGCTACGGCAAGGACGACCGCCCGCTACGGGTCGGTCCCGGCCCGCTGGATGCCGAAGGCTACGGGGTGAAGACCAGCGCGGCCGACCTGCTGCGCTTCGTCGATGCCAACCTGCATCCGGAGCGCCTGGACAGGCCCTGGGCGCAGGCGCTCGATGCCACCCATCGCGGTTACTACAAGGTCGGCGACATGACCCAGGGCCTGGGCTGGGAAGCCTACGACTGGCCGATCTCCCTGAAGCGCCTGCAGGCCGGCAACTCGACGCCGATGGCGCTGCAACCACACAGGATCGCCAGGCTGCCCGCGCCACAGGCGCTGGAGGGCCAGCGCCTGCTGAACAAGACCGGCTCCACCAACGGCTTCGGCGCCTACGTGGCGTTCGTCCCGGGCCGCGACCTGGGCCTGGTGATCCTGGCCAACCGCAACTATCCCAATGCCGAGCGGGTGAAGATCGC
gb|JCMW02000002.1|-|55721-56522|ARO:3004489|OXA-663 [Klebsiella pneumoniae BIDMC 35] 	0	746	659	1405	801	104604+	746	ATGAAAACATTTGCCGCATATGTAATTATCGCGTGTCTTTCGAGTACGGCATTAGCTGGTTCAATTACAGAAAATACGTCTTGGAACAAAGAGTTCTCTGCCGAAGCCGTCAATGGTGTCTTCGTGCTTTGTAAAAGTAGCAGTAAATCCTGCGCTACCAATGACTTAGCTCGTGCATCAAAGGAATATCTTCCAGCATCAACATTTAAGATCCCCAACGCAATTATCGGCCTAGAAACTGGTGTCATAAAGAATGAGCATCAGGTTTTCAAATGGGACGGAAAGCCAAGAGCCATGAAGCAATGGGAAAGAGACTTGACCTTAAGAGGGGCAATACAAGTTTCAGCTGTTCCCGTATTTCAACAAATCGCCAGAGAAGTTGGCGAAGTAAGAATGCAGAAATACCTTAAAAAATTTTCCTATGGCAACCAGAATATCAGTGGTGGCATTGACAAATTCTGGTTGGAAGGCCAGCTTAGAATTTCCGCAGTTAATCAAGTGGAGTTTCTAGAGTCTCTATATTTAAATAAATTGTCAGCATCTAAAGAAAACCAGCTAATAGTAAAAGAGGCTTTGGTAACGGAGGCGGCACCTGAATATCTAGTGCATTCAAAAACTGGTTTTTCTGGTGTGGGAACTGAGTCAAATCCTGGTGTCGCATGGTGGGTTGGGTGGGTTGAGAAGGAGACAGAGGTTTACTTTTTCGCCTTTAACATGGATATAGACAACGAAAGTAAGTTGCCGCT
gb|KF057034|+|0-825|ARO:3001688|OXA-317 [Acinetobacter baumannii] 	0	770	54149	54919	825	246080-	770	ATGAACATTAAAGCACTCTTACTTATAACAAGCGCTATTTTTATTTCAGCCTGCTCACCTTATATAGTGACTGCTAATCCAAATCACAGCGCTTCAAAATCTGATGTAAAAGCAGAGAAAATTAAAAATTTATTTAACGAAGCACACACTACGGGTGTTTTAGTTATCCAACAAGGCCAAACTCAACAAAGCTATGGTAATGATCTTGCTCGTGCTTCGACCGAGTATGTACCTGCTTCGACCTTCAAAATGCTTAATGCTTTGATCGGCCTTGAGCACCATAAGGCAACCACCACAGAAGTATTTAAGTGGGATGGTAAAAAAAGGTTATTCCCAGAATGGGAAAAGGACATGACCCTAGGCGATGCCATGAAAGCTTCCGCTATTCCAGTTTATCAAGATTTAGCTCGTCGTATTGGACTTGAGCTCATGTCTAAGGAAGTGAAGCGTGTTGGTTATGGCAATGCAGATATCGGTACCCAAGTCGATAATTTTTGGCTGGTGGGTCCTTTAAAAATTACTCCTCAGCAAGAGGCACAGTTTGCTTACAAGCTAGCTAATAAAACGCTTCCATTTAGCCAAAAAGTCCAAGATGAAGTGCAATCCATGCTATTCATAGAAGAAAAGAATGGAAACAAAATATACGCAAAAAGTGGTTGGGGATGGGATGTAAACCCACAAGTAGGCTGGTTAACTGGATGGGTTGTTCAGCCTCAAGGGAATATTGTAGCGTTCTCCCTTAACTTAGAAATGAAAAAAGGAATACCTAG
gb|JX121114|+|0-858|ARO:3001186|SHV-147 [Klebsiella pneumoniae] 	0	803	16	819	858	1612535+	803	ATGCGTTATATTCGCCTGTGTATTATCACCCTGTGAGCCACCCTGCCGCTGGCGGTACACGCCAGCCCGCAGCCGCTTGAGCAAATTAAACAAAGCGAAAGCCAGCTGTCGGGCCGCGTAGGCATGATAGAAATGGATCTGGCCAGCGGCCGCACGCTGACCGCCTGGCGCGCCGATGAACGCTTTCCCATGATGAGCACCTTTAAAGTAGTGCTCTGCGGCGCAGTGCTGGCGCGGGTGGATGCCGGTGACGAACAGCTGGAGCGAAAGATCCACTATCGCCAGCAGGATCTGGTGGACTACTCGCCGGTCAGCGAAAAACACCTTGCCGACGGCATGACGGTCGGCGAACTCTGCGCCGCCGCCATTACCATGAGCGATAACAGCGCCGCCAATCTGCTGCTGGCCACCGTCGGCGGCCCCGCAGGATTGACTGCCTTTTTGCGCCAGATCGGCGACAACGTCACCCGCCTTGACCGCTGGGAAACGGAACTGAATGAGGCGCTTCCCGGCGACGCCCGCGACACCACTACCCCGGCCAGCATGGCCGCGACCCTGCGCAAGCTGCTGACCAGCCAGCGTCTGAGCGCCCGTTCGCAACGGCAGCTGCTGCAGTGGATGGTGGACGATCGGGTCGCCGGACCGTTGATCCGCTCCGTGCTGCCGGCGGGCTGGTTTATCGCCGATAAGACCGGAGCTAGCAAGCGGGGTGCGCGCGGGATTGTCGCCCTGCTTGGCCCGAATAACAAAGCAGAGCGCATTGTGGTGATTTATCTGCGGGATACGCCGGCGAGCATGGCCGA
gb|KX092356.1|+|192-1053|ARO:3001062|SHV-3 [Klebsiella pneumoniae] 	0	806	16	822	861	1612535+	806	ATGCGTTATATTCGCCTGTGTATTATCACCCTGTGAGCCACCCTGCCGCTGGCGGTACACGCCAGCCCGCAGCCGCTTGAGCAAATTAAACAAAGCGAAAGCCAGCTGTCGGGCCGCGTAGGCATGATAGAAATGGATCTGGCCAGCGGCCGCACGCTGACCGCCTGGCGCGCCGATGAACGCTTTCCCATGATGAGCACCTTTAAAGTAGTGCTCTGCGGCGCAGTGCTGGCGCGGGTGGATGCCGGTGACGAACAGCTGGAGCGAAAGATCCACTATCGCCAGCAGGATCTGGTGGACTACTCGCCGGTCAGCGAAAAACACCTTGCCGACGGCATGACGGTCGGCGAACTCTGCGCCGCCGCCATTACCATGAGCGATAACAGCGCCGCCAATCTGCTGCTGGCCACCGTCGGCGGCCCCGCAGGATTGACTGCCTTTTTGCGCCAGATCGGCGACAACGTCACCCGCCTTGACCGCTGGGAAACGGAACTGAATGAGGCGCTTCCCGGCGACGCCCGCGACACCACTACCCCGGCCAGCATGGCCGCGACCCTGCGCAAGCTGCTGACCAGCCAGCGTCTGAGCGCCCGTTCGCAACGGCAGCTGCTGCAGTGGATGGTGGACGATCGGGTCGCCGGACCGTTGATCCGCTCCGTGCTGCCGGCGGGCTGGTTTATCGCCGATAAGACCGGAGCTAGCAAGCGGGGTGCGCGCGGGATTGTCGCCCTGCTTGGCCCGAATAACAAAGCAGAGCGCATTGTGGTGATTTATCTGCGGGATACGCCGGCGAGCATGGCCGAGCG
gb|JX121115|+|0-858|ARO:3001187|SHV-148 [Klebsiella pneumoniae] 	0	801	16	817	858	1612535+	801	ATGCGTTATATTCGCCTGTGTATTATCACCCTGTGAGCCACCCTGCCGCTGGCGGTACACGCCAGCCCGCAGCCGCTTGAGCAAATTAAACAAAGCGAAAGCCAGCTGTCGGGCCGCGTAGGCATGATAGAAATGGATCTGGCCAGCGGCCGCACGCTGACCGCCTGGCGCGCCGATGAACGCTTTCCCATGATGAGCACCTTTAAAGTAGTGCTCTGCGGCGCAGTGCTGGCGCGGGTGGATGCCGGTGACGAACAGCTGGAGCGAAAGATCCACTATCGCCAGCAGGATCTGGTGGACTACTCGCCGGTCAGCGAAAAACACCTTGCCGACGGCATGACGGTCGGCGAACTCTGCGCCGCCGCCATTACCATGAGCGATAACAGCGCCGCCAATCTGCTGCTGGCCACCGTCGGCGGCCCCGCAGGATTGACTGCCTTTTTGCGCCAGATCGGCGACAACGTCACCCGCCTTGACCGCTGGGAAACGGAACTGAATGAGGCGCTTCCCGGCGACGCCCGCGACACCACTACCCCGGCCAGCATGGCCGCGACCCTGCGCAAGCTGCTGACCAGCCAGCGTCTGAGCGCCCGTTCGCAACGGCAGCTGCTGCAGTGGATGGTGGACGATCGGGTCGCCGGACCGTTGATCCGCTCCGTGCTGCCGGCGGGCTGGTTTATCGCCGATAAGACCGGAGCTAGCAAGCGGGGTGCGCGCGGGATTGTCGCCCTGCTTGGCCCGAATAACAAAGCAGAGCGCATTGTGGTGATTTATCTGCGGGATACGCCGGCGAGCATGGCC
gb|AF043100|+|0-775|ARO:3001411|OXA-16 [Pseudomonas aeruginosa] Partial	0	720	685	1405	775	104604+	720	TATCGCGTGTCTTTCGAGTACGGCATTAGCTGGTTCAATTACAGAAAATACGTCTTGGAACAAAGAGTTCTCTGCCGAAGCCGTCAATGGTGTCTTCGTGCTTTGTAAAAGTAGCAGTAAATCCTGCGCTACCAATGACTTAGCTCGTGCATCAAAGGAATATCTTCCAGCATCAACATTTAAGATCCCCAACGCAATTATCGGCCTAGAAACTGGTGTCATAAAGAATGAGCATCAGGTTTTCAAATGGGACGGAAAGCCAAGAGCCATGAAGCAATGGGAAAGAGACTTGACCTTAAGAGGGGCAATACAAGTTTCAGCTGTTCCCGTATTTCAACAAATCGCCAGAGAAGTTGGCGAAGTAAGAATGCAGAAATACCTTAAAAAATTTTCCTATGGCAACCAGAATATCAGTGGTGGCATTGACAAATTCTGGTTGGAAGGCCAGCTTAGAATTTCCGCAGTTAATCAAGTGGAGTTTCTAGAGTCTCTATATTTAAATAAATTGTCAGCATCTAAAGAAAACCAGCTAATAGTAAAAGAGGCTTTGGTAACGGAGGCGGCACCTGAATATCTAGTGCATTCAAAAACTGGTTTTTCTGGTGTGGGAACTGAGTCAAATCCTGGTGTCGCATGGTGGGTTGGGTGGGTTGAGAAGGAGACAGAGGTTTACTTTTTCGCCTTTAACATGGATATAGACAACGAAAGTAAGTTGCCGCT
gb|AY661885|+|48-909|ARO:3001088|SHV-30 [Enterobacter cloacae] 	0	806	16	822	861	1612535+	806	ATGCGTTATATTCGCCTGTGTATTATCACCCTGTGAGCCACCCTGCCGCTGGCGGTACACGCCAGCCCGCAGCCGCTTGAGCAAATTAAACAAAGCGAAAGCCAGCTGTCGGGCCGCGTAGGCATGATAGAAATGGATCTGGCCAGCGGCCGCACGCTGACCGCCTGGCGCGCCGATGAACGCTTTCCCATGATGAGCACCTTTAAAGTAGTGCTCTGCGGCGCAGTGCTGGCGCGGGTGGATGCCGGTGACGAACAGCTGGAGCGAAAGATCCACTATCGCCAGCAGGATCTGGTGGACTACTCGCCGGTCAGCGAAAAACACCTTGCCGACGGCATGACGGTCGGCGAACTCTGCGCCGCCGCCATTACCATGAGCGATAACAGCGCCGCCAATCTGCTGCTGGCCACCGTCGGCGGCCCCGCAGGATTGACTGCCTTTTTGCGCCAGATCGGCGACAACGTCACCCGCCTTGACCGCTGGGAAACGGAACTGAATGAGGCGCTTCCCGGCGACGCCCGCGACACCACTACCCCGGCCAGCATGGCCGCGACCCTGCGCAAGCTGCTGACCAGCCAGCGTCTGAGCGCCCGTTCGCAACGGCAGCTGCTGCAGTGGATGGTGGACGATCGGGTCGCCGGACCGTTGATCCGCTCCGTGCTGCCGGCGGGCTGGTTTATCGCCGATAAGACCGGAGCTAGCAAGCGGGGTGCGCGCGGGATTGTCGCCCTGCTTGGCCCGAATAACAAAGCAGAGCGCATTGTGGTGATTTATCTGCGGGATACGCCGGCGAGCATGGCCGAGCG
gb|AY177427.1|+|1141-2293|ARO:3003848|ADC-2 [Oligella urethralis] 	0	1097	63	1160	1152	126080+	1097	ATGCGATTTAAAAAAATTTCTTGTCTACTTTTATCCCCGCTTTTTATTTTTAGTACCTCAATTTATGCGGGCAATACACCAAAAGACCAAGAAATTAAAAAACTGGTAGATCAAAACTTTAAACCGTTATTAGAAAAATATGATGTGCCAGGTATGGCTGTGGGTGTTATTCAAAATAATAAAAAGTATGAAATGTATTATGGTCTTCAATCTGTTCAAGATAAAAAAGCCGTAAATAGCAGTACTATTTTTGAGCTAGGTTCTGTCAGTAAATTATTTACCGCGACAGCAGGTGGATATGCAAAAAATAAAGGAAAAATCTCTTTTGACGATACGCCTGGTAAGTATTGGAAAGAACTAAAAAATACACCGATTGACCAAGTTAACTTACTTCAACTCGCGACGTATACAAGTGGTAACCTTGCCTTGCAATTTCCAGATGAAGTAAAAACAGATCAGCAAGTTTTAACATTTTTTAAAGACTGGAAACCTAAAAACTCAATCGGTGAATATCGACAATATTCAAACCCAAGCATTGGTTTATTTGGAAAAGTTGTAGCTTTGTCTATGAATAAACCTTTCGACCAAGTCTTAGAAAAAACAATTTTTCCGGCCCTTGGCTTAAAACATAGCTATGTAAATGTACCTAAGACCCAGATGCAAAACTATGCTTTTGGCTATAACCAAGAAAATCAGCCGATTCGAGTTAACCCCGGCCCACTCGATGCCCCAGCATATGGCGTCAAATCGACACTACCCGACATGTTGAGTTTTATTCATGCCAACCTAAATCCACAAAAATATCCAGCAGATATTCAACGGGCAATTAATGAAACACATCAGGGTCGCTATCAAGTAAATACCATGTATCAGGCACTCGGTTGGGAAGAGTTTTCTTATCCGGCAACGTTACAAACTTTATTAGACAGTAATTCAGAACAGATTGTGATGAAACCTAATAAAGTGACTGCTATTTCAAAGGAACCTTCAGTTAAGATGTACCATAAAACTGGCTCAACTACCGGTTTCGGAACATATGTGGTGTTTATTCCTAAAGAAAATATTGGTTTAGTCATGTTAACCAATAAACGTATTCC
gb|JX121116|+|0-858|ARO:3001188|SHV-149 [Klebsiella pneumoniae] 	0	803	16	819	858	1612535+	803	ATGCGTTATATTCGCCTGTGTATTATCACCCTGTGAGCCACCCTGCCGCTGGCGGTACACGCCAGCCCGCAGCCGCTTGAGCAAATTAAACAAAGCGAAAGCCAGCTGTCGGGCCGCGTAGGCATGATAGAAATGGATCTGGCCAGCGGCCGCACGCTGACCGCCTGGCGCGCCGATGAACGCTTTCCCATGATGAGCACCTTTAAAGTAGTGCTCTGCGGCGCAGTGCTGGCGCGGGTGGATGCCGGTGACGAACAGCTGGAGCGAAAGATCCACTATCGCCAGCAGGATCTGGTGGACTACTCGCCGGTCAGCGAAAAACACCTTGCCGACGGCATGACGGTCGGCGAACTCTGCGCCGCCGCCATTACCATGAGCGATAACAGCGCCGCCAATCTGCTGCTGGCCACCGTCGGCGGCCCCGCAGGATTGACTGCCTTTTTGCGCCAGATCGGCGACAACGTCACCCGCCTTGACCGCTGGGAAACGGAACTGAATGAGGCGCTTCCCGGCGACGCCCGCGACACCACTACCCCGGCCAGCATGGCCGCGACCCTGCGCAAGCTGCTGACCAGCCAGCGTCTGAGCGCCCGTTCGCAACGGCAGCTGCTGCAGTGGATGGTGGACGATCGGGTCGCCGGACCGTTGATCCGCTCCGTGCTGCCGGCGGGCTGGTTTATCGCCGATAAGACCGGAGCTAGCAAGCGGGGTGCGCGCGGGATTGTCGCCCTGCTTGGCCCGAATAACAAAGCAGAGCGCATTGTGGTGATTTATCTGCGGGATACGCCGGCGAGCATGGCCGA
gb|KF203108|+|0-825|ARO:3001522|OXA-334 [Acinetobacter johnsonii] 	0	770	156	929	825	5350482-	773	ATGAAAACTTTACAGTTGGGCCTCATCGTCCTCATTACTACCTTCGGTTCTGCATGTACCATAATAAGAAGCCCCTCCATAGAAACAGCTAAAAACCATGAGCAACAAAGTGCGCAGCAGCAGATCCAACAGGCCTTCGATCAACTCCAAACCACGGGGGTGATTGTCATAAAGGATAAGCATGGCTTACACAGCTACGGCAATGACTTGAGCCGTGCTCAGACACCCTATGTACCCGCCTCTACCTTTAAAATGCTGAATGCCTTAATCGGACTAGAACATGGTAAAGCAACCAGCACCGAGGTGTTTAAATGGGATGGTCAAAAGAACAGCTTCCCTGCTTGGGAAAAAGACATGACTTTAGGGCAAGCCATGCAAGCATCTGCCGTTCCTGTTTATCAGGAGCTAGCACGGCGCATTGGCCTAGATCTAATGCAAAAAGAAGTACAGCGCATTGGATATGGCAATCAACAGATTGGCACCGTTGTCGATAATTTTTGGTTAGTCGGTCCACTGCAAATTACGCCTGTTCAAGAAGTCCTTTTTGTAGAGAAGCTGGCCAATACGCAACTCGCTTTTAAGCCAGATGTGCAACATACCGTACAAGACATGCTGCTGATTGAACAAAAACCGAATTATAAACTCTACGCCAAATCTGGTTGGGGCATGGACCTAGAACCGCAAGTGGGCTGGTGGACAGGCTGGGTCGAAACAGCAACAGGTGAAAAAGTGTATTTTGCTTTGAATATGCATATGAAAACAGGAATTTCAGC
gb|AM176554|+|30-891|ARO:3001133|SHV-79 [Klebsiella pneumoniae] 	0	806	16	822	861	1612535+	806	ATGCGTTATATTCGCCTGTGTATTATCACCCTGTGAGCCACCCTGCCGCTGGCGGTACACGCCAGCCCGCAGCCGCTTGAGCAAATTAAACAAAGCGAAAGCCAGCTGTCGGGCCGCGTAGGCATGATAGAAATGGATCTGGCCAGCGGCCGCACGCTGACCGCCTGGCGCGCCGATGAACGCTTTCCCATGATGAGCACCTTTAAAGTAGTGCTCTGCGGCGCAGTGCTGGCGCGGGTGGATGCCGGTGACGAACAGCTGGAGCGAAAGATCCACTATCGCCAGCAGGATCTGGTGGACTACTCGCCGGTCAGCGAAAAACACCTTGCCGACGGCATGACGGTCGGCGAACTCTGCGCCGCCGCCATTACCATGAGCGATAACAGCGCCGCCAATCTGCTGCTGGCCACCGTCGGCGGCCCCGCAGGATTGACTGCCTTTTTGCGCCAGATCGGCGACAACGTCACCCGCCTTGACCGCTGGGAAACGGAACTGAATGAGGCGCTTCCCGGCGACGCCCGCGACACCACTACCCCGGCCAGCATGGCCGCGACCCTGCGCAAGCTGCTGACCAGCCAGCGTCTGAGCGCCCGTTCGCAACGGCAGCTGCTGCAGTGGATGGTGGACGATCGGGTCGCCGGACCGTTGATCCGCTCCGTGCTGCCGGCGGGCTGGTTTATCGCCGATAAGACCGGAGCTAGCAAGCGGGGTGCGCGCGGGATTGTCGCCCTGCTTGGCCCGAATAACAAAGCAGAGCGCATTGTGGTGATTTATCTGCGGGATACGCCGGCGAGCATGGCCGAGCG
gb|HM488986|+|0-822|ARO:3001465|OXA-165 [Acinetobacter baumannii] 	0	767	80	847	822	254088-	767	ATGAATAAATATTTTACTTGCTATGTGGTTGCTTCTCTTTTTCTTTCTGGTTGTACGGTTCAGCATAATTTAATAAATGAAACCCCGAGTCAGATTGTTCAAGGACATAATCAGGTGATTCATCAATACTTTGATGAAAAAAACACCTCAGGTGTGCTGGTTATTCAAACAGATAAAAAAATTAATCTATATGGTAATGCTCTAAGCCGCGCAAATACAGAATATGTGCCAGCCTCTACATTTAAAATGTTGAATGCCCTGATCGGATTGGAGAACCAGAAAACGGATATTAATGAAATATTTAAATGGAAGGGCGAGAAAAGGTCATTTACCGCTTGGGAAAAAGACATGACACTAGGAGAAGCCATGAAGCTTTCTGCAGTCCCAGTCTATCAGGAACTTGCGCGACGTATCGGTCTTGATCTCATGCAAAAAGAAGTAAAACGTATTGGTTTCGGTAATGCTGAAATTGGACAGCAGGTTGATAATTTCTGGTTGGTAGGACCATTAAAGGTTACGCCTATTCAAGAGGTAGAGTTTGTTTCCCAATTAGCACATACACAGCTTCCATTTAGTGAAAAAGTGCAGGCTAATGTAAAAAATATGCTTCTTTTAGAAGAGAGTAATGGCTACAAAATTTTTGGAAAGACTGGTTGGGCAATGGATATAAAACCACAAGTGGGCTGGTTGACCGGCTGGGTTGAGCAGCCAGATGGAAAAATTGTCGCTTTTGCATTAAATATGGAAATGCGGTCAGAAATGCCGGC
gb|AJ011428|+|0-861|ARO:3001074|SHV-15 [Escherichia coli] 	0	806	16	822	861	1612535+	806	ATGCGTTATATTCGCCTGTGTATTATCACCCTGTGAGCCACCCTGCCGCTGGCGGTACACGCCAGCCCGCAGCCGCTTGAGCAAATTAAACAAAGCGAAAGCCAGCTGTCGGGCCGCGTAGGCATGATAGAAATGGATCTGGCCAGCGGCCGCACGCTGACCGCCTGGCGCGCCGATGAACGCTTTCCCATGATGAGCACCTTTAAAGTAGTGCTCTGCGGCGCAGTGCTGGCGCGGGTGGATGCCGGTGACGAACAGCTGGAGCGAAAGATCCACTATCGCCAGCAGGATCTGGTGGACTACTCGCCGGTCAGCGAAAAACACCTTGCCGACGGCATGACGGTCGGCGAACTCTGCGCCGCCGCCATTACCATGAGCGATAACAGCGCCGCCAATCTGCTGCTGGCCACCGTCGGCGGCCCCGCAGGATTGACTGCCTTTTTGCGCCAGATCGGCGACAACGTCACCCGCCTTGACCGCTGGGAAACGGAACTGAATGAGGCGCTTCCCGGCGACGCCCGCGACACCACTACCCCGGCCAGCATGGCCGCGACCCTGCGCAAGCTGCTGACCAGCCAGCGTCTGAGCGCCCGTTCGCAACGGCAGCTGCTGCAGTGGATGGTGGACGATCGGGTCGCCGGACCGTTGATCCGCTCCGTGCTGCCGGCGGGCTGGTTTATCGCCGATAAGACCGGAGCTAGCAAGCGGGGTGCGCGCGGGATTGTCGCCCTGCTTGGCCCGAATAACAAAGCAGAGCGCATTGTGGTGATTTATCTGCGGGATACGCCGGCGAGCATGGCCGAGCG
gb|DQ491200|+|0-825|ARO:3001437|OXA-67 [Acinetobacter baumannii] 	0	770	54149	54919	825	246080-	770	ATGAACATTAAAGCACTCTTACTTATAACAAGCGCTATTTTTATTTCAGCCTGCTCACCTTATATAGTGACTGCTAATCCAAATCACAGCGCTTCAAAATCTGATGTAAAAGCAGAGAAAATTAAAAATTTATTTAACGAAGCACACACTACGGGTGTTTTAGTTATCCAACAAGGCCAAACTCAACAAAGCTATGGTAATGATCTTGCTCGTGCTTCGACCGAGTATGTACCTGCTTCGACCTTCAAAATGCTTAATGCTTTGATCGGCCTTGAGCACCATAAGGCAACCACCACAGAAGTATTTAAGTGGGATGGTAAAAAAAGGTTATTCCCAGAATGGGAAAAGGACATGACCCTAGGCGATGCCATGAAAGCTTCCGCTATTCCAGTTTATCAAGATTTAGCTCGTCGTATTGGACTTGAGCTCATGTCTAAGGAAGTGAAGCGTGTTGGTTATGGCAATGCAGATATCGGTACCCAAGTCGATAATTTTTGGCTGGTGGGTCCTTTAAAAATTACTCCTCAGCAAGAGGCACAGTTTGCTTACAAGCTAGCTAATAAAACGCTTCCATTTAGCCAAAAAGTCCAAGATGAAGTGCAATCCATGCTATTCATAGAAGAAAAGAATGGAAACAAAATATACGCAAAAAGTGGTTGGGGATGGGATGTAAACCCACAAGTAGGCTGGTTAACTGGATGGGTTGTTCAGCCTCAAGGGAATATTGTAGCGTTCTCCCTTAACTTAGAAATGAAAAAAGGAATACCTAG
gb|KF048907.1|+|0-825|ARO:3001524|OXA-336 [Acinetobacter baumannii] 	0	770	54149	54919	825	246080-	770	ATGAACATTAAAGCACTCTTACTTATAACAAGCGCTATTTTTATTTCAGCCTGCTCACCTTATATAGTGACTGCTAATCCAAATCACAGCGCTTCAAAATCTGATGTAAAAGCAGAGAAAATTAAAAATTTATTTAACGAAGCACACACTACGGGTGTTTTAGTTATCCAACAAGGCCAAACTCAACAAAGCTATGGTAATGATCTTGCTCGTGCTTCGACCGAGTATGTACCTGCTTCGACCTTCAAAATGCTTAATGCTTTGATCGGCCTTGAGCACCATAAGGCAACCACCACAGAAGTATTTAAGTGGGATGGTAAAAAAAGGTTATTCCCAGAATGGGAAAAGGACATGACCCTAGGCGATGCCATGAAAGCTTCCGCTATTCCAGTTTATCAAGATTTAGCTCGTCGTATTGGACTTGAGCTCATGTCTAAGGAAGTGAAGCGTGTTGGTTATGGCAATGCAGATATCGGTACCCAAGTCGATAATTTTTGGCTGGTGGGTCCTTTAAAAATTACTCCTCAGCAAGAGGCACAGTTTGCTTACAAGCTAGCTAATAAAACGCTTCCATTTAGCCAAAAAGTCCAAGATGAAGTGCAATCCATGCTATTCATAGAAGAAAAGAATGGAAACAAAATATACGCAAAAAGTGGTTGGGGATGGGATGTAAACCCACAAGTAGGCTGGTTAACTGGATGGGTTGTTCAGCCTCAAGGGAATATTGTAGCGTTCTCCCTTAACTTAGAAATGAAAAAAGGAATACCTAG
gb|AY277255|+|66-927|ARO:3001089|SHV-31 [Klebsiella pneumoniae] 	0	806	16	822	861	1612535+	806	ATGCGTTATATTCGCCTGTGTATTATCACCCTGTGAGCCACCCTGCCGCTGGCGGTACACGCCAGCCCGCAGCCGCTTGAGCAAATTAAACAAAGCGAAAGCCAGCTGTCGGGCCGCGTAGGCATGATAGAAATGGATCTGGCCAGCGGCCGCACGCTGACCGCCTGGCGCGCCGATGAACGCTTTCCCATGATGAGCACCTTTAAAGTAGTGCTCTGCGGCGCAGTGCTGGCGCGGGTGGATGCCGGTGACGAACAGCTGGAGCGAAAGATCCACTATCGCCAGCAGGATCTGGTGGACTACTCGCCGGTCAGCGAAAAACACCTTGCCGACGGCATGACGGTCGGCGAACTCTGCGCCGCCGCCATTACCATGAGCGATAACAGCGCCGCCAATCTGCTGCTGGCCACCGTCGGCGGCCCCGCAGGATTGACTGCCTTTTTGCGCCAGATCGGCGACAACGTCACCCGCCTTGACCGCTGGGAAACGGAACTGAATGAGGCGCTTCCCGGCGACGCCCGCGACACCACTACCCCGGCCAGCATGGCCGCGACCCTGCGCAAGCTGCTGACCAGCCAGCGTCTGAGCGCCCGTTCGCAACGGCAGCTGCTGCAGTGGATGGTGGACGATCGGGTCGCCGGACCGTTGATCCGCTCCGTGCTGCCGGCGGGCTGGTTTATCGCCGATAAGACCGGAGCTAGCAAGCGGGGTGCGCGCGGGATTGTCGCCCTGCTTGGCCCGAATAACAAAGCAGAGCGCATTGTGGTGATTTATCTGCGGGATACGCCGGCGAGCATGGCCGAGCG
gb|KR057742.1|+|0-1116|ARO:3004336|PDC-73 [Pseudomonas aeruginosa] 	3	1061	35594	36652	1116	232416+	1058	GAGGCCCCGGCGGATCGCCTGAAGGCACTGGTCGACGCCGCCGTACAACCGGTGATGAAGGCCAATGACATTCCGGGCCTGGCCGTAGCCATCAGCCTGAAAGGAGAACCGCATTACTTCAGCTATGGGCTGGCCTCGAAAGAGGACGGCCGCCGGGTGACGCCGGAGACCCTGTTCGAGATCGGCTCGGTGAGCAAGACCTTCACCGTCACCCTCGCCGGCTATGCCCTGGCCCAGGACAAGATGCGCCTCGACGACCGCGCCAGCCAGCACTGGCCGGCACTGCAGGGCAGCCGCTTCGACGGCATCAGCCTGCTCGACCTCGCGACCTATACCGCCGGCGGCTTGCCGCTGCAGTTCCCCGACTCGGTGCAGAAGGACCAGGCACAGATCCGCGACTACTACCGCCAGTGGCAGCCGACCTACGCGCCGGGCAGCCAGCGCCTCTATTCCAACCCGAGCATCGGCCTGTTCGGCTATCTCGCCGCGCGCAGCCTGGGCCAGCCGTTCGAACGGCTCATGGAGCAGCAATTGTTCCCGGCACTGGGCCTCGAACAGACCCACCTCGACGTGCCCGAGGCGGCGCTGGCGCAGTACGCCCAGGGCTACGGCAAGGACGACCGCCCGCTACGGGTCGGTCCCGGCCCGCTGGATGCCGAAGGCTACGGGGTGAAGACCAGCGCGGCCGACCTGCTGCGCTTCGTCGATGCCAACCTGCATCCGGAGCGCCTGGACAGGCCCTGGGCGCAGGCGCTCGATGCCACCCATCGCGGTTACTACAAGGTCGGCGACATGACCCAGGGCCTGGGCTGGGAAGCCTACGACTGGCCGATCTCCCTGAAGCGCCTGCAGGCCGGCAACTCGACGCCGATGGCGCTGCAACCACACAGGATCGCCAGGCTGCCCGCGCCACAGGCGCTGGAGGGCCAGCGCCTGCTGAACAAGACCGGCTCCACCAACGGCTTCGGCGCCTACGTGGCGTTCGTCCCGGGCCGCGACCTGGGCCTGGTGATCCTGGCCAACCGCAACTATCCCAATGCCGAGCGGGTGAAGATCGC
gb|U92041|+|0-861|ARO:3001067|SHV-8 [Escherichia coli] 	0	806	16	822	861	1612535+	806	ATGCGTTATATTCGCCTGTGTATTATCACCCTGTGAGCCACCCTGCCGCTGGCGGTACACGCCAGCCCGCAGCCGCTTGAGCAAATTAAACAAAGCGAAAGCCAGCTGTCGGGCCGCGTAGGCATGATAGAAATGGATCTGGCCAGCGGCCGCACGCTGACCGCCTGGCGCGCCGATGAACGCTTTCCCATGATGAGCACCTTTAAAGTAGTGCTCTGCGGCGCAGTGCTGGCGCGGGTGGATGCCGGTGACGAACAGCTGGAGCGAAAGATCCACTATCGCCAGCAGGATCTGGTGGACTACTCGCCGGTCAGCGAAAAACACCTTGCCGACGGCATGACGGTCGGCGAACTCTGCGCCGCCGCCATTACCATGAGCGATAACAGCGCCGCCAATCTGCTGCTGGCCACCGTCGGCGGCCCCGCAGGATTGACTGCCTTTTTGCGCCAGATCGGCGACAACGTCACCCGCCTTGACCGCTGGGAAACGGAACTGAATGAGGCGCTTCCCGGCGACGCCCGCGACACCACTACCCCGGCCAGCATGGCCGCGACCCTGCGCAAGCTGCTGACCAGCCAGCGTCTGAGCGCCCGTTCGCAACGGCAGCTGCTGCAGTGGATGGTGGACGATCGGGTCGCCGGACCGTTGATCCGCTCCGTGCTGCCGGCGGGCTGGTTTATCGCCGATAAGACCGGAGCTAGCAAGCGGGGTGCGCGCGGGATTGTCGCCCTGCTTGGCCCGAATAACAAAGCAGAGCGCATTGTGGTGATTTATCTGCGGGATACGCCGGCGAGCATGGCCGAGCG
gb|HM488987|+|0-822|ARO:3001466|OXA-166 [Acinetobacter baumannii] 	0	767	80	847	822	254088-	767	ATGAATAAATATTTTACTTGCTATGTGGTTGCTTCTCTTTTTCTTTCTGGTTGTACGGTTCAGCATAATTTAATAAATGAAACCCCGAGTCAGATTGTTCAAGGACATAATCAGGTGATTCATCAATACTTTGATGAAAAAAACACCTCAGGTGTGCTGGTTATTCAAACAGATAAAAAAATTAATCTATATGGTAATGCTCTAAGCCGCGCAAATACAGAATATGTGCCAGCCTCTACATTTAAAATGTTGAATGCCCTGATCGGATTGGAGAACCAGAAAACGGATATTAATGAAATATTTAAATGGAAGGGCGAGAAAAGGTCATTTACCGCTTGGGAAAAAGACATGACACTAGGAGAAGCCATGAAGCTTTCTGCAGTCCCAGTCTATCAGGAACTTGCGCGACGTATCGGTCTTGATCTCATGCAAAAAGAAGTAAAACGTATTGGTTTCGGTAATGCTGAAATTGGACAGCAGGTTGATAATTTCTGGTTGGTAGGACCATTAAAGGTTACGCCTATTCAAGAGGTAGAGTTTGTTTCCCAATTAGCACATACACAGCTTCCATTTAGTGAAAAAGTGCAGGCTAATGTAAAAAATATGCTTCTTTTAGAAGAGAGTAATGGCTACAAAATTTTTGGAAAGACTGGTTGGGCAATGGATATAAAACCACAAGTGGGCTGGTTGACCGGCTGGGTTGAGCAGCCAGATGGAAAAATTGTCGCTTTTGCATTAAATATGGAAATGCGGTCAGAAATGCCGGC
gb|AY750910|+|0-825|ARO:3001616|OXA-68 [Acinetobacter baumannii] 	0	770	54149	54919	825	246080-	770	ATGAACATTAAAGCACTCTTACTTATAACAAGCGCTATTTTTATTTCAGCCTGCTCACCTTATATAGTGACTGCTAATCCAAATCACAGCGCTTCAAAATCTGATGTAAAAGCAGAGAAAATTAAAAATTTATTTAACGAAGCACACACTACGGGTGTTTTAGTTATCCAACAAGGCCAAACTCAACAAAGCTATGGTAATGATCTTGCTCGTGCTTCGACCGAGTATGTACCTGCTTCGACCTTCAAAATGCTTAATGCTTTGATCGGCCTTGAGCACCATAAGGCAACCACCACAGAAGTATTTAAGTGGGATGGTAAAAAAAGGTTATTCCCAGAATGGGAAAAGGACATGACCCTAGGCGATGCCATGAAAGCTTCCGCTATTCCAGTTTATCAAGATTTAGCTCGTCGTATTGGACTTGAGCTCATGTCTAAGGAAGTGAAGCGTGTTGGTTATGGCAATGCAGATATCGGTACCCAAGTCGATAATTTTTGGCTGGTGGGTCCTTTAAAAATTACTCCTCAGCAAGAGGCACAGTTTGCTTACAAGCTAGCTAATAAAACGCTTCCATTTAGCCAAAAAGTCCAAGATGAAGTGCAATCCATGCTATTCATAGAAGAAAAGAATGGAAACAAAATATACGCAAAAAGTGGTTGGGGATGGGATGTAAACCCACAAGTAGGCTGGTTAACTGGATGGGTTGTTCAGCCTCAAGGGAATATTGTAGCGTTCTCCCTTAACTTAGAAATGAAAAAAGGAATACCTAG
gb|PYSX01000023.1|+|160178-161003|ARO:3001525|OXA-337 [Acinetobacter baumannii] 	0	770	54149	54919	825	246080-	770	ATGAACATTAAAGCACTCTTACTTATAACAAGCGCTATTTTTATTTCAGCCTGCTCACCTTATATAGTGACTGCTAATCCAAATCACAGCGCTTCAAAATCTGATGTAAAAGCAGAGAAAATTAAAAATTTATTTAACGAAGCACACACTACGGGTGTTTTAGTTATCCAACAAGGCCAAACTCAACAAAGCTATGGTAATGATCTTGCTCGTGCTTCGACCGAGTATGTACCTGCTTCGACCTTCAAAATGCTTAATGCTTTGATCGGCCTTGAGCACCATAAGGCAACCACCACAGAAGTATTTAAGTGGGATGGTAAAAAAAGGTTATTCCCAGAATGGGAAAAGGACATGACCCTAGGCGATGCCATGAAAGCTTCCGCTATTCCAGTTTATCAAGATTTAGCTCGTCGTATTGGACTTGAGCTCATGTCTAAGGAAGTGAAGCGTGTTGGTTATGGCAATGCAGATATCGGTACCCAAGTCGATAATTTTTGGCTGGTGGGTCCTTTAAAAATTACTCCTCAGCAAGAGGCACAGTTTGCTTACAAGCTAGCTAATAAAACGCTTCCATTTAGCCAAAAAGTCCAAGATGAAGTGCAATCCATGCTATTCATAGAAGAAAAGAATGGAAACAAAATATACGCAAAAAGTGGTTGGGGATGGGATGTAAACCCACAAGTAGGCTGGTTAACTGGATGGGTTGTTCAGCCTCAAGGGAATATTGTAGCGTTCTCCCTTAACTTAGAAATGAAAAAAGGAATACCTAG
gb|AM176555|+|0-861|ARO:3001134|SHV-80 [Klebsiella pneumoniae] 	0	806	16	822	861	1612535+	806	ATGCGTTATATTCGCCTGTGTATTATCACCCTGTGAGCCACCCTGCCGCTGGCGGTACACGCCAGCCCGCAGCCGCTTGAGCAAATTAAACAAAGCGAAAGCCAGCTGTCGGGCCGCGTAGGCATGATAGAAATGGATCTGGCCAGCGGCCGCACGCTGACCGCCTGGCGCGCCGATGAACGCTTTCCCATGATGAGCACCTTTAAAGTAGTGCTCTGCGGCGCAGTGCTGGCGCGGGTGGATGCCGGTGACGAACAGCTGGAGCGAAAGATCCACTATCGCCAGCAGGATCTGGTGGACTACTCGCCGGTCAGCGAAAAACACCTTGCCGACGGCATGACGGTCGGCGAACTCTGCGCCGCCGCCATTACCATGAGCGATAACAGCGCCGCCAATCTGCTGCTGGCCACCGTCGGCGGCCCCGCAGGATTGACTGCCTTTTTGCGCCAGATCGGCGACAACGTCACCCGCCTTGACCGCTGGGAAACGGAACTGAATGAGGCGCTTCCCGGCGACGCCCGCGACACCACTACCCCGGCCAGCATGGCCGCGACCCTGCGCAAGCTGCTGACCAGCCAGCGTCTGAGCGCCCGTTCGCAACGGCAGCTGCTGCAGTGGATGGTGGACGATCGGGTCGCCGGACCGTTGATCCGCTCCGTGCTGCCGGCGGGCTGGTTTATCGCCGATAAGACCGGAGCTAGCAAGCGGGGTGCGCGCGGGATTGTCGCCCTGCTTGGCCCGAATAACAAAGCAGAGCGCATTGTGGTGATTTATCTGCGGGATACGCCGGCGAGCATGGCCGAGCG
gb|JX121117|+|0-858|ARO:3001189|SHV-150 [Klebsiella pneumoniae] 	0	803	16	819	858	1612535+	803	ATGCGTTATATTCGCCTGTGTATTATCACCCTGTGAGCCACCCTGCCGCTGGCGGTACACGCCAGCCCGCAGCCGCTTGAGCAAATTAAACAAAGCGAAAGCCAGCTGTCGGGCCGCGTAGGCATGATAGAAATGGATCTGGCCAGCGGCCGCACGCTGACCGCCTGGCGCGCCGATGAACGCTTTCCCATGATGAGCACCTTTAAAGTAGTGCTCTGCGGCGCAGTGCTGGCGCGGGTGGATGCCGGTGACGAACAGCTGGAGCGAAAGATCCACTATCGCCAGCAGGATCTGGTGGACTACTCGCCGGTCAGCGAAAAACACCTTGCCGACGGCATGACGGTCGGCGAACTCTGCGCCGCCGCCATTACCATGAGCGATAACAGCGCCGCCAATCTGCTGCTGGCCACCGTCGGCGGCCCCGCAGGATTGACTGCCTTTTTGCGCCAGATCGGCGACAACGTCACCCGCCTTGACCGCTGGGAAACGGAACTGAATGAGGCGCTTCCCGGCGACGCCCGCGACACCACTACCCCGGCCAGCATGGCCGCGACCCTGCGCAAGCTGCTGACCAGCCAGCGTCTGAGCGCCCGTTCGCAACGGCAGCTGCTGCAGTGGATGGTGGACGATCGGGTCGCCGGACCGTTGATCCGCTCCGTGCTGCCGGCGGGCTGGTTTATCGCCGATAAGACCGGAGCTAGCAAGCGGGGTGCGCGCGGGATTGTCGCCCTGCTTGGCCCGAATAACAAAGCAGAGCGCATTGTGGTGATTTATCTGCGGGATACGCCGGCGAGCATGGCCGA
gb|KF048909|+|0-825|ARO:3001526|OXA-338 [Acinetobacter baumannii] 	0	770	54149	54919	825	246080-	770	ATGAACATTAAAGCACTCTTACTTATAACAAGCGCTATTTTTATTTCAGCCTGCTCACCTTATATAGTGACTGCTAATCCAAATCACAGCGCTTCAAAATCTGATGTAAAAGCAGAGAAAATTAAAAATTTATTTAACGAAGCACACACTACGGGTGTTTTAGTTATCCAACAAGGCCAAACTCAACAAAGCTATGGTAATGATCTTGCTCGTGCTTCGACCGAGTATGTACCTGCTTCGACCTTCAAAATGCTTAATGCTTTGATCGGCCTTGAGCACCATAAGGCAACCACCACAGAAGTATTTAAGTGGGATGGTAAAAAAAGGTTATTCCCAGAATGGGAAAAGGACATGACCCTAGGCGATGCCATGAAAGCTTCCGCTATTCCAGTTTATCAAGATTTAGCTCGTCGTATTGGACTTGAGCTCATGTCTAAGGAAGTGAAGCGTGTTGGTTATGGCAATGCAGATATCGGTACCCAAGTCGATAATTTTTGGCTGGTGGGTCCTTTAAAAATTACTCCTCAGCAAGAGGCACAGTTTGCTTACAAGCTAGCTAATAAAACGCTTCCATTTAGCCAAAAAGTCCAAGATGAAGTGCAATCCATGCTATTCATAGAAGAAAAGAATGGAAACAAAATATACGCAAAAAGTGGTTGGGGATGGGATGTAAACCCACAAGTAGGCTGGTTAACTGGATGGGTTGTTCAGCCTCAAGGGAATATTGTAGCGTTCTCCCTTAACTTAGAAATGAAAAAAGGAATACCTAG
gb|CU459141.1|+|2175316-2176141|ARO:3001617|OXA-69 [Acinetobacter baumannii AYE] 	0	770	54149	54919	825	246080-	770	ATGAACATTAAAGCACTCTTACTTATAACAAGCGCTATTTTTATTTCAGCCTGCTCACCTTATATAGTGACTGCTAATCCAAATCACAGCGCTTCAAAATCTGATGTAAAAGCAGAGAAAATTAAAAATTTATTTAACGAAGCACACACTACGGGTGTTTTAGTTATCCAACAAGGCCAAACTCAACAAAGCTATGGTAATGATCTTGCTCGTGCTTCGACCGAGTATGTACCTGCTTCGACCTTCAAAATGCTTAATGCTTTGATCGGCCTTGAGCACCATAAGGCAACCACCACAGAAGTATTTAAGTGGGATGGTAAAAAAAGGTTATTCCCAGAATGGGAAAAGGACATGACCCTAGGCGATGCCATGAAAGCTTCCGCTATTCCAGTTTATCAAGATTTAGCTCGTCGTATTGGACTTGAGCTCATGTCTAAGGAAGTGAAGCGTGTTGGTTATGGCAATGCAGATATCGGTACCCAAGTCGATAATTTTTGGCTGGTGGGTCCTTTAAAAATTACTCCTCAGCAAGAGGCACAGTTTGCTTACAAGCTAGCTAATAAAACGCTTCCATTTAGCCAAAAAGTCCAAGATGAAGTGCAATCCATGCTATTCATAGAAGAAAAGAATGGAAACAAAATATACGCAAAAAGTGGTTGGGGATGGGATGTAAACCCACAAGTAGGCTGGTTAACTGGATGGGTTGTTCAGCCTCAAGGGAATATTGTAGCGTTCTCCCTTAACTTAGAAATGAAAAAAGGAATACCTAG
gb|HM488988|+|0-822|ARO:3001467|OXA-167 [Acinetobacter baumannii] 	0	767	80	847	822	254088-	767	ATGAATAAATATTTTACTTGCTATGTGGTTGCTTCTCTTTTTCTTTCTGGTTGTACGGTTCAGCATAATTTAATAAATGAAACCCCGAGTCAGATTGTTCAAGGACATAATCAGGTGATTCATCAATACTTTGATGAAAAAAACACCTCAGGTGTGCTGGTTATTCAAACAGATAAAAAAATTAATCTATATGGTAATGCTCTAAGCCGCGCAAATACAGAATATGTGCCAGCCTCTACATTTAAAATGTTGAATGCCCTGATCGGATTGGAGAACCAGAAAACGGATATTAATGAAATATTTAAATGGAAGGGCGAGAAAAGGTCATTTACCGCTTGGGAAAAAGACATGACACTAGGAGAAGCCATGAAGCTTTCTGCAGTCCCAGTCTATCAGGAACTTGCGCGACGTATCGGTCTTGATCTCATGCAAAAAGAAGTAAAACGTATTGGTTTCGGTAATGCTGAAATTGGACAGCAGGTTGATAATTTCTGGTTGGTAGGACCATTAAAGGTTACGCCTATTCAAGAGGTAGAGTTTGTTTCCCAATTAGCACATACACAGCTTCCATTTAGTGAAAAAGTGCAGGCTAATGTAAAAAATATGCTTCTTTTAGAAGAGAGTAATGGCTACAAAATTTTTGGAAAGACTGGTTGGGCAATGGATATAAAACCACAAGTGGGCTGGTTGACCGGCTGGGTTGAGCAGCCAGATGGAAAAATTGTCGCTTTTGCATTAAATATGGAAATGCGGTCAGAAATGCCGGC
gb|AY037778|+|91-952|ARO:3001090|SHV-32 [Klebsiella pneumoniae] 	0	806	16	822	861	1612535+	806	ATGCGTTATATTCGCCTGTGTATTATCACCCTGTGAGCCACCCTGCCGCTGGCGGTACACGCCAGCCCGCAGCCGCTTGAGCAAATTAAACAAAGCGAAAGCCAGCTGTCGGGCCGCGTAGGCATGATAGAAATGGATCTGGCCAGCGGCCGCACGCTGACCGCCTGGCGCGCCGATGAACGCTTTCCCATGATGAGCACCTTTAAAGTAGTGCTCTGCGGCGCAGTGCTGGCGCGGGTGGATGCCGGTGACGAACAGCTGGAGCGAAAGATCCACTATCGCCAGCAGGATCTGGTGGACTACTCGCCGGTCAGCGAAAAACACCTTGCCGACGGCATGACGGTCGGCGAACTCTGCGCCGCCGCCATTACCATGAGCGATAACAGCGCCGCCAATCTGCTGCTGGCCACCGTCGGCGGCCCCGCAGGATTGACTGCCTTTTTGCGCCAGATCGGCGACAACGTCACCCGCCTTGACCGCTGGGAAACGGAACTGAATGAGGCGCTTCCCGGCGACGCCCGCGACACCACTACCCCGGCCAGCATGGCCGCGACCCTGCGCAAGCTGCTGACCAGCCAGCGTCTGAGCGCCCGTTCGCAACGGCAGCTGCTGCAGTGGATGGTGGACGATCGGGTCGCCGGACCGTTGATCCGCTCCGTGCTGCCGGCGGGCTGGTTTATCGCCGATAAGACCGGAGCTAGCAAGCGGGGTGCGCGCGGGATTGTCGCCCTGCTTGGCCCGAATAACAAAGCAGAGCGCATTGTGGTGATTTATCTGCGGGATACGCCGGCGAGCATGGCCGAGCG
gb|AM176556|+|25-886|ARO:3001135|SHV-81 [Klebsiella pneumoniae] 	0	806	16	822	861	1612535+	806	ATGCGTTATATTCGCCTGTGTATTATCACCCTGTGAGCCACCCTGCCGCTGGCGGTACACGCCAGCCCGCAGCCGCTTGAGCAAATTAAACAAAGCGAAAGCCAGCTGTCGGGCCGCGTAGGCATGATAGAAATGGATCTGGCCAGCGGCCGCACGCTGACCGCCTGGCGCGCCGATGAACGCTTTCCCATGATGAGCACCTTTAAAGTAGTGCTCTGCGGCGCAGTGCTGGCGCGGGTGGATGCCGGTGACGAACAGCTGGAGCGAAAGATCCACTATCGCCAGCAGGATCTGGTGGACTACTCGCCGGTCAGCGAAAAACACCTTGCCGACGGCATGACGGTCGGCGAACTCTGCGCCGCCGCCATTACCATGAGCGATAACAGCGCCGCCAATCTGCTGCTGGCCACCGTCGGCGGCCCCGCAGGATTGACTGCCTTTTTGCGCCAGATCGGCGACAACGTCACCCGCCTTGACCGCTGGGAAACGGAACTGAATGAGGCGCTTCCCGGCGACGCCCGCGACACCACTACCCCGGCCAGCATGGCCGCGACCCTGCGCAAGCTGCTGACCAGCCAGCGTCTGAGCGCCCGTTCGCAACGGCAGCTGCTGCAGTGGATGGTGGACGATCGGGTCGCCGGACCGTTGATCCGCTCCGTGCTGCCGGCGGGCTGGTTTATCGCCGATAAGACCGGAGCTAGCAAGCGGGGTGCGCGCGGGATTGTCGCCCTGCTTGGCCCGAATAACAAAGCAGAGCGCATTGTGGTGATTTATCTGCGGGATACGCCGGCGAGCATGGCCGAGCG
gb|NG_051744.1|+|100-1294|ARO:3004337|PDC-74 [Pseudomonas aeruginosa] 	0	1139	35513	36652	1194	232416+	1139	ATGCGCGATACCAGATTCCCCTGCCTGTGCGGCATCGCCGCTTCCACACTGCTGTTCGCCACCACCCCGGCCATTGCCGATGAGGCCCCGGCGGATCGCCTGAAGGCACTGGTCGACGCCGCCGTACAACCGGTGATGAAGGCCAATGACATTCCGGGCCTGGCCGTAGCCATCAGCCTGAAAGGAGAACCGCATTACTTCAGCTATGGGCTGGCCTCGAAAGAGGACGGCCGCCGGGTGACGCCGGAGACCCTGTTCGAGATCGGCTCGGTGAGCAAGACCTTCACCGTCACCCTCGCCGGCTATGCCCTGGCCCAGGACAAGATGCGCCTCGACGACCGCGCCAGCCAGCACTGGCCGGCACTGCAGGGCAGCCGCTTCGACGGCATCAGCCTGCTCGACCTCGCGACCTATACCGCCGGCGGCTTGCCGCTGCAGTTCCCCGACTCGGTGCAGAAGGACCAGGCACAGATCCGCGACTACTACCGCCAGTGGCAGCCGACCTACGCGCCGGGCAGCCAGCGCCTCTATTCCAACCCGAGCATCGGCCTGTTCGGCTATCTCGCCGCGCGCAGCCTGGGCCAGCCGTTCGAACGGCTCATGGAGCAGCAATTGTTCCCGGCACTGGGCCTCGAACAGACCCACCTCGACGTGCCCGAGGCGGCGCTGGCGCAGTACGCCCAGGGCTACGGCAAGGACGACCGCCCGCTACGGGTCGGTCCCGGCCCGCTGGATGCCGAAGGCTACGGGGTGAAGACCAGCGCGGCCGACCTGCTGCGCTTCGTCGATGCCAACCTGCATCCGGAGCGCCTGGACAGGCCCTGGGCGCAGGCGCTCGATGCCACCCATCGCGGTTACTACAAGGTCGGCGACATGACCCAGGGCCTGGGCTGGGAAGCCTACGACTGGCCGATCTCCCTGAAGCGCCTGCAGGCCGGCAACTCGACGCCGATGGCGCTGCAACCACACAGGATCGCCAGGCTGCCCGCGCCACAGGCGCTGGAGGGCCAGCGCCTGCTGAACAAGACCGGCTCCACCAACGGCTTCGGCGCCTACGTGGCGTTCGTCCCGGGCCGCGACCTGGGCCTGGTGATCCTGGCCAACCGCAACTATCCCAATGCCGAGCGGGTGAAGATCGC
gb|EF016355.1|+|0-1152|ARO:3003868|ADC-25 [Acinetobacter baumannii] 	0	1097	63	1160	1152	126080+	1097	ATGCGATTTAAAAAAATTTCTTGTCTACTTTTATCCCCGCTTTTTATTTTTAGTACCTCAATTTATGCGGGCAATACACCAAAAGACCAAGAAATTAAAAAACTGGTAGATCAAAACTTTAAACCGTTATTAGAAAAATATGATGTGCCAGGTATGGCTGTGGGTGTTATTCAAAATAATAAAAAGTATGAAATGTATTATGGTCTTCAATCTGTTCAAGATAAAAAAGCCGTAAATAGCAGTACTATTTTTGAGCTAGGTTCTGTCAGTAAATTATTTACCGCGACAGCAGGTGGATATGCAAAAAATAAAGGAAAAATCTCTTTTGACGATACGCCTGGTAAGTATTGGAAAGAACTAAAAAATACACCGATTGACCAAGTTAACTTACTTCAACTCGCGACGTATACAAGTGGTAACCTTGCCTTGCAATTTCCAGATGAAGTAAAAACAGATCAGCAAGTTTTAACATTTTTTAAAGACTGGAAACCTAAAAACTCAATCGGTGAATATCGACAATATTCAAACCCAAGCATTGGTTTATTTGGAAAAGTTGTAGCTTTGTCTATGAATAAACCTTTCGACCAAGTCTTAGAAAAAACAATTTTTCCGGCCCTTGGCTTAAAACATAGCTATGTAAATGTACCTAAGACCCAGATGCAAAACTATGCTTTTGGCTATAACCAAGAAAATCAGCCGATTCGAGTTAACCCCGGCCCACTCGATGCCCCAGCATATGGCGTCAAATCGACACTACCCGACATGTTGAGTTTTATTCATGCCAACCTAAATCCACAAAAATATCCAGCAGATATTCAACGGGCAATTAATGAAACACATCAGGGTCGCTATCAAGTAAATACCATGTATCAGGCACTCGGTTGGGAAGAGTTTTCTTATCCGGCAACGTTACAAACTTTATTAGACAGTAATTCAGAACAGATTGTGATGAAACCTAATAAAGTGACTGCTATTTCAAAGGAACCTTCAGTTAAGATGTACCATAAAACTGGCTCAACTACCGGTTTCGGAACATATGTGGTGTTTATTCCTAAAGAAAATATTGGTTTAGTCATGTTAACCAATAAACGTATTCC
gb|HM488989|+|0-822|ARO:3001468|OXA-168 [Acinetobacter baumannii] 	0	767	80	847	822	254088-	767	ATGAATAAATATTTTACTTGCTATGTGGTTGCTTCTCTTTTTCTTTCTGGTTGTACGGTTCAGCATAATTTAATAAATGAAACCCCGAGTCAGATTGTTCAAGGACATAATCAGGTGATTCATCAATACTTTGATGAAAAAAACACCTCAGGTGTGCTGGTTATTCAAACAGATAAAAAAATTAATCTATATGGTAATGCTCTAAGCCGCGCAAATACAGAATATGTGCCAGCCTCTACATTTAAAATGTTGAATGCCCTGATCGGATTGGAGAACCAGAAAACGGATATTAATGAAATATTTAAATGGAAGGGCGAGAAAAGGTCATTTACCGCTTGGGAAAAAGACATGACACTAGGAGAAGCCATGAAGCTTTCTGCAGTCCCAGTCTATCAGGAACTTGCGCGACGTATCGGTCTTGATCTCATGCAAAAAGAAGTAAAACGTATTGGTTTCGGTAATGCTGAAATTGGACAGCAGGTTGATAATTTCTGGTTGGTAGGACCATTAAAGGTTACGCCTATTCAAGAGGTAGAGTTTGTTTCCCAATTAGCACATACACAGCTTCCATTTAGTGAAAAAGTGCAGGCTAATGTAAAAAATATGCTTCTTTTAGAAGAGAGTAATGGCTACAAAATTTTTGGAAAGACTGGTTGGGCAATGGATATAAAACCACAAGTGGGCTGGTTGACCGGCTGGGTTGAGCAGCCAGATGGAAAAATTGTCGCTTTTGCATTAAATATGGAAATGCGGTCAGAAATGCCGGC
gb|AM176557|+|0-861|ARO:3001136|SHV-82 [Klebsiella pneumoniae] 	0	806	16	822	861	1612535+	806	ATGCGTTATATTCGCCTGTGTATTATCACCCTGTGAGCCACCCTGCCGCTGGCGGTACACGCCAGCCCGCAGCCGCTTGAGCAAATTAAACAAAGCGAAAGCCAGCTGTCGGGCCGCGTAGGCATGATAGAAATGGATCTGGCCAGCGGCCGCACGCTGACCGCCTGGCGCGCCGATGAACGCTTTCCCATGATGAGCACCTTTAAAGTAGTGCTCTGCGGCGCAGTGCTGGCGCGGGTGGATGCCGGTGACGAACAGCTGGAGCGAAAGATCCACTATCGCCAGCAGGATCTGGTGGACTACTCGCCGGTCAGCGAAAAACACCTTGCCGACGGCATGACGGTCGGCGAACTCTGCGCCGCCGCCATTACCATGAGCGATAACAGCGCCGCCAATCTGCTGCTGGCCACCGTCGGCGGCCCCGCAGGATTGACTGCCTTTTTGCGCCAGATCGGCGACAACGTCACCCGCCTTGACCGCTGGGAAACGGAACTGAATGAGGCGCTTCCCGGCGACGCCCGCGACACCACTACCCCGGCCAGCATGGCCGCGACCCTGCGCAAGCTGCTGACCAGCCAGCGTCTGAGCGCCCGTTCGCAACGGCAGCTGCTGCAGTGGATGGTGGACGATCGGGTCGCCGGACCGTTGATCCGCTCCGTGCTGCCGGCGGGCTGGTTTATCGCCGATAAGACCGGAGCTAGCAAGCGGGGTGCGCGCGGGATTGTCGCCCTGCTTGGCCCGAATAACAAAGCAGAGCGCATTGTGGTGATTTATCTGCGGGATACGCCGGCGAGCATGGCCGAGCG
gb|JX121118|+|0-858|ARO:3001190|SHV-151 [Klebsiella pneumoniae] 	0	803	16	819	858	1612535+	803	ATGCGTTATATTCGCCTGTGTATTATCACCCTGTGAGCCACCCTGCCGCTGGCGGTACACGCCAGCCCGCAGCCGCTTGAGCAAATTAAACAAAGCGAAAGCCAGCTGTCGGGCCGCGTAGGCATGATAGAAATGGATCTGGCCAGCGGCCGCACGCTGACCGCCTGGCGCGCCGATGAACGCTTTCCCATGATGAGCACCTTTAAAGTAGTGCTCTGCGGCGCAGTGCTGGCGCGGGTGGATGCCGGTGACGAACAGCTGGAGCGAAAGATCCACTATCGCCAGCAGGATCTGGTGGACTACTCGCCGGTCAGCGAAAAACACCTTGCCGACGGCATGACGGTCGGCGAACTCTGCGCCGCCGCCATTACCATGAGCGATAACAGCGCCGCCAATCTGCTGCTGGCCACCGTCGGCGGCCCCGCAGGATTGACTGCCTTTTTGCGCCAGATCGGCGACAACGTCACCCGCCTTGACCGCTGGGAAACGGAACTGAATGAGGCGCTTCCCGGCGACGCCCGCGACACCACTACCCCGGCCAGCATGGCCGCGACCCTGCGCAAGCTGCTGACCAGCCAGCGTCTGAGCGCCCGTTCGCAACGGCAGCTGCTGCAGTGGATGGTGGACGATCGGGTCGCCGGACCGTTGATCCGCTCCGTGCTGCCGGCGGGCTGGTTTATCGCCGATAAGACCGGAGCTAGCAAGCGGGGTGCGCGCGGGATTGTCGCCCTGCTTGGCCCGAATAACAAAGCAGAGCGCATTGTGGTGATTTATCTGCGGGATACGCCGGCGAGCATGGCCGA
gb|X75562|+|134-935|ARO:3001402|OXA-7 [Escherichia coli] 	0	746	659	1405	801	104604+	746	ATGAAAACATTTGCCGCATATGTAATTATCGCGTGTCTTTCGAGTACGGCATTAGCTGGTTCAATTACAGAAAATACGTCTTGGAACAAAGAGTTCTCTGCCGAAGCCGTCAATGGTGTCTTCGTGCTTTGTAAAAGTAGCAGTAAATCCTGCGCTACCAATGACTTAGCTCGTGCATCAAAGGAATATCTTCCAGCATCAACATTTAAGATCCCCAACGCAATTATCGGCCTAGAAACTGGTGTCATAAAGAATGAGCATCAGGTTTTCAAATGGGACGGAAAGCCAAGAGCCATGAAGCAATGGGAAAGAGACTTGACCTTAAGAGGGGCAATACAAGTTTCAGCTGTTCCCGTATTTCAACAAATCGCCAGAGAAGTTGGCGAAGTAAGAATGCAGAAATACCTTAAAAAATTTTCCTATGGCAACCAGAATATCAGTGGTGGCATTGACAAATTCTGGTTGGAAGGCCAGCTTAGAATTTCCGCAGTTAATCAAGTGGAGTTTCTAGAGTCTCTATATTTAAATAAATTGTCAGCATCTAAAGAAAACCAGCTAATAGTAAAAGAGGCTTTGGTAACGGAGGCGGCACCTGAATATCTAGTGCATTCAAAAACTGGTTTTTCTGGTGTGGGAACTGAGTCAAATCCTGGTGTCGCATGGTGGGTTGGGTGGGTTGAGAAGGAGACAGAGGTTTACTTTTTCGCCTTTAACATGGATATAGACAACGAAAGTAAGTTGCCGCT
gb|KF048911.1|+|0-825|ARO:3001527|OXA-339 [Acinetobacter baumannii] 	0	770	54149	54919	825	246080-	770	ATGAACATTAAAGCACTCTTACTTATAACAAGCGCTATTTTTATTTCAGCCTGCTCACCTTATATAGTGACTGCTAATCCAAATCACAGCGCTTCAAAATCTGATGTAAAAGCAGAGAAAATTAAAAATTTATTTAACGAAGCACACACTACGGGTGTTTTAGTTATCCAACAAGGCCAAACTCAACAAAGCTATGGTAATGATCTTGCTCGTGCTTCGACCGAGTATGTACCTGCTTCGACCTTCAAAATGCTTAATGCTTTGATCGGCCTTGAGCACCATAAGGCAACCACCACAGAAGTATTTAAGTGGGATGGTAAAAAAAGGTTATTCCCAGAATGGGAAAAGGACATGACCCTAGGCGATGCCATGAAAGCTTCCGCTATTCCAGTTTATCAAGATTTAGCTCGTCGTATTGGACTTGAGCTCATGTCTAAGGAAGTGAAGCGTGTTGGTTATGGCAATGCAGATATCGGTACCCAAGTCGATAATTTTTGGCTGGTGGGTCCTTTAAAAATTACTCCTCAGCAAGAGGCACAGTTTGCTTACAAGCTAGCTAATAAAACGCTTCCATTTAGCCAAAAAGTCCAAGATGAAGTGCAATCCATGCTATTCATAGAAGAAAAGAATGGAAACAAAATATACGCAAAAAGTGGTTGGGGATGGGATGTAAACCCACAAGTAGGCTGGTTAACTGGATGGGTTGTTCAGCCTCAAGGGAATATTGTAGCGTTCTCCCTTAACTTAGAAATGAAAAAAGGAATACCTAG
gb|JX268631|+|0-861|ARO:3001091|SHV-33 [Klebsiella pneumoniae] 	0	806	16	822	861	1612535+	806	ATGCGTTATATTCGCCTGTGTATTATCACCCTGTGAGCCACCCTGCCGCTGGCGGTACACGCCAGCCCGCAGCCGCTTGAGCAAATTAAACAAAGCGAAAGCCAGCTGTCGGGCCGCGTAGGCATGATAGAAATGGATCTGGCCAGCGGCCGCACGCTGACCGCCTGGCGCGCCGATGAACGCTTTCCCATGATGAGCACCTTTAAAGTAGTGCTCTGCGGCGCAGTGCTGGCGCGGGTGGATGCCGGTGACGAACAGCTGGAGCGAAAGATCCACTATCGCCAGCAGGATCTGGTGGACTACTCGCCGGTCAGCGAAAAACACCTTGCCGACGGCATGACGGTCGGCGAACTCTGCGCCGCCGCCATTACCATGAGCGATAACAGCGCCGCCAATCTGCTGCTGGCCACCGTCGGCGGCCCCGCAGGATTGACTGCCTTTTTGCGCCAGATCGGCGACAACGTCACCCGCCTTGACCGCTGGGAAACGGAACTGAATGAGGCGCTTCCCGGCGACGCCCGCGACACCACTACCCCGGCCAGCATGGCCGCGACCCTGCGCAAGCTGCTGACCAGCCAGCGTCTGAGCGCCCGTTCGCAACGGCAGCTGCTGCAGTGGATGGTGGACGATCGGGTCGCCGGACCGTTGATCCGCTCCGTGCTGCCGGCGGGCTGGTTTATCGCCGATAAGACCGGAGCTAGCAAGCGGGGTGCGCGCGGGATTGTCGCCCTGCTTGGCCCGAATAACAAAGCAGAGCGCATTGTGGTGATTTATCTGCGGGATACGCCGGCGAGCATGGCCGAGCG
gb|AM176558|+|0-861|ARO:3001137|SHV-83 [Klebsiella pneumoniae] 	2	806	18	822	861	1612535+	804	GCGTTATATTCGCCTGTGTATTATCACCCTGTGAGCCACCCTGCCGCTGGCGGTACACGCCAGCCCGCAGCCGCTTGAGCAAATTAAACAAAGCGAAAGCCAGCTGTCGGGCCGCGTAGGCATGATAGAAATGGATCTGGCCAGCGGCCGCACGCTGACCGCCTGGCGCGCCGATGAACGCTTTCCCATGATGAGCACCTTTAAAGTAGTGCTCTGCGGCGCAGTGCTGGCGCGGGTGGATGCCGGTGACGAACAGCTGGAGCGAAAGATCCACTATCGCCAGCAGGATCTGGTGGACTACTCGCCGGTCAGCGAAAAACACCTTGCCGACGGCATGACGGTCGGCGAACTCTGCGCCGCCGCCATTACCATGAGCGATAACAGCGCCGCCAATCTGCTGCTGGCCACCGTCGGCGGCCCCGCAGGATTGACTGCCTTTTTGCGCCAGATCGGCGACAACGTCACCCGCCTTGACCGCTGGGAAACGGAACTGAATGAGGCGCTTCCCGGCGACGCCCGCGACACCACTACCCCGGCCAGCATGGCCGCGACCCTGCGCAAGCTGCTGACCAGCCAGCGTCTGAGCGCCCGTTCGCAACGGCAGCTGCTGCAGTGGATGGTGGACGATCGGGTCGCCGGACCGTTGATCCGCTCCGTGCTGCCGGCGGGCTGGTTTATCGCCGATAAGACCGGAGCTAGCAAGCGGGGTGCGCGCGGGATTGTCGCCCTGCTTGGCCCGAATAACAAAGCAGAGCGCATTGTGGTGATTTATCTGCGGGATACGCCGGCGAGCATGGCCGAGCG
gb|AY750912|+|0-825|ARO:3001618|OXA-70 [Acinetobacter baumannii] 	0	770	54149	54919	825	246080-	770	ATGAACATTAAAGCACTCTTACTTATAACAAGCGCTATTTTTATTTCAGCCTGCTCACCTTATATAGTGACTGCTAATCCAAATCACAGCGCTTCAAAATCTGATGTAAAAGCAGAGAAAATTAAAAATTTATTTAACGAAGCACACACTACGGGTGTTTTAGTTATCCAACAAGGCCAAACTCAACAAAGCTATGGTAATGATCTTGCTCGTGCTTCGACCGAGTATGTACCTGCTTCGACCTTCAAAATGCTTAATGCTTTGATCGGCCTTGAGCACCATAAGGCAACCACCACAGAAGTATTTAAGTGGGATGGTAAAAAAAGGTTATTCCCAGAATGGGAAAAGGACATGACCCTAGGCGATGCCATGAAAGCTTCCGCTATTCCAGTTTATCAAGATTTAGCTCGTCGTATTGGACTTGAGCTCATGTCTAAGGAAGTGAAGCGTGTTGGTTATGGCAATGCAGATATCGGTACCCAAGTCGATAATTTTTGGCTGGTGGGTCCTTTAAAAATTACTCCTCAGCAAGAGGCACAGTTTGCTTACAAGCTAGCTAATAAAACGCTTCCATTTAGCCAAAAAGTCCAAGATGAAGTGCAATCCATGCTATTCATAGAAGAAAAGAATGGAAACAAAATATACGCAAAAAGTGGTTGGGGATGGGATGTAAACCCACAAGTAGGCTGGTTAACTGGATGGGTTGTTCAGCCTCAAGGGAATATTGTAGCGTTCTCCCTTAACTTAGAAATGAAAAAAGGAATACCTAG
gb|KR057744.1|+|0-1116|ARO:3004338|PDC-75 [Pseudomonas aeruginosa] 	3	1061	35594	36652	1116	232416+	1058	GAGGCCCCGGCGGATCGCCTGAAGGCACTGGTCGACGCCGCCGTACAACCGGTGATGAAGGCCAATGACATTCCGGGCCTGGCCGTAGCCATCAGCCTGAAAGGAGAACCGCATTACTTCAGCTATGGGCTGGCCTCGAAAGAGGACGGCCGCCGGGTGACGCCGGAGACCCTGTTCGAGATCGGCTCGGTGAGCAAGACCTTCACCGTCACCCTCGCCGGCTATGCCCTGGCCCAGGACAAGATGCGCCTCGACGACCGCGCCAGCCAGCACTGGCCGGCACTGCAGGGCAGCCGCTTCGACGGCATCAGCCTGCTCGACCTCGCGACCTATACCGCCGGCGGCTTGCCGCTGCAGTTCCCCGACTCGGTGCAGAAGGACCAGGCACAGATCCGCGACTACTACCGCCAGTGGCAGCCGACCTACGCGCCGGGCAGCCAGCGCCTCTATTCCAACCCGAGCATCGGCCTGTTCGGCTATCTCGCCGCGCGCAGCCTGGGCCAGCCGTTCGAACGGCTCATGGAGCAGCAATTGTTCCCGGCACTGGGCCTCGAACAGACCCACCTCGACGTGCCCGAGGCGGCGCTGGCGCAGTACGCCCAGGGCTACGGCAAGGACGACCGCCCGCTACGGGTCGGTCCCGGCCCGCTGGATGCCGAAGGCTACGGGGTGAAGACCAGCGCGGCCGACCTGCTGCGCTTCGTCGATGCCAACCTGCATCCGGAGCGCCTGGACAGGCCCTGGGCGCAGGCGCTCGATGCCACCCATCGCGGTTACTACAAGGTCGGCGACATGACCCAGGGCCTGGGCTGGGAAGCCTACGACTGGCCGATCTCCCTGAAGCGCCTGCAGGCCGGCAACTCGACGCCGATGGCGCTGCAACCACACAGGATCGCCAGGCTGCCCGCGCCACAGGCGCTGGAGGGCCAGCGCCTGCTGAACAAGACCGGCTCCACCAACGGCTTCGGCGCCTACGTGGCGTTCGTCCCGGGCCGCGACCTGGGCCTGGTGATCCTGGCCAACCGCAACTATCCCAATGCCGAGCGGGTGAAGATCGC
gb|JX121119|+|0-858|ARO:3001191|SHV-152 [Klebsiella pneumoniae] 	0	803	16	819	858	1612535+	803	ATGCGTTATATTCGCCTGTGTATTATCACCCTGTGAGCCACCCTGCCGCTGGCGGTACACGCCAGCCCGCAGCCGCTTGAGCAAATTAAACAAAGCGAAAGCCAGCTGTCGGGCCGCGTAGGCATGATAGAAATGGATCTGGCCAGCGGCCGCACGCTGACCGCCTGGCGCGCCGATGAACGCTTTCCCATGATGAGCACCTTTAAAGTAGTGCTCTGCGGCGCAGTGCTGGCGCGGGTGGATGCCGGTGACGAACAGCTGGAGCGAAAGATCCACTATCGCCAGCAGGATCTGGTGGACTACTCGCCGGTCAGCGAAAAACACCTTGCCGACGGCATGACGGTCGGCGAACTCTGCGCCGCCGCCATTACCATGAGCGATAACAGCGCCGCCAATCTGCTGCTGGCCACCGTCGGCGGCCCCGCAGGATTGACTGCCTTTTTGCGCCAGATCGGCGACAACGTCACCCGCCTTGACCGCTGGGAAACGGAACTGAATGAGGCGCTTCCCGGCGACGCCCGCGACACCACTACCCCGGCCAGCATGGCCGCGACCCTGCGCAAGCTGCTGACCAGCCAGCGTCTGAGCGCCCGTTCGCAACGGCAGCTGCTGCAGTGGATGGTGGACGATCGGGTCGCCGGACCGTTGATCCGCTCCGTGCTGCCGGCGGGCTGGTTTATCGCCGATAAGACCGGAGCTAGCAAGCGGGGTGCGCGCGGGATTGTCGCCCTGCTTGGCCCGAATAACAAAGCAGAGCGCATTGTGGTGATTTATCTGCGGGATACGCCGGCGAGCATGGCCGA
gb|AY178995.1|+|0-1152|ARO:3003849|ADC-3 [Acinetobacter baumannii] 	0	1097	63	1160	1152	126080+	1097	ATGCGATTTAAAAAAATTTCTTGTCTACTTTTATCCCCGCTTTTTATTTTTAGTACCTCAATTTATGCGGGCAATACACCAAAAGACCAAGAAATTAAAAAACTGGTAGATCAAAACTTTAAACCGTTATTAGAAAAATATGATGTGCCAGGTATGGCTGTGGGTGTTATTCAAAATAATAAAAAGTATGAAATGTATTATGGTCTTCAATCTGTTCAAGATAAAAAAGCCGTAAATAGCAGTACTATTTTTGAGCTAGGTTCTGTCAGTAAATTATTTACCGCGACAGCAGGTGGATATGCAAAAAATAAAGGAAAAATCTCTTTTGACGATACGCCTGGTAAGTATTGGAAAGAACTAAAAAATACACCGATTGACCAAGTTAACTTACTTCAACTCGCGACGTATACAAGTGGTAACCTTGCCTTGCAATTTCCAGATGAAGTAAAAACAGATCAGCAAGTTTTAACATTTTTTAAAGACTGGAAACCTAAAAACTCAATCGGTGAATATCGACAATATTCAAACCCAAGCATTGGTTTATTTGGAAAAGTTGTAGCTTTGTCTATGAATAAACCTTTCGACCAAGTCTTAGAAAAAACAATTTTTCCGGCCCTTGGCTTAAAACATAGCTATGTAAATGTACCTAAGACCCAGATGCAAAACTATGCTTTTGGCTATAACCAAGAAAATCAGCCGATTCGAGTTAACCCCGGCCCACTCGATGCCCCAGCATATGGCGTCAAATCGACACTACCCGACATGTTGAGTTTTATTCATGCCAACCTAAATCCACAAAAATATCCAGCAGATATTCAACGGGCAATTAATGAAACACATCAGGGTCGCTATCAAGTAAATACCATGTATCAGGCACTCGGTTGGGAAGAGTTTTCTTATCCGGCAACGTTACAAACTTTATTAGACAGTAATTCAGAACAGATTGTGATGAAACCTAATAAAGTGACTGCTATTTCAAAGGAACCTTCAGTTAAGATGTACCATAAAACTGGCTCAACTACCGGTTTCGGAACATATGTGGTGTTTATTCCTAAAGAAAATATTGGTTTAGTCATGTTAACCAATAAACGTATTCC
gb|HM488990|+|0-822|ARO:3001469|OXA-169 [Acinetobacter baumannii] 	0	767	80	847	822	254088-	767	ATGAATAAATATTTTACTTGCTATGTGGTTGCTTCTCTTTTTCTTTCTGGTTGTACGGTTCAGCATAATTTAATAAATGAAACCCCGAGTCAGATTGTTCAAGGACATAATCAGGTGATTCATCAATACTTTGATGAAAAAAACACCTCAGGTGTGCTGGTTATTCAAACAGATAAAAAAATTAATCTATATGGTAATGCTCTAAGCCGCGCAAATACAGAATATGTGCCAGCCTCTACATTTAAAATGTTGAATGCCCTGATCGGATTGGAGAACCAGAAAACGGATATTAATGAAATATTTAAATGGAAGGGCGAGAAAAGGTCATTTACCGCTTGGGAAAAAGACATGACACTAGGAGAAGCCATGAAGCTTTCTGCAGTCCCAGTCTATCAGGAACTTGCGCGACGTATCGGTCTTGATCTCATGCAAAAAGAAGTAAAACGTATTGGTTTCGGTAATGCTGAAATTGGACAGCAGGTTGATAATTTCTGGTTGGTAGGACCATTAAAGGTTACGCCTATTCAAGAGGTAGAGTTTGTTTCCCAATTAGCACATACACAGCTTCCATTTAGTGAAAAAGTGCAGGCTAATGTAAAAAATATGCTTCTTTTAGAAGAGAGTAATGGCTACAAAATTTTTGGAAAGACTGGTTGGGCAATGGATATAAAACCACAAGTGGGCTGGTTGACCGGCTGGGTTGAGCAGCCAGATGGAAAAATTGTCGCTTTTGCATTAAATATGGAAATGCGGTCAGAAATGCCGGC
gb|AY036620|+|88-949|ARO:3001092|SHV-34 [Escherichia coli] 	0	806	16	822	861	1612535+	806	ATGCGTTATATTCGCCTGTGTATTATCACCCTGTGAGCCACCCTGCCGCTGGCGGTACACGCCAGCCCGCAGCCGCTTGAGCAAATTAAACAAAGCGAAAGCCAGCTGTCGGGCCGCGTAGGCATGATAGAAATGGATCTGGCCAGCGGCCGCACGCTGACCGCCTGGCGCGCCGATGAACGCTTTCCCATGATGAGCACCTTTAAAGTAGTGCTCTGCGGCGCAGTGCTGGCGCGGGTGGATGCCGGTGACGAACAGCTGGAGCGAAAGATCCACTATCGCCAGCAGGATCTGGTGGACTACTCGCCGGTCAGCGAAAAACACCTTGCCGACGGCATGACGGTCGGCGAACTCTGCGCCGCCGCCATTACCATGAGCGATAACAGCGCCGCCAATCTGCTGCTGGCCACCGTCGGCGGCCCCGCAGGATTGACTGCCTTTTTGCGCCAGATCGGCGACAACGTCACCCGCCTTGACCGCTGGGAAACGGAACTGAATGAGGCGCTTCCCGGCGACGCCCGCGACACCACTACCCCGGCCAGCATGGCCGCGACCCTGCGCAAGCTGCTGACCAGCCAGCGTCTGAGCGCCCGTTCGCAACGGCAGCTGCTGCAGTGGATGGTGGACGATCGGGTCGCCGGACCGTTGATCCGCTCCGTGCTGCCGGCGGGCTGGTTTATCGCCGATAAGACCGGAGCTAGCAAGCGGGGTGCGCGCGGGATTGTCGCCCTGCTTGGCCCGAATAACAAAGCAGAGCGCATTGTGGTGATTTATCTGCGGGATACGCCGGCGAGCATGGCCGAGCG
gb|DQ902344.1|+|2716-3517|ARO:3001412|OXA-17 [Klebsiella pneumoniae] Partial	0	746	659	1405	801	104604+	746	ATGAAAACATTTGCCGCATATGTAATTATCGCGTGTCTTTCGAGTACGGCATTAGCTGGTTCAATTACAGAAAATACGTCTTGGAACAAAGAGTTCTCTGCCGAAGCCGTCAATGGTGTCTTCGTGCTTTGTAAAAGTAGCAGTAAATCCTGCGCTACCAATGACTTAGCTCGTGCATCAAAGGAATATCTTCCAGCATCAACATTTAAGATCCCCAACGCAATTATCGGCCTAGAAACTGGTGTCATAAAGAATGAGCATCAGGTTTTCAAATGGGACGGAAAGCCAAGAGCCATGAAGCAATGGGAAAGAGACTTGACCTTAAGAGGGGCAATACAAGTTTCAGCTGTTCCCGTATTTCAACAAATCGCCAGAGAAGTTGGCGAAGTAAGAATGCAGAAATACCTTAAAAAATTTTCCTATGGCAACCAGAATATCAGTGGTGGCATTGACAAATTCTGGTTGGAAGGCCAGCTTAGAATTTCCGCAGTTAATCAAGTGGAGTTTCTAGAGTCTCTATATTTAAATAAATTGTCAGCATCTAAAGAAAACCAGCTAATAGTAAAAGAGGCTTTGGTAACGGAGGCGGCACCTGAATATCTAGTGCATTCAAAAACTGGTTTTTCTGGTGTGGGAACTGAGTCAAATCCTGGTGTCGCATGGTGGGTTGGGTGGGTTGAGAAGGAGACAGAGGTTTACTTTTTCGCCTTTAACATGGATATAGACAACGAAAGTAAGTTGCCGCT
gb|NGCN01000023.1|-|65770-66595|ARO:3001528|OXA-340 [Acinetobacter baumannii] 	0	770	54149	54919	825	246080-	770	ATGAACATTAAAGCACTCTTACTTATAACAAGCGCTATTTTTATTTCAGCCTGCTCACCTTATATAGTGACTGCTAATCCAAATCACAGCGCTTCAAAATCTGATGTAAAAGCAGAGAAAATTAAAAATTTATTTAACGAAGCACACACTACGGGTGTTTTAGTTATCCAACAAGGCCAAACTCAACAAAGCTATGGTAATGATCTTGCTCGTGCTTCGACCGAGTATGTACCTGCTTCGACCTTCAAAATGCTTAATGCTTTGATCGGCCTTGAGCACCATAAGGCAACCACCACAGAAGTATTTAAGTGGGATGGTAAAAAAAGGTTATTCCCAGAATGGGAAAAGGACATGACCCTAGGCGATGCCATGAAAGCTTCCGCTATTCCAGTTTATCAAGATTTAGCTCGTCGTATTGGACTTGAGCTCATGTCTAAGGAAGTGAAGCGTGTTGGTTATGGCAATGCAGATATCGGTACCCAAGTCGATAATTTTTGGCTGGTGGGTCCTTTAAAAATTACTCCTCAGCAAGAGGCACAGTTTGCTTACAAGCTAGCTAATAAAACGCTTCCATTTAGCCAAAAAGTCCAAGATGAAGTGCAATCCATGCTATTCATAGAAGAAAAGAATGGAAACAAAATATACGCAAAAAGTGGTTGGGGATGGGATGTAAACCCACAAGTAGGCTGGTTAACTGGATGGGTTGTTCAGCCTCAAGGGAATATTGTAGCGTTCTCCCTTAACTTAGAAATGAAAAAAGGAATACCTAG
gb|JX121120|+|0-858|ARO:3001192|SHV-153 [Klebsiella pneumoniae] 	0	803	16	819	858	1612535+	803	ATGCGTTATATTCGCCTGTGTATTATCACCCTGTGAGCCACCCTGCCGCTGGCGGTACACGCCAGCCCGCAGCCGCTTGAGCAAATTAAACAAAGCGAAAGCCAGCTGTCGGGCCGCGTAGGCATGATAGAAATGGATCTGGCCAGCGGCCGCACGCTGACCGCCTGGCGCGCCGATGAACGCTTTCCCATGATGAGCACCTTTAAAGTAGTGCTCTGCGGCGCAGTGCTGGCGCGGGTGGATGCCGGTGACGAACAGCTGGAGCGAAAGATCCACTATCGCCAGCAGGATCTGGTGGACTACTCGCCGGTCAGCGAAAAACACCTTGCCGACGGCATGACGGTCGGCGAACTCTGCGCCGCCGCCATTACCATGAGCGATAACAGCGCCGCCAATCTGCTGCTGGCCACCGTCGGCGGCCCCGCAGGATTGACTGCCTTTTTGCGCCAGATCGGCGACAACGTCACCCGCCTTGACCGCTGGGAAACGGAACTGAATGAGGCGCTTCCCGGCGACGCCCGCGACACCACTACCCCGGCCAGCATGGCCGCGACCCTGCGCAAGCTGCTGACCAGCCAGCGTCTGAGCGCCCGTTCGCAACGGCAGCTGCTGCAGTGGATGGTGGACGATCGGGTCGCCGGACCGTTGATCCGCTCCGTGCTGCCGGCGGGCTGGTTTATCGCCGATAAGACCGGAGCTAGCAAGCGGGGTGCGCGCGGGATTGTCGCCCTGCTTGGCCCGAATAACAAAGCAGAGCGCATTGTGGTGATTTATCTGCGGGATACGCCGGCGAGCATGGCCGA
gb|AY070258|+|0-861|ARO:3001093|SHV-35 [Klebsiella pneumoniae] 	0	806	16	822	861	1612535+	806	ATGCGTTATATTCGCCTGTGTATTATCACCCTGTGAGCCACCCTGCCGCTGGCGGTACACGCCAGCCCGCAGCCGCTTGAGCAAATTAAACAAAGCGAAAGCCAGCTGTCGGGCCGCGTAGGCATGATAGAAATGGATCTGGCCAGCGGCCGCACGCTGACCGCCTGGCGCGCCGATGAACGCTTTCCCATGATGAGCACCTTTAAAGTAGTGCTCTGCGGCGCAGTGCTGGCGCGGGTGGATGCCGGTGACGAACAGCTGGAGCGAAAGATCCACTATCGCCAGCAGGATCTGGTGGACTACTCGCCGGTCAGCGAAAAACACCTTGCCGACGGCATGACGGTCGGCGAACTCTGCGCCGCCGCCATTACCATGAGCGATAACAGCGCCGCCAATCTGCTGCTGGCCACCGTCGGCGGCCCCGCAGGATTGACTGCCTTTTTGCGCCAGATCGGCGACAACGTCACCCGCCTTGACCGCTGGGAAACGGAACTGAATGAGGCGCTTCCCGGCGACGCCCGCGACACCACTACCCCGGCCAGCATGGCCGCGACCCTGCGCAAGCTGCTGACCAGCCAGCGTCTGAGCGCCCGTTCGCAACGGCAGCTGCTGCAGTGGATGGTGGACGATCGGGTCGCCGGACCGTTGATCCGCTCCGTGCTGCCGGCGGGCTGGTTTATCGCCGATAAGACCGGAGCTAGCAAGCGGGGTGCGCGCGGGATTGTCGCCCTGCTTGGCCCGAATAACAAAGCAGAGCGCATTGTGGTGATTTATCTGCGGGATACGCCGGCGAGCATGGCCGAGCG
gb|JF265068.1|+|954-2106|ARO:3004617|ADC-30 [Acinetobacter baumannii] 	0	1097	63	1160	1152	126080+	1097	ATGCGATTTAAAAAAATTTCTTGTCTACTTTTATCCCCGCTTTTTATTTTTAGTACCTCAATTTATGCGGGCAATACACCAAAAGACCAAGAAATTAAAAAACTGGTAGATCAAAACTTTAAACCGTTATTAGAAAAATATGATGTGCCAGGTATGGCTGTGGGTGTTATTCAAAATAATAAAAAGTATGAAATGTATTATGGTCTTCAATCTGTTCAAGATAAAAAAGCCGTAAATAGCAGTACTATTTTTGAGCTAGGTTCTGTCAGTAAATTATTTACCGCGACAGCAGGTGGATATGCAAAAAATAAAGGAAAAATCTCTTTTGACGATACGCCTGGTAAGTATTGGAAAGAACTAAAAAATACACCGATTGACCAAGTTAACTTACTTCAACTCGCGACGTATACAAGTGGTAACCTTGCCTTGCAATTTCCAGATGAAGTAAAAACAGATCAGCAAGTTTTAACATTTTTTAAAGACTGGAAACCTAAAAACTCAATCGGTGAATATCGACAATATTCAAACCCAAGCATTGGTTTATTTGGAAAAGTTGTAGCTTTGTCTATGAATAAACCTTTCGACCAAGTCTTAGAAAAAACAATTTTTCCGGCCCTTGGCTTAAAACATAGCTATGTAAATGTACCTAAGACCCAGATGCAAAACTATGCTTTTGGCTATAACCAAGAAAATCAGCCGATTCGAGTTAACCCCGGCCCACTCGATGCCCCAGCATATGGCGTCAAATCGACACTACCCGACATGTTGAGTTTTATTCATGCCAACCTAAATCCACAAAAATATCCAGCAGATATTCAACGGGCAATTAATGAAACACATCAGGGTCGCTATCAAGTAAATACCATGTATCAGGCACTCGGTTGGGAAGAGTTTTCTTATCCGGCAACGTTACAAACTTTATTAGACAGTAATTCAGAACAGATTGTGATGAAACCTAATAAAGTGACTGCTATTTCAAAGGAACCTTCAGTTAAGATGTACCATAAAACTGGCTCAACTACCGGTTTCGGAACATATGTGGTGTTTATTCCTAAAGAAAATATTGGTTTAGTCATGTTAACCAATAAACGTATTCC
gb|HM488991|+|0-822|ARO:3001470|OXA-170 [Acinetobacter baumannii] 	0	767	80	847	822	254088-	767	ATGAATAAATATTTTACTTGCTATGTGGTTGCTTCTCTTTTTCTTTCTGGTTGTACGGTTCAGCATAATTTAATAAATGAAACCCCGAGTCAGATTGTTCAAGGACATAATCAGGTGATTCATCAATACTTTGATGAAAAAAACACCTCAGGTGTGCTGGTTATTCAAACAGATAAAAAAATTAATCTATATGGTAATGCTCTAAGCCGCGCAAATACAGAATATGTGCCAGCCTCTACATTTAAAATGTTGAATGCCCTGATCGGATTGGAGAACCAGAAAACGGATATTAATGAAATATTTAAATGGAAGGGCGAGAAAAGGTCATTTACCGCTTGGGAAAAAGACATGACACTAGGAGAAGCCATGAAGCTTTCTGCAGTCCCAGTCTATCAGGAACTTGCGCGACGTATCGGTCTTGATCTCATGCAAAAAGAAGTAAAACGTATTGGTTTCGGTAATGCTGAAATTGGACAGCAGGTTGATAATTTCTGGTTGGTAGGACCATTAAAGGTTACGCCTATTCAAGAGGTAGAGTTTGTTTCCCAATTAGCACATACACAGCTTCCATTTAGTGAAAAAGTGCAGGCTAATGTAAAAAATATGCTTCTTTTAGAAGAGAGTAATGGCTACAAAATTTTTGGAAAGACTGGTTGGGCAATGGATATAAAACCACAAGTGGGCTGGTTGACCGGCTGGGTTGAGCAGCCAGATGGAAAAATTGTCGCTTTTGCATTAAATATGGAAATGCGGTCAGAAATGCCGGC
gb|JX121121|+|0-858|ARO:3001193|SHV-154 [Klebsiella pneumoniae] 	0	803	16	819	858	1612535+	803	ATGCGTTATATTCGCCTGTGTATTATCACCCTGTGAGCCACCCTGCCGCTGGCGGTACACGCCAGCCCGCAGCCGCTTGAGCAAATTAAACAAAGCGAAAGCCAGCTGTCGGGCCGCGTAGGCATGATAGAAATGGATCTGGCCAGCGGCCGCACGCTGACCGCCTGGCGCGCCGATGAACGCTTTCCCATGATGAGCACCTTTAAAGTAGTGCTCTGCGGCGCAGTGCTGGCGCGGGTGGATGCCGGTGACGAACAGCTGGAGCGAAAGATCCACTATCGCCAGCAGGATCTGGTGGACTACTCGCCGGTCAGCGAAAAACACCTTGCCGACGGCATGACGGTCGGCGAACTCTGCGCCGCCGCCATTACCATGAGCGATAACAGCGCCGCCAATCTGCTGCTGGCCACCGTCGGCGGCCCCGCAGGATTGACTGCCTTTTTGCGCCAGATCGGCGACAACGTCACCCGCCTTGACCGCTGGGAAACGGAACTGAATGAGGCGCTTCCCGGCGACGCCCGCGACACCACTACCCCGGCCAGCATGGCCGCGACCCTGCGCAAGCTGCTGACCAGCCAGCGTCTGAGCGCCCGTTCGCAACGGCAGCTGCTGCAGTGGATGGTGGACGATCGGGTCGCCGGACCGTTGATCCGCTCCGTGCTGCCGGCGGGCTGGTTTATCGCCGATAAGACCGGAGCTAGCAAGCGGGGTGCGCGCGGGATTGTCGCCCTGCTTGGCCCGAATAACAAAGCAGAGCGCATTGTGGTGATTTATCTGCGGGATACGCCGGCGAGCATGGCCGA
gb|AY750913|+|0-825|ARO:3001619|OXA-71 [Acinetobacter baumannii] 	0	770	54149	54919	825	246080-	770	ATGAACATTAAAGCACTCTTACTTATAACAAGCGCTATTTTTATTTCAGCCTGCTCACCTTATATAGTGACTGCTAATCCAAATCACAGCGCTTCAAAATCTGATGTAAAAGCAGAGAAAATTAAAAATTTATTTAACGAAGCACACACTACGGGTGTTTTAGTTATCCAACAAGGCCAAACTCAACAAAGCTATGGTAATGATCTTGCTCGTGCTTCGACCGAGTATGTACCTGCTTCGACCTTCAAAATGCTTAATGCTTTGATCGGCCTTGAGCACCATAAGGCAACCACCACAGAAGTATTTAAGTGGGATGGTAAAAAAAGGTTATTCCCAGAATGGGAAAAGGACATGACCCTAGGCGATGCCATGAAAGCTTCCGCTATTCCAGTTTATCAAGATTTAGCTCGTCGTATTGGACTTGAGCTCATGTCTAAGGAAGTGAAGCGTGTTGGTTATGGCAATGCAGATATCGGTACCCAAGTCGATAATTTTTGGCTGGTGGGTCCTTTAAAAATTACTCCTCAGCAAGAGGCACAGTTTGCTTACAAGCTAGCTAATAAAACGCTTCCATTTAGCCAAAAAGTCCAAGATGAAGTGCAATCCATGCTATTCATAGAAGAAAAGAATGGAAACAAAATATACGCAAAAAGTGGTTGGGGATGGGATGTAAACCCACAAGTAGGCTGGTTAACTGGATGGGTTGTTCAGCCTCAAGGGAATATTGTAGCGTTCTCCCTTAACTTAGAAATGAAAAAAGGAATACCTAG
gb|AF467947|+|0-861|ARO:3001094|SHV-36 [Klebsiella pneumoniae] 	0	806	16	822	861	1612535+	806	ATGCGTTATATTCGCCTGTGTATTATCACCCTGTGAGCCACCCTGCCGCTGGCGGTACACGCCAGCCCGCAGCCGCTTGAGCAAATTAAACAAAGCGAAAGCCAGCTGTCGGGCCGCGTAGGCATGATAGAAATGGATCTGGCCAGCGGCCGCACGCTGACCGCCTGGCGCGCCGATGAACGCTTTCCCATGATGAGCACCTTTAAAGTAGTGCTCTGCGGCGCAGTGCTGGCGCGGGTGGATGCCGGTGACGAACAGCTGGAGCGAAAGATCCACTATCGCCAGCAGGATCTGGTGGACTACTCGCCGGTCAGCGAAAAACACCTTGCCGACGGCATGACGGTCGGCGAACTCTGCGCCGCCGCCATTACCATGAGCGATAACAGCGCCGCCAATCTGCTGCTGGCCACCGTCGGCGGCCCCGCAGGATTGACTGCCTTTTTGCGCCAGATCGGCGACAACGTCACCCGCCTTGACCGCTGGGAAACGGAACTGAATGAGGCGCTTCCCGGCGACGCCCGCGACACCACTACCCCGGCCAGCATGGCCGCGACCCTGCGCAAGCTGCTGACCAGCCAGCGTCTGAGCGCCCGTTCGCAACGGCAGCTGCTGCAGTGGATGGTGGACGATCGGGTCGCCGGACCGTTGATCCGCTCCGTGCTGCCGGCGGGCTGGTTTATCGCCGATAAGACCGGAGCTAGCAAGCGGGGTGCGCGCGGGATTGTCGCCCTGCTTGGCCCGAATAACAAAGCAGAGCGCATTGTGGTGATTTATCTGCGGGATACGCCGGCGAGCATGGCCGAGCG
gb|HM488992|+|0-822|ARO:3001471|OXA-171 [Acinetobacter baumannii] 	0	767	80	847	822	254088-	767	ATGAATAAATATTTTACTTGCTATGTGGTTGCTTCTCTTTTTCTTTCTGGTTGTACGGTTCAGCATAATTTAATAAATGAAACCCCGAGTCAGATTGTTCAAGGACATAATCAGGTGATTCATCAATACTTTGATGAAAAAAACACCTCAGGTGTGCTGGTTATTCAAACAGATAAAAAAATTAATCTATATGGTAATGCTCTAAGCCGCGCAAATACAGAATATGTGCCAGCCTCTACATTTAAAATGTTGAATGCCCTGATCGGATTGGAGAACCAGAAAACGGATATTAATGAAATATTTAAATGGAAGGGCGAGAAAAGGTCATTTACCGCTTGGGAAAAAGACATGACACTAGGAGAAGCCATGAAGCTTTCTGCAGTCCCAGTCTATCAGGAACTTGCGCGACGTATCGGTCTTGATCTCATGCAAAAAGAAGTAAAACGTATTGGTTTCGGTAATGCTGAAATTGGACAGCAGGTTGATAATTTCTGGTTGGTAGGACCATTAAAGGTTACGCCTATTCAAGAGGTAGAGTTTGTTTCCCAATTAGCACATACACAGCTTCCATTTAGTGAAAAAGTGCAGGCTAATGTAAAAAATATGCTTCTTTTAGAAGAGAGTAATGGCTACAAAATTTTTGGAAAGACTGGTTGGGCAATGGATATAAAACCACAAGTGGGCTGGTTGACCGGCTGGGTTGAGCAGCCAGATGGAAAAATTGTCGCTTTTGCATTAAATATGGAAATGCGGTCAGAAATGCCGGC
gb|JX121122|+|0-858|ARO:3001194|SHV-155 [Klebsiella pneumoniae] 	0	801	16	817	858	1612535+	801	ATGCGTTATATTCGCCTGTGTATTATCACCCTGTGAGCCACCCTGCCGCTGGCGGTACACGCCAGCCCGCAGCCGCTTGAGCAAATTAAACAAAGCGAAAGCCAGCTGTCGGGCCGCGTAGGCATGATAGAAATGGATCTGGCCAGCGGCCGCACGCTGACCGCCTGGCGCGCCGATGAACGCTTTCCCATGATGAGCACCTTTAAAGTAGTGCTCTGCGGCGCAGTGCTGGCGCGGGTGGATGCCGGTGACGAACAGCTGGAGCGAAAGATCCACTATCGCCAGCAGGATCTGGTGGACTACTCGCCGGTCAGCGAAAAACACCTTGCCGACGGCATGACGGTCGGCGAACTCTGCGCCGCCGCCATTACCATGAGCGATAACAGCGCCGCCAATCTGCTGCTGGCCACCGTCGGCGGCCCCGCAGGATTGACTGCCTTTTTGCGCCAGATCGGCGACAACGTCACCCGCCTTGACCGCTGGGAAACGGAACTGAATGAGGCGCTTCCCGGCGACGCCCGCGACACCACTACCCCGGCCAGCATGGCCGCGACCCTGCGCAAGCTGCTGACCAGCCAGCGTCTGAGCGCCCGTTCGCAACGGCAGCTGCTGCAGTGGATGGTGGACGATCGGGTCGCCGGACCGTTGATCCGCTCCGTGCTGCCGGCGGGCTGGTTTATCGCCGATAAGACCGGAGCTAGCAAGCGGGGTGCGCGCGGGATTGTCGCCCTGCTTGGCCCGAATAACAAAGCAGAGCGCATTGTGGTGATTTATCTGCGGGATACGCCGGCGAGCATGGCC
gb|AM087453|+|25-856|ARO:3001138|SHV-84 [Escherichia coli] 	0	776	16	792	831	1612535+	776	ATGCGTTATATTCGCCTGTGTATTATCACCCTGTGAGCCACCCTGCCGCTGGCGGTACACGCCAGCCCGCAGCCGCTTGAGCAAATTAAACAAAGCGAAAGCCAGCTGTCGGGCCGCGTAGGCATGATAGAAATGGATCTGGCCAGCGGCCGCACGCTGACCGCCTGGCGCGCCGATGAACGCTTTCCCATGATGAGCACCTTTAAAGTAGTGCTCTGCGGCGCAGTGCTGGCGCGGGTGGATGCCGGTGACGAACAGCTGGAGCGAAAGATCCACTATCGCCAGCAGGATCTGGTGGACTACTCGCCGGTCAGCGAAAAACACCTTGCCGACGGCATGACGGTCGGCGAACTCTGCGCCGCCGCCATTACCATGAGCGATAACAGCGCCGCCAATCTGCTGCTGGCCACCGTCGGCGGCCCCGCAGGATTGACTGCCTTTTTGCGCCAGATCGGCGACAACGTCACCCGCCTTGACCGCTGGGAAACGGAACTGAATGAGGCGCTTCCCGGCGACGCCCGCGACACCACTACCCCGGCCAGCATGGCCGCGACCCTGCGCAAGCTGCTGACCAGCCAGCGTCTGAGCGCCCGTTCGCAACGGCAGCTGCTGCAGTGGATGGTGGACGATCGGGTCGCCGGACCGTTGATCCGCTCCGTGCTGCCGGCGGGCTGGTTTATCGCCGATAAGACCGGAGCTAGCAAGCGGGGTGCGCGCGGGATTGTCGCCCTGCTTGGCCCGAATAACAAAGCAGAGCGCATTGTGGTGATTTATCT
gb|AY762325|+|115-937|ARO:3001785|OXA-73 [Klebsiella pneumoniae] 	0	767	80	847	822	254088-	767	ATGAATAAATATTTTACTTGCTATGTGGTTGCTTCTCTTTTTCTTTCTGGTTGTACGGTTCAGCATAATTTAATAAATGAAACCCCGAGTCAGATTGTTCAAGGACATAATCAGGTGATTCATCAATACTTTGATGAAAAAAACACCTCAGGTGTGCTGGTTATTCAAACAGATAAAAAAATTAATCTATATGGTAATGCTCTAAGCCGCGCAAATACAGAATATGTGCCAGCCTCTACATTTAAAATGTTGAATGCCCTGATCGGATTGGAGAACCAGAAAACGGATATTAATGAAATATTTAAATGGAAGGGCGAGAAAAGGTCATTTACCGCTTGGGAAAAAGACATGACACTAGGAGAAGCCATGAAGCTTTCTGCAGTCCCAGTCTATCAGGAACTTGCGCGACGTATCGGTCTTGATCTCATGCAAAAAGAAGTAAAACGTATTGGTTTCGGTAATGCTGAAATTGGACAGCAGGTTGATAATTTCTGGTTGGTAGGACCATTAAAGGTTACGCCTATTCAAGAGGTAGAGTTTGTTTCCCAATTAGCACATACACAGCTTCCATTTAGTGAAAAAGTGCAGGCTAATGTAAAAAATATGCTTCTTTTAGAAGAGAGTAATGGCTACAAAATTTTTGGAAAGACTGGTTGGGCAATGGATATAAAACCACAAGTGGGCTGGTTGACCGGCTGGGTTGAGCAGCCAGATGGAAAAATTGTCGCTTTTGCATTAAATATGGAAATGCGGTCAGAAATGCCGGC
gb|AF467948|+|0-861|ARO:3001095|SHV-37 [Klebsiella pneumoniae] 	0	806	16	822	861	1612535+	806	ATGCGTTATATTCGCCTGTGTATTATCACCCTGTGAGCCACCCTGCCGCTGGCGGTACACGCCAGCCCGCAGCCGCTTGAGCAAATTAAACAAAGCGAAAGCCAGCTGTCGGGCCGCGTAGGCATGATAGAAATGGATCTGGCCAGCGGCCGCACGCTGACCGCCTGGCGCGCCGATGAACGCTTTCCCATGATGAGCACCTTTAAAGTAGTGCTCTGCGGCGCAGTGCTGGCGCGGGTGGATGCCGGTGACGAACAGCTGGAGCGAAAGATCCACTATCGCCAGCAGGATCTGGTGGACTACTCGCCGGTCAGCGAAAAACACCTTGCCGACGGCATGACGGTCGGCGAACTCTGCGCCGCCGCCATTACCATGAGCGATAACAGCGCCGCCAATCTGCTGCTGGCCACCGTCGGCGGCCCCGCAGGATTGACTGCCTTTTTGCGCCAGATCGGCGACAACGTCACCCGCCTTGACCGCTGGGAAACGGAACTGAATGAGGCGCTTCCCGGCGACGCCCGCGACACCACTACCCCGGCCAGCATGGCCGCGACCCTGCGCAAGCTGCTGACCAGCCAGCGTCTGAGCGCCCGTTCGCAACGGCAGCTGCTGCAGTGGATGGTGGACGATCGGGTCGCCGGACCGTTGATCCGCTCCGTGCTGCCGGCGGGCTGGTTTATCGCCGATAAGACCGGAGCTAGCAAGCGGGGTGCGCGCGGGATTGTCGCCCTGCTTGGCCCGAATAACAAAGCAGAGCGCATTGTGGTGATTTATCTGCGGGATACGCCGGCGAGCATGGCCGAGCG
gb|CP001921.1|+|2803996-2805148|ARO:3003870|ADC-31 [Acinetobacter baumannii 1656-2] 	0	1097	63	1160	1152	126080+	1097	ATGCGATTTAAAAAAATTTCTTGTCTACTTTTATCCCCGCTTTTTATTTTTAGTACCTCAATTTATGCGGGCAATACACCAAAAGACCAAGAAATTAAAAAACTGGTAGATCAAAACTTTAAACCGTTATTAGAAAAATATGATGTGCCAGGTATGGCTGTGGGTGTTATTCAAAATAATAAAAAGTATGAAATGTATTATGGTCTTCAATCTGTTCAAGATAAAAAAGCCGTAAATAGCAGTACTATTTTTGAGCTAGGTTCTGTCAGTAAATTATTTACCGCGACAGCAGGTGGATATGCAAAAAATAAAGGAAAAATCTCTTTTGACGATACGCCTGGTAAGTATTGGAAAGAACTAAAAAATACACCGATTGACCAAGTTAACTTACTTCAACTCGCGACGTATACAAGTGGTAACCTTGCCTTGCAATTTCCAGATGAAGTAAAAACAGATCAGCAAGTTTTAACATTTTTTAAAGACTGGAAACCTAAAAACTCAATCGGTGAATATCGACAATATTCAAACCCAAGCATTGGTTTATTTGGAAAAGTTGTAGCTTTGTCTATGAATAAACCTTTCGACCAAGTCTTAGAAAAAACAATTTTTCCGGCCCTTGGCTTAAAACATAGCTATGTAAATGTACCTAAGACCCAGATGCAAAACTATGCTTTTGGCTATAACCAAGAAAATCAGCCGATTCGAGTTAACCCCGGCCCACTCGATGCCCCAGCATATGGCGTCAAATCGACACTACCCGACATGTTGAGTTTTATTCATGCCAACCTAAATCCACAAAAATATCCAGCAGATATTCAACGGGCAATTAATGAAACACATCAGGGTCGCTATCAAGTAAATACCATGTATCAGGCACTCGGTTGGGAAGAGTTTTCTTATCCGGCAACGTTACAAACTTTATTAGACAGTAATTCAGAACAGATTGTGATGAAACCTAATAAAGTGACTGCTATTTCAAAGGAACCTTCAGTTAAGATGTACCATAAAACTGGCTCAACTACCGGTTTCGGAACATATGTGGTGTTTATTCCTAAAGAAAATATTGGTTTAGTCATGTTAACCAATAAACGTATTCC
gb|HM113558|+|0-825|ARO:3001656|OXA-172 [Acinetobacter baumannii] 	0	770	54149	54919	825	246080-	770	ATGAACATTAAAGCACTCTTACTTATAACAAGCGCTATTTTTATTTCAGCCTGCTCACCTTATATAGTGACTGCTAATCCAAATCACAGCGCTTCAAAATCTGATGTAAAAGCAGAGAAAATTAAAAATTTATTTAACGAAGCACACACTACGGGTGTTTTAGTTATCCAACAAGGCCAAACTCAACAAAGCTATGGTAATGATCTTGCTCGTGCTTCGACCGAGTATGTACCTGCTTCGACCTTCAAAATGCTTAATGCTTTGATCGGCCTTGAGCACCATAAGGCAACCACCACAGAAGTATTTAAGTGGGATGGTAAAAAAAGGTTATTCCCAGAATGGGAAAAGGACATGACCCTAGGCGATGCCATGAAAGCTTCCGCTATTCCAGTTTATCAAGATTTAGCTCGTCGTATTGGACTTGAGCTCATGTCTAAGGAAGTGAAGCGTGTTGGTTATGGCAATGCAGATATCGGTACCCAAGTCGATAATTTTTGGCTGGTGGGTCCTTTAAAAATTACTCCTCAGCAAGAGGCACAGTTTGCTTACAAGCTAGCTAATAAAACGCTTCCATTTAGCCAAAAAGTCCAAGATGAAGTGCAATCCATGCTATTCATAGAAGAAAAGAATGGAAACAAAATATACGCAAAAAGTGGTTGGGGATGGGATGTAAACCCACAAGTAGGCTGGTTAACTGGATGGGTTGTTCAGCCTCAAGGGAATATTGTAGCGTTCTCCCTTAACTTAGAAATGAAAAAAGGAATACCTAG
gb|JX121123|+|0-861|ARO:3001195|SHV-156 [Klebsiella pneumoniae] 	0	806	16	822	861	1612535+	806	ATGCGTTATATTCGCCTGTGTATTATCACCCTGTGAGCCACCCTGCCGCTGGCGGTACACGCCAGCCCGCAGCCGCTTGAGCAAATTAAACAAAGCGAAAGCCAGCTGTCGGGCCGCGTAGGCATGATAGAAATGGATCTGGCCAGCGGCCGCACGCTGACCGCCTGGCGCGCCGATGAACGCTTTCCCATGATGAGCACCTTTAAAGTAGTGCTCTGCGGCGCAGTGCTGGCGCGGGTGGATGCCGGTGACGAACAGCTGGAGCGAAAGATCCACTATCGCCAGCAGGATCTGGTGGACTACTCGCCGGTCAGCGAAAAACACCTTGCCGACGGCATGACGGTCGGCGAACTCTGCGCCGCCGCCATTACCATGAGCGATAACAGCGCCGCCAATCTGCTGCTGGCCACCGTCGGCGGCCCCGCAGGATTGACTGCCTTTTTGCGCCAGATCGGCGACAACGTCACCCGCCTTGACCGCTGGGAAACGGAACTGAATGAGGCGCTTCCCGGCGACGCCCGCGACACCACTACCCCGGCCAGCATGGCCGCGACCCTGCGCAAGCTGCTGACCAGCCAGCGTCTGAGCGCCCGTTCGCAACGGCAGCTGCTGCAGTGGATGGTGGACGATCGGGTCGCCGGACCGTTGATCCGCTCCGTGCTGCCGGCGGGCTGGTTTATCGCCGATAAGACCGGAGCTAGCAAGCGGGGTGCGCGCGGGATTGTCGCCCTGCTTGGCCCGAATAACAAAGCAGAGCGCATTGTGGTGATTTATCTGCGGGATACGCCGGCGAGCATGGCCGAGCG
gb|KF048913.1|+|0-825|ARO:3001529|OXA-341 [Acinetobacter baumannii] 	0	770	54149	54919	825	246080-	770	ATGAACATTAAAGCACTCTTACTTATAACAAGCGCTATTTTTATTTCAGCCTGCTCACCTTATATAGTGACTGCTAATCCAAATCACAGCGCTTCAAAATCTGATGTAAAAGCAGAGAAAATTAAAAATTTATTTAACGAAGCACACACTACGGGTGTTTTAGTTATCCAACAAGGCCAAACTCAACAAAGCTATGGTAATGATCTTGCTCGTGCTTCGACCGAGTATGTACCTGCTTCGACCTTCAAAATGCTTAATGCTTTGATCGGCCTTGAGCACCATAAGGCAACCACCACAGAAGTATTTAAGTGGGATGGTAAAAAAAGGTTATTCCCAGAATGGGAAAAGGACATGACCCTAGGCGATGCCATGAAAGCTTCCGCTATTCCAGTTTATCAAGATTTAGCTCGTCGTATTGGACTTGAGCTCATGTCTAAGGAAGTGAAGCGTGTTGGTTATGGCAATGCAGATATCGGTACCCAAGTCGATAATTTTTGGCTGGTGGGTCCTTTAAAAATTACTCCTCAGCAAGAGGCACAGTTTGCTTACAAGCTAGCTAATAAAACGCTTCCATTTAGCCAAAAAGTCCAAGATGAAGTGCAATCCATGCTATTCATAGAAGAAAAGAATGGAAACAAAATATACGCAAAAAGTGGTTGGGGATGGGATGTAAACCCACAAGTAGGCTGGTTAACTGGATGGGTTGTTCAGCCTCAAGGGAATATTGTAGCGTTCTCCCTTAACTTAGAAATGAAAAAAGGAATACCTAG
gb|AY079099|+|148-1009|ARO:3001096|SHV-38 [Klebsiella pneumoniae] 	0	806	16	822	861	1612535+	806	ATGCGTTATATTCGCCTGTGTATTATCACCCTGTGAGCCACCCTGCCGCTGGCGGTACACGCCAGCCCGCAGCCGCTTGAGCAAATTAAACAAAGCGAAAGCCAGCTGTCGGGCCGCGTAGGCATGATAGAAATGGATCTGGCCAGCGGCCGCACGCTGACCGCCTGGCGCGCCGATGAACGCTTTCCCATGATGAGCACCTTTAAAGTAGTGCTCTGCGGCGCAGTGCTGGCGCGGGTGGATGCCGGTGACGAACAGCTGGAGCGAAAGATCCACTATCGCCAGCAGGATCTGGTGGACTACTCGCCGGTCAGCGAAAAACACCTTGCCGACGGCATGACGGTCGGCGAACTCTGCGCCGCCGCCATTACCATGAGCGATAACAGCGCCGCCAATCTGCTGCTGGCCACCGTCGGCGGCCCCGCAGGATTGACTGCCTTTTTGCGCCAGATCGGCGACAACGTCACCCGCCTTGACCGCTGGGAAACGGAACTGAATGAGGCGCTTCCCGGCGACGCCCGCGACACCACTACCCCGGCCAGCATGGCCGCGACCCTGCGCAAGCTGCTGACCAGCCAGCGTCTGAGCGCCCGTTCGCAACGGCAGCTGCTGCAGTGGATGGTGGACGATCGGGTCGCCGGACCGTTGATCCGCTCCGTGCTGCCGGCGGGCTGGTTTATCGCCGATAAGACCGGAGCTAGCAAGCGGGGTGCGCGCGGGATTGTCGCCCTGCTTGGCCCGAATAACAAAGCAGAGCGCATTGTGGTGATTTATCTGCGGGATACGCCGGCGAGCATGGCCGAGCG
gb|AJ854182|+|0-801|ARO:3001798|OXA-74 [Pseudomonas aeruginosa] 	0	746	659	1405	801	104604+	746	ATGAAAACATTTGCCGCATATGTAATTATCGCGTGTCTTTCGAGTACGGCATTAGCTGGTTCAATTACAGAAAATACGTCTTGGAACAAAGAGTTCTCTGCCGAAGCCGTCAATGGTGTCTTCGTGCTTTGTAAAAGTAGCAGTAAATCCTGCGCTACCAATGACTTAGCTCGTGCATCAAAGGAATATCTTCCAGCATCAACATTTAAGATCCCCAACGCAATTATCGGCCTAGAAACTGGTGTCATAAAGAATGAGCATCAGGTTTTCAAATGGGACGGAAAGCCAAGAGCCATGAAGCAATGGGAAAGAGACTTGACCTTAAGAGGGGCAATACAAGTTTCAGCTGTTCCCGTATTTCAACAAATCGCCAGAGAAGTTGGCGAAGTAAGAATGCAGAAATACCTTAAAAAATTTTCCTATGGCAACCAGAATATCAGTGGTGGCATTGACAAATTCTGGTTGGAAGGCCAGCTTAGAATTTCCGCAGTTAATCAAGTGGAGTTTCTAGAGTCTCTATATTTAAATAAATTGTCAGCATCTAAAGAAAACCAGCTAATAGTAAAAGAGGCTTTGGTAACGGAGGCGGCACCTGAATATCTAGTGCATTCAAAAACTGGTTTTTCTGGTGTGGGAACTGAGTCAAATCCTGGTGTCGCATGGTGGGTTGGGTGGGTTGAGAAGGAGACAGAGGTTTACTTTTTCGCCTTTAACATGGATATAGACAACGAAAGTAAGTTGCCGCT
gb|JX121124|+|0-861|ARO:3001196|SHV-157 [Klebsiella pneumoniae] 	0	806	16	822	861	1612535+	806	ATGCGTTATATTCGCCTGTGTATTATCACCCTGTGAGCCACCCTGCCGCTGGCGGTACACGCCAGCCCGCAGCCGCTTGAGCAAATTAAACAAAGCGAAAGCCAGCTGTCGGGCCGCGTAGGCATGATAGAAATGGATCTGGCCAGCGGCCGCACGCTGACCGCCTGGCGCGCCGATGAACGCTTTCCCATGATGAGCACCTTTAAAGTAGTGCTCTGCGGCGCAGTGCTGGCGCGGGTGGATGCCGGTGACGAACAGCTGGAGCGAAAGATCCACTATCGCCAGCAGGATCTGGTGGACTACTCGCCGGTCAGCGAAAAACACCTTGCCGACGGCATGACGGTCGGCGAACTCTGCGCCGCCGCCATTACCATGAGCGATAACAGCGCCGCCAATCTGCTGCTGGCCACCGTCGGCGGCCCCGCAGGATTGACTGCCTTTTTGCGCCAGATCGGCGACAACGTCACCCGCCTTGACCGCTGGGAAACGGAACTGAATGAGGCGCTTCCCGGCGACGCCCGCGACACCACTACCCCGGCCAGCATGGCCGCGACCCTGCGCAAGCTGCTGACCAGCCAGCGTCTGAGCGCCCGTTCGCAACGGCAGCTGCTGCAGTGGATGGTGGACGATCGGGTCGCCGGACCGTTGATCCGCTCCGTGCTGCCGGCGGGCTGGTTTATCGCCGATAAGACCGGAGCTAGCAAGCGGGGTGCGCGCGGGATTGTCGCCCTGCTTGGCCCGAATAACAAAGCAGAGCGCATTGTGGTGATTTATCTGCGGGATACGCCGGCGAGCATGGCCGAGCG
gb|DQ322460|+|15-876|ARO:3001139|SHV-85 [Klebsiella pneumoniae] 	0	806	16	822	861	1612535+	806	ATGCGTTATATTCGCCTGTGTATTATCACCCTGTGAGCCACCCTGCCGCTGGCGGTACACGCCAGCCCGCAGCCGCTTGAGCAAATTAAACAAAGCGAAAGCCAGCTGTCGGGCCGCGTAGGCATGATAGAAATGGATCTGGCCAGCGGCCGCACGCTGACCGCCTGGCGCGCCGATGAACGCTTTCCCATGATGAGCACCTTTAAAGTAGTGCTCTGCGGCGCAGTGCTGGCGCGGGTGGATGCCGGTGACGAACAGCTGGAGCGAAAGATCCACTATCGCCAGCAGGATCTGGTGGACTACTCGCCGGTCAGCGAAAAACACCTTGCCGACGGCATGACGGTCGGCGAACTCTGCGCCGCCGCCATTACCATGAGCGATAACAGCGCCGCCAATCTGCTGCTGGCCACCGTCGGCGGCCCCGCAGGATTGACTGCCTTTTTGCGCCAGATCGGCGACAACGTCACCCGCCTTGACCGCTGGGAAACGGAACTGAATGAGGCGCTTCCCGGCGACGCCCGCGACACCACTACCCCGGCCAGCATGGCCGCGACCCTGCGCAAGCTGCTGACCAGCCAGCGTCTGAGCGCCCGTTCGCAACGGCAGCTGCTGCAGTGGATGGTGGACGATCGGGTCGCCGGACCGTTGATCCGCTCCGTGCTGCCGGCGGGCTGGTTTATCGCCGATAAGACCGGAGCTAGCAAGCGGGGTGCGCGCGGGATTGTCGCCCTGCTTGGCCCGAATAACAAAGCAGAGCGCATTGTGGTGATTTATCTGCGGGATACGCCGGCGAGCATGGCCGAGCG
gb|KF048915.1|+|0-825|ARO:3001530|OXA-342 [Acinetobacter baumannii] 	0	770	54149	54919	825	246080-	770	ATGAACATTAAAGCACTCTTACTTATAACAAGCGCTATTTTTATTTCAGCCTGCTCACCTTATATAGTGACTGCTAATCCAAATCACAGCGCTTCAAAATCTGATGTAAAAGCAGAGAAAATTAAAAATTTATTTAACGAAGCACACACTACGGGTGTTTTAGTTATCCAACAAGGCCAAACTCAACAAAGCTATGGTAATGATCTTGCTCGTGCTTCGACCGAGTATGTACCTGCTTCGACCTTCAAAATGCTTAATGCTTTGATCGGCCTTGAGCACCATAAGGCAACCACCACAGAAGTATTTAAGTGGGATGGTAAAAAAAGGTTATTCCCAGAATGGGAAAAGGACATGACCCTAGGCGATGCCATGAAAGCTTCCGCTATTCCAGTTTATCAAGATTTAGCTCGTCGTATTGGACTTGAGCTCATGTCTAAGGAAGTGAAGCGTGTTGGTTATGGCAATGCAGATATCGGTACCCAAGTCGATAATTTTTGGCTGGTGGGTCCTTTAAAAATTACTCCTCAGCAAGAGGCACAGTTTGCTTACAAGCTAGCTAATAAAACGCTTCCATTTAGCCAAAAAGTCCAAGATGAAGTGCAATCCATGCTATTCATAGAAGAAAAGAATGGAAACAAAATATACGCAAAAAGTGGTTGGGGATGGGATGTAAACCCACAAGTAGGCTGGTTAACTGGATGGGTTGTTCAGCCTCAAGGGAATATTGTAGCGTTCTCCCTTAACTTAGAAATGAAAAAAGGAATACCTAG
gb|KR057745.1|+|0-1116|ARO:3004339|PDC-76 [Pseudomonas aeruginosa] 	3	1061	35594	36652	1116	232416+	1058	GAGGCCCCGGCGGATCGCCTGAAGGCACTGGTCGACGCCGCCGTACAACCGGTGATGAAGGCCAATGACATTCCGGGCCTGGCCGTAGCCATCAGCCTGAAAGGAGAACCGCATTACTTCAGCTATGGGCTGGCCTCGAAAGAGGACGGCCGCCGGGTGACGCCGGAGACCCTGTTCGAGATCGGCTCGGTGAGCAAGACCTTCACCGTCACCCTCGCCGGCTATGCCCTGGCCCAGGACAAGATGCGCCTCGACGACCGCGCCAGCCAGCACTGGCCGGCACTGCAGGGCAGCCGCTTCGACGGCATCAGCCTGCTCGACCTCGCGACCTATACCGCCGGCGGCTTGCCGCTGCAGTTCCCCGACTCGGTGCAGAAGGACCAGGCACAGATCCGCGACTACTACCGCCAGTGGCAGCCGACCTACGCGCCGGGCAGCCAGCGCCTCTATTCCAACCCGAGCATCGGCCTGTTCGGCTATCTCGCCGCGCGCAGCCTGGGCCAGCCGTTCGAACGGCTCATGGAGCAGCAATTGTTCCCGGCACTGGGCCTCGAACAGACCCACCTCGACGTGCCCGAGGCGGCGCTGGCGCAGTACGCCCAGGGCTACGGCAAGGACGACCGCCCGCTACGGGTCGGTCCCGGCCCGCTGGATGCCGAAGGCTACGGGGTGAAGACCAGCGCGGCCGACCTGCTGCGCTTCGTCGATGCCAACCTGCATCCGGAGCGCCTGGACAGGCCCTGGGCGCAGGCGCTCGATGCCACCCATCGCGGTTACTACAAGGTCGGCGACATGACCCAGGGCCTGGGCTGGGAAGCCTACGACTGGCCGATCTCCCTGAAGCGCCTGCAGGCCGGCAACTCGACGCCGATGGCGCTGCAACCACACAGGATCGCCAGGCTGCCCGCGCCACAGGCGCTGGAGGGCCAGCGCCTGCTGAACAAGACCGGCTCCACCAACGGCTTCGGCGCCTACGTGGCGTTCGTCCCGGGCCGCGACCTGGGCCTGGTGATCCTGGCCAACCGCAACTATCCCAATGCCGAGCGGGTGAAGATCGC
gb|HM113559|+|0-825|ARO:3001657|OXA-173 [Acinetobacter baumannii] 	0	770	54149	54919	825	246080-	770	ATGAACATTAAAGCACTCTTACTTATAACAAGCGCTATTTTTATTTCAGCCTGCTCACCTTATATAGTGACTGCTAATCCAAATCACAGCGCTTCAAAATCTGATGTAAAAGCAGAGAAAATTAAAAATTTATTTAACGAAGCACACACTACGGGTGTTTTAGTTATCCAACAAGGCCAAACTCAACAAAGCTATGGTAATGATCTTGCTCGTGCTTCGACCGAGTATGTACCTGCTTCGACCTTCAAAATGCTTAATGCTTTGATCGGCCTTGAGCACCATAAGGCAACCACCACAGAAGTATTTAAGTGGGATGGTAAAAAAAGGTTATTCCCAGAATGGGAAAAGGACATGACCCTAGGCGATGCCATGAAAGCTTCCGCTATTCCAGTTTATCAAGATTTAGCTCGTCGTATTGGACTTGAGCTCATGTCTAAGGAAGTGAAGCGTGTTGGTTATGGCAATGCAGATATCGGTACCCAAGTCGATAATTTTTGGCTGGTGGGTCCTTTAAAAATTACTCCTCAGCAAGAGGCACAGTTTGCTTACAAGCTAGCTAATAAAACGCTTCCATTTAGCCAAAAAGTCCAAGATGAAGTGCAATCCATGCTATTCATAGAAGAAAAGAATGGAAACAAAATATACGCAAAAAGTGGTTGGGGATGGGATGTAAACCCACAAGTAGGCTGGTTAACTGGATGGGTTGTTCAGCCTCAAGGGAATATTGTAGCGTTCTCCCTTAACTTAGAAATGAAAAAAGGAATACCTAG
gb|JX121125|+|0-858|ARO:3001197|SHV-158 [Klebsiella pneumoniae] 	0	803	16	819	858	1612535+	803	ATGCGTTATATTCGCCTGTGTATTATCACCCTGTGAGCCACCCTGCCGCTGGCGGTACACGCCAGCCCGCAGCCGCTTGAGCAAATTAAACAAAGCGAAAGCCAGCTGTCGGGCCGCGTAGGCATGATAGAAATGGATCTGGCCAGCGGCCGCACGCTGACCGCCTGGCGCGCCGATGAACGCTTTCCCATGATGAGCACCTTTAAAGTAGTGCTCTGCGGCGCAGTGCTGGCGCGGGTGGATGCCGGTGACGAACAGCTGGAGCGAAAGATCCACTATCGCCAGCAGGATCTGGTGGACTACTCGCCGGTCAGCGAAAAACACCTTGCCGACGGCATGACGGTCGGCGAACTCTGCGCCGCCGCCATTACCATGAGCGATAACAGCGCCGCCAATCTGCTGCTGGCCACCGTCGGCGGCCCCGCAGGATTGACTGCCTTTTTGCGCCAGATCGGCGACAACGTCACCCGCCTTGACCGCTGGGAAACGGAACTGAATGAGGCGCTTCCCGGCGACGCCCGCGACACCACTACCCCGGCCAGCATGGCCGCGACCCTGCGCAAGCTGCTGACCAGCCAGCGTCTGAGCGCCCGTTCGCAACGGCAGCTGCTGCAGTGGATGGTGGACGATCGGGTCGCCGGACCGTTGATCCGCTCCGTGCTGCCGGCGGGCTGGTTTATCGCCGATAAGACCGGAGCTAGCAAGCGGGGTGCGCGCGGGATTGTCGCCCTGCTTGGCCCGAATAACAAAGCAGAGCGCATTGTGGTGATTTATCTGCGGGATACGCCGGCGAGCATGGCCGA
gb|LT985229.1|+|36107-36968|ARO:3001063|SHV-4 [Escherichia coli] 	0	806	16	822	861	1612535+	806	ATGCGTTATATTCGCCTGTGTATTATCACCCTGTGAGCCACCCTGCCGCTGGCGGTACACGCCAGCCCGCAGCCGCTTGAGCAAATTAAACAAAGCGAAAGCCAGCTGTCGGGCCGCGTAGGCATGATAGAAATGGATCTGGCCAGCGGCCGCACGCTGACCGCCTGGCGCGCCGATGAACGCTTTCCCATGATGAGCACCTTTAAAGTAGTGCTCTGCGGCGCAGTGCTGGCGCGGGTGGATGCCGGTGACGAACAGCTGGAGCGAAAGATCCACTATCGCCAGCAGGATCTGGTGGACTACTCGCCGGTCAGCGAAAAACACCTTGCCGACGGCATGACGGTCGGCGAACTCTGCGCCGCCGCCATTACCATGAGCGATAACAGCGCCGCCAATCTGCTGCTGGCCACCGTCGGCGGCCCCGCAGGATTGACTGCCTTTTTGCGCCAGATCGGCGACAACGTCACCCGCCTTGACCGCTGGGAAACGGAACTGAATGAGGCGCTTCCCGGCGACGCCCGCGACACCACTACCCCGGCCAGCATGGCCGCGACCCTGCGCAAGCTGCTGACCAGCCAGCGTCTGAGCGCCCGTTCGCAACGGCAGCTGCTGCAGTGGATGGTGGACGATCGGGTCGCCGGACCGTTGATCCGCTCCGTGCTGCCGGCGGGCTGGTTTATCGCCGATAAGACCGGAGCTAGCAAGCGGGGTGCGCGCGGGATTGTCGCCCTGCTTGGCCCGAATAACAAAGCAGAGCGCATTGTGGTGATTTATCTGCGGGATACGCCGGCGAGCATGGCCGAGCG
gb|NWUK01000007.1|-|12139-12964|ARO:3001531|OXA-343 [Acinetobacter baumannii] 	0	770	54149	54919	825	246080-	770	ATGAACATTAAAGCACTCTTACTTATAACAAGCGCTATTTTTATTTCAGCCTGCTCACCTTATATAGTGACTGCTAATCCAAATCACAGCGCTTCAAAATCTGATGTAAAAGCAGAGAAAATTAAAAATTTATTTAACGAAGCACACACTACGGGTGTTTTAGTTATCCAACAAGGCCAAACTCAACAAAGCTATGGTAATGATCTTGCTCGTGCTTCGACCGAGTATGTACCTGCTTCGACCTTCAAAATGCTTAATGCTTTGATCGGCCTTGAGCACCATAAGGCAACCACCACAGAAGTATTTAAGTGGGATGGTAAAAAAAGGTTATTCCCAGAATGGGAAAAGGACATGACCCTAGGCGATGCCATGAAAGCTTCCGCTATTCCAGTTTATCAAGATTTAGCTCGTCGTATTGGACTTGAGCTCATGTCTAAGGAAGTGAAGCGTGTTGGTTATGGCAATGCAGATATCGGTACCCAAGTCGATAATTTTTGGCTGGTGGGTCCTTTAAAAATTACTCCTCAGCAAGAGGCACAGTTTGCTTACAAGCTAGCTAATAAAACGCTTCCATTTAGCCAAAAAGTCCAAGATGAAGTGCAATCCATGCTATTCATAGAAGAAAAGAATGGAAACAAAATATACGCAAAAAGTGGTTGGGGATGGGATGTAAACCCACAAGTAGGCTGGTTAACTGGATGGGTTGTTCAGCCTCAAGGGAATATTGTAGCGTTCTCCCTTAACTTAGAAATGAAAAAAGGAATACCTAG
gb|EU652244.1|+|0-1152|ARO:3003871|ADC-39 [Acinetobacter baumannii] 	0	1097	63	1160	1152	126080+	1097	ATGCGATTTAAAAAAATTTCTTGTCTACTTTTATCCCCGCTTTTTATTTTTAGTACCTCAATTTATGCGGGCAATACACCAAAAGACCAAGAAATTAAAAAACTGGTAGATCAAAACTTTAAACCGTTATTAGAAAAATATGATGTGCCAGGTATGGCTGTGGGTGTTATTCAAAATAATAAAAAGTATGAAATGTATTATGGTCTTCAATCTGTTCAAGATAAAAAAGCCGTAAATAGCAGTACTATTTTTGAGCTAGGTTCTGTCAGTAAATTATTTACCGCGACAGCAGGTGGATATGCAAAAAATAAAGGAAAAATCTCTTTTGACGATACGCCTGGTAAGTATTGGAAAGAACTAAAAAATACACCGATTGACCAAGTTAACTTACTTCAACTCGCGACGTATACAAGTGGTAACCTTGCCTTGCAATTTCCAGATGAAGTAAAAACAGATCAGCAAGTTTTAACATTTTTTAAAGACTGGAAACCTAAAAACTCAATCGGTGAATATCGACAATATTCAAACCCAAGCATTGGTTTATTTGGAAAAGTTGTAGCTTTGTCTATGAATAAACCTTTCGACCAAGTCTTAGAAAAAACAATTTTTCCGGCCCTTGGCTTAAAACATAGCTATGTAAATGTACCTAAGACCCAGATGCAAAACTATGCTTTTGGCTATAACCAAGAAAATCAGCCGATTCGAGTTAACCCCGGCCCACTCGATGCCCCAGCATATGGCGTCAAATCGACACTACCCGACATGTTGAGTTTTATTCATGCCAACCTAAATCCACAAAAATATCCAGCAGATATTCAACGGGCAATTAATGAAACACATCAGGGTCGCTATCAAGTAAATACCATGTATCAGGCACTCGGTTGGGAAGAGTTTTCTTATCCGGCAACGTTACAAACTTTATTAGACAGTAATTCAGAACAGATTGTGATGAAACCTAATAAAGTGACTGCTATTTCAAAGGAACCTTCAGTTAAGATGTACCATAAAACTGGCTCAACTACCGGTTTCGGAACATATGTGGTGTTTATTCCTAAAGAAAATATTGGTTTAGTCATGTTAACCAATAAACGTATTCC
gb|DQ328802|+|0-861|ARO:3001140|SHV-86 [Klebsiella pneumoniae] 	0	806	16	822	861	1612535+	806	ATGCGTTATATTCGCCTGTGTATTATCACCCTGTGAGCCACCCTGCCGCTGGCGGTACACGCCAGCCCGCAGCCGCTTGAGCAAATTAAACAAAGCGAAAGCCAGCTGTCGGGCCGCGTAGGCATGATAGAAATGGATCTGGCCAGCGGCCGCACGCTGACCGCCTGGCGCGCCGATGAACGCTTTCCCATGATGAGCACCTTTAAAGTAGTGCTCTGCGGCGCAGTGCTGGCGCGGGTGGATGCCGGTGACGAACAGCTGGAGCGAAAGATCCACTATCGCCAGCAGGATCTGGTGGACTACTCGCCGGTCAGCGAAAAACACCTTGCCGACGGCATGACGGTCGGCGAACTCTGCGCCGCCGCCATTACCATGAGCGATAACAGCGCCGCCAATCTGCTGCTGGCCACCGTCGGCGGCCCCGCAGGATTGACTGCCTTTTTGCGCCAGATCGGCGACAACGTCACCCGCCTTGACCGCTGGGAAACGGAACTGAATGAGGCGCTTCCCGGCGACGCCCGCGACACCACTACCCCGGCCAGCATGGCCGCGACCCTGCGCAAGCTGCTGACCAGCCAGCGTCTGAGCGCCCGTTCGCAACGGCAGCTGCTGCAGTGGATGGTGGACGATCGGGTCGCCGGACCGTTGATCCGCTCCGTGCTGCCGGCGGGCTGGTTTATCGCCGATAAGACCGGAGCTAGCAAGCGGGGTGCGCGCGGGATTGTCGCCCTGCTTGGCCCGAATAACAAAGCAGAGCGCATTGTGGTGATTTATCTGCGGGATACGCCGGCGAGCATGGCCGAGCG
gb|AF535128|+|0-861|ARO:3001098|SHV-40 [Klebsiella pneumoniae] 	0	806	16	822	861	1612535+	806	ATGCGTTATATTCGCCTGTGTATTATCACCCTGTGAGCCACCCTGCCGCTGGCGGTACACGCCAGCCCGCAGCCGCTTGAGCAAATTAAACAAAGCGAAAGCCAGCTGTCGGGCCGCGTAGGCATGATAGAAATGGATCTGGCCAGCGGCCGCACGCTGACCGCCTGGCGCGCCGATGAACGCTTTCCCATGATGAGCACCTTTAAAGTAGTGCTCTGCGGCGCAGTGCTGGCGCGGGTGGATGCCGGTGACGAACAGCTGGAGCGAAAGATCCACTATCGCCAGCAGGATCTGGTGGACTACTCGCCGGTCAGCGAAAAACACCTTGCCGACGGCATGACGGTCGGCGAACTCTGCGCCGCCGCCATTACCATGAGCGATAACAGCGCCGCCAATCTGCTGCTGGCCACCGTCGGCGGCCCCGCAGGATTGACTGCCTTTTTGCGCCAGATCGGCGACAACGTCACCCGCCTTGACCGCTGGGAAACGGAACTGAATGAGGCGCTTCCCGGCGACGCCCGCGACACCACTACCCCGGCCAGCATGGCCGCGACCCTGCGCAAGCTGCTGACCAGCCAGCGTCTGAGCGCCCGTTCGCAACGGCAGCTGCTGCAGTGGATGGTGGACGATCGGGTCGCCGGACCGTTGATCCGCTCCGTGCTGCCGGCGGGCTGGTTTATCGCCGATAAGACCGGAGCTAGCAAGCGGGGTGCGCGCGGGATTGTCGCCCTGCTTGGCCCGAATAACAAAGCAGAGCGCATTGTGGTGATTTATCTGCGGGATACGCCGGCGAGCATGGCCGAGCG
gb|HM113560|+|0-825|ARO:3001658|OXA-174 [Acinetobacter baumannii] 	0	770	54149	54919	825	246080-	770	ATGAACATTAAAGCACTCTTACTTATAACAAGCGCTATTTTTATTTCAGCCTGCTCACCTTATATAGTGACTGCTAATCCAAATCACAGCGCTTCAAAATCTGATGTAAAAGCAGAGAAAATTAAAAATTTATTTAACGAAGCACACACTACGGGTGTTTTAGTTATCCAACAAGGCCAAACTCAACAAAGCTATGGTAATGATCTTGCTCGTGCTTCGACCGAGTATGTACCTGCTTCGACCTTCAAAATGCTTAATGCTTTGATCGGCCTTGAGCACCATAAGGCAACCACCACAGAAGTATTTAAGTGGGATGGTAAAAAAAGGTTATTCCCAGAATGGGAAAAGGACATGACCCTAGGCGATGCCATGAAAGCTTCCGCTATTCCAGTTTATCAAGATTTAGCTCGTCGTATTGGACTTGAGCTCATGTCTAAGGAAGTGAAGCGTGTTGGTTATGGCAATGCAGATATCGGTACCCAAGTCGATAATTTTTGGCTGGTGGGTCCTTTAAAAATTACTCCTCAGCAAGAGGCACAGTTTGCTTACAAGCTAGCTAATAAAACGCTTCCATTTAGCCAAAAAGTCCAAGATGAAGTGCAATCCATGCTATTCATAGAAGAAAAGAATGGAAACAAAATATACGCAAAAAGTGGTTGGGGATGGGATGTAAACCCACAAGTAGGCTGGTTAACTGGATGGGTTGTTCAGCCTCAAGGGAATATTGTAGCGTTCTCCCTTAACTTAGAAATGAAAAAAGGAATACCTAG
gb|JX121126|+|0-858|ARO:3001198|SHV-159 [Klebsiella pneumoniae] 	0	803	16	819	858	1612535+	803	ATGCGTTATATTCGCCTGTGTATTATCACCCTGTGAGCCACCCTGCCGCTGGCGGTACACGCCAGCCCGCAGCCGCTTGAGCAAATTAAACAAAGCGAAAGCCAGCTGTCGGGCCGCGTAGGCATGATAGAAATGGATCTGGCCAGCGGCCGCACGCTGACCGCCTGGCGCGCCGATGAACGCTTTCCCATGATGAGCACCTTTAAAGTAGTGCTCTGCGGCGCAGTGCTGGCGCGGGTGGATGCCGGTGACGAACAGCTGGAGCGAAAGATCCACTATCGCCAGCAGGATCTGGTGGACTACTCGCCGGTCAGCGAAAAACACCTTGCCGACGGCATGACGGTCGGCGAACTCTGCGCCGCCGCCATTACCATGAGCGATAACAGCGCCGCCAATCTGCTGCTGGCCACCGTCGGCGGCCCCGCAGGATTGACTGCCTTTTTGCGCCAGATCGGCGACAACGTCACCCGCCTTGACCGCTGGGAAACGGAACTGAATGAGGCGCTTCCCGGCGACGCCCGCGACACCACTACCCCGGCCAGCATGGCCGCGACCCTGCGCAAGCTGCTGACCAGCCAGCGTCTGAGCGCCCGTTCGCAACGGCAGCTGCTGCAGTGGATGGTGGACGATCGGGTCGCCGGACCGTTGATCCGCTCCGTGCTGCCGGCGGGCTGGTTTATCGCCGATAAGACCGGAGCTAGCAAGCGGGGTGCGCGCGGGATTGTCGCCCTGCTTGGCCCGAATAACAAAGCAGAGCGCATTGTGGTGATTTATCTGCGGGATACGCCGGCGAGCATGGCCGA
gb|KF048917.1|+|0-825|ARO:3001532|OXA-344 [Acinetobacter baumannii] 	0	770	54149	54919	825	246080-	770	ATGAACATTAAAGCACTCTTACTTATAACAAGCGCTATTTTTATTTCAGCCTGCTCACCTTATATAGTGACTGCTAATCCAAATCACAGCGCTTCAAAATCTGATGTAAAAGCAGAGAAAATTAAAAATTTATTTAACGAAGCACACACTACGGGTGTTTTAGTTATCCAACAAGGCCAAACTCAACAAAGCTATGGTAATGATCTTGCTCGTGCTTCGACCGAGTATGTACCTGCTTCGACCTTCAAAATGCTTAATGCTTTGATCGGCCTTGAGCACCATAAGGCAACCACCACAGAAGTATTTAAGTGGGATGGTAAAAAAAGGTTATTCCCAGAATGGGAAAAGGACATGACCCTAGGCGATGCCATGAAAGCTTCCGCTATTCCAGTTTATCAAGATTTAGCTCGTCGTATTGGACTTGAGCTCATGTCTAAGGAAGTGAAGCGTGTTGGTTATGGCAATGCAGATATCGGTACCCAAGTCGATAATTTTTGGCTGGTGGGTCCTTTAAAAATTACTCCTCAGCAAGAGGCACAGTTTGCTTACAAGCTAGCTAATAAAACGCTTCCATTTAGCCAAAAAGTCCAAGATGAAGTGCAATCCATGCTATTCATAGAAGAAAAGAATGGAAACAAAATATACGCAAAAAGTGGTTGGGGATGGGATGTAAACCCACAAGTAGGCTGGTTAACTGGATGGGTTGTTCAGCCTCAAGGGAATATTGTAGCGTTCTCCCTTAACTTAGAAATGAAAAAAGGAATACCTAG
gb|AF535129|+|0-861|ARO:3001099|SHV-41 [Klebsiella pneumoniae] 	0	806	16	822	861	1612535+	806	ATGCGTTATATTCGCCTGTGTATTATCACCCTGTGAGCCACCCTGCCGCTGGCGGTACACGCCAGCCCGCAGCCGCTTGAGCAAATTAAACAAAGCGAAAGCCAGCTGTCGGGCCGCGTAGGCATGATAGAAATGGATCTGGCCAGCGGCCGCACGCTGACCGCCTGGCGCGCCGATGAACGCTTTCCCATGATGAGCACCTTTAAAGTAGTGCTCTGCGGCGCAGTGCTGGCGCGGGTGGATGCCGGTGACGAACAGCTGGAGCGAAAGATCCACTATCGCCAGCAGGATCTGGTGGACTACTCGCCGGTCAGCGAAAAACACCTTGCCGACGGCATGACGGTCGGCGAACTCTGCGCCGCCGCCATTACCATGAGCGATAACAGCGCCGCCAATCTGCTGCTGGCCACCGTCGGCGGCCCCGCAGGATTGACTGCCTTTTTGCGCCAGATCGGCGACAACGTCACCCGCCTTGACCGCTGGGAAACGGAACTGAATGAGGCGCTTCCCGGCGACGCCCGCGACACCACTACCCCGGCCAGCATGGCCGCGACCCTGCGCAAGCTGCTGACCAGCCAGCGTCTGAGCGCCCGTTCGCAACGGCAGCTGCTGCAGTGGATGGTGGACGATCGGGTCGCCGGACCGTTGATCCGCTCCGTGCTGCCGGCGGGCTGGTTTATCGCCGATAAGACCGGAGCTAGCAAGCGGGGTGCGCGCGGGATTGTCGCCCTGCTTGGCCCGAATAACAAAGCAGAGCGCATTGTGGTGATTTATCTGCGGGATACGCCGGCGAGCATGGCCGAGCG
gb|KF048918.1|+|0-825|ARO:3001533|OXA-345 [Acinetobacter baumannii] 	0	770	54149	54919	825	246080-	770	ATGAACATTAAAGCACTCTTACTTATAACAAGCGCTATTTTTATTTCAGCCTGCTCACCTTATATAGTGACTGCTAATCCAAATCACAGCGCTTCAAAATCTGATGTAAAAGCAGAGAAAATTAAAAATTTATTTAACGAAGCACACACTACGGGTGTTTTAGTTATCCAACAAGGCCAAACTCAACAAAGCTATGGTAATGATCTTGCTCGTGCTTCGACCGAGTATGTACCTGCTTCGACCTTCAAAATGCTTAATGCTTTGATCGGCCTTGAGCACCATAAGGCAACCACCACAGAAGTATTTAAGTGGGATGGTAAAAAAAGGTTATTCCCAGAATGGGAAAAGGACATGACCCTAGGCGATGCCATGAAAGCTTCCGCTATTCCAGTTTATCAAGATTTAGCTCGTCGTATTGGACTTGAGCTCATGTCTAAGGAAGTGAAGCGTGTTGGTTATGGCAATGCAGATATCGGTACCCAAGTCGATAATTTTTGGCTGGTGGGTCCTTTAAAAATTACTCCTCAGCAAGAGGCACAGTTTGCTTACAAGCTAGCTAATAAAACGCTTCCATTTAGCCAAAAAGTCCAAGATGAAGTGCAATCCATGCTATTCATAGAAGAAAAGAATGGAAACAAAATATACGCAAAAAGTGGTTGGGGATGGGATGTAAACCCACAAGTAGGCTGGTTAACTGGATGGGTTGTTCAGCCTCAAGGGAATATTGTAGCGTTCTCCCTTAACTTAGAAATGAAAAAAGGAATACCTAG
gb|HM113561|+|0-825|ARO:3001659|OXA-175 [Acinetobacter baumannii] 	0	770	54149	54919	825	246080-	770	ATGAACATTAAAGCACTCTTACTTATAACAAGCGCTATTTTTATTTCAGCCTGCTCACCTTATATAGTGACTGCTAATCCAAATCACAGCGCTTCAAAATCTGATGTAAAAGCAGAGAAAATTAAAAATTTATTTAACGAAGCACACACTACGGGTGTTTTAGTTATCCAACAAGGCCAAACTCAACAAAGCTATGGTAATGATCTTGCTCGTGCTTCGACCGAGTATGTACCTGCTTCGACCTTCAAAATGCTTAATGCTTTGATCGGCCTTGAGCACCATAAGGCAACCACCACAGAAGTATTTAAGTGGGATGGTAAAAAAAGGTTATTCCCAGAATGGGAAAAGGACATGACCCTAGGCGATGCCATGAAAGCTTCCGCTATTCCAGTTTATCAAGATTTAGCTCGTCGTATTGGACTTGAGCTCATGTCTAAGGAAGTGAAGCGTGTTGGTTATGGCAATGCAGATATCGGTACCCAAGTCGATAATTTTTGGCTGGTGGGTCCTTTAAAAATTACTCCTCAGCAAGAGGCACAGTTTGCTTACAAGCTAGCTAATAAAACGCTTCCATTTAGCCAAAAAGTCCAAGATGAAGTGCAATCCATGCTATTCATAGAAGAAAAGAATGGAAACAAAATATACGCAAAAAGTGGTTGGGGATGGGATGTAAACCCACAAGTAGGCTGGTTAACTGGATGGGTTGTTCAGCCTCAAGGGAATATTGTAGCGTTCTCCCTTAACTTAGAAATGAAAAAAGGAATACCTAG
gb|AF072684|+|117-993|ARO:3001075|SHV-16 [Klebsiella pneumoniae] 	0	821	16	822	876	1612535+	806	ATGCGTTATATTCGCCTGTGTATTATCACCCTGTGAGCCACCCTGCCGCTGGCGGTACACGCCAGCCCGCAGCCGCTTGAGCAAATTAAACAAAGCGAAAGCCAGCTGTCGGGCCGCGTAGGCATGATAGAAATGGATCTGGCCAGCGGCCGCACGCTGACCGCCTGGCGCGCCGATGAACGCTTTCCCATGATGAGCACCTTTAAAGTAGTGCTCTGCGGCGCAGTGCTGGCGCGGGTGGATGCCGGTGACGAACAGCTGGAGCGAAAGATCCACTATCGCCAGCAGGATCTGGTGGACTACTCGCCGGTCAGCGAAAAACACCTTGCCGACGGCATGACGGTCGGCGAACTCTGCGCCGCCGCCATTACCATGAGCGATAACAGCGCCGCCAATCTGCTGCTGGCCACCGTCGGCGGCCCCGCAGGATTGACTGCCTTTTTGCGCCAGATCGGCGACAACGTCACCCGCCTTGACCGCTGGGAAACGGAACTGAATGAGGCGCTTCCCGGCGACGCCCGCGACACCACTACCCCGGCCAGCATGGCCGCGACCCTGCGCAAGCTGCTGACCAGCCAGCGTCTGAGCGCCCGTTCGCAACGGCAGCTGCTGCAGTGGATGGTGGACGATCGGGTCGCCGGACCGTTGATCCGCTCCGTGCTGCCGGCGGGCTGGTTTATCGCCGATAAGACCGGAGCTAGCAAGCGGGGTGCGCGCGGGATTGTCGCCCTGCTTGGCCCGAATAACAAAGCAGAGCGCATTGTGGTGATTTATCTGCGGGATACGCCGGCGAGCATGGCCGAGCG
gb|DQ193536|+|0-861|ARO:3001141|SHV-89 [Klebsiella pneumoniae] 	0	806	16	822	861	1612535+	806	ATGCGTTATATTCGCCTGTGTATTATCACCCTGTGAGCCACCCTGCCGCTGGCGGTACACGCCAGCCCGCAGCCGCTTGAGCAAATTAAACAAAGCGAAAGCCAGCTGTCGGGCCGCGTAGGCATGATAGAAATGGATCTGGCCAGCGGCCGCACGCTGACCGCCTGGCGCGCCGATGAACGCTTTCCCATGATGAGCACCTTTAAAGTAGTGCTCTGCGGCGCAGTGCTGGCGCGGGTGGATGCCGGTGACGAACAGCTGGAGCGAAAGATCCACTATCGCCAGCAGGATCTGGTGGACTACTCGCCGGTCAGCGAAAAACACCTTGCCGACGGCATGACGGTCGGCGAACTCTGCGCCGCCGCCATTACCATGAGCGATAACAGCGCCGCCAATCTGCTGCTGGCCACCGTCGGCGGCCCCGCAGGATTGACTGCCTTTTTGCGCCAGATCGGCGACAACGTCACCCGCCTTGACCGCTGGGAAACGGAACTGAATGAGGCGCTTCCCGGCGACGCCCGCGACACCACTACCCCGGCCAGCATGGCCGCGACCCTGCGCAAGCTGCTGACCAGCCAGCGTCTGAGCGCCCGTTCGCAACGGCAGCTGCTGCAGTGGATGGTGGACGATCGGGTCGCCGGACCGTTGATCCGCTCCGTGCTGCCGGCGGGCTGGTTTATCGCCGATAAGACCGGAGCTAGCAAGCGGGGTGCGCGCGGGATTGTCGCCCTGCTTGGCCCGAATAACAAAGCAGAGCGCATTGTGGTGATTTATCTGCGGGATACGCCGGCGAGCATGGCCGAGCG
gb|CU468230.2|+|1959577-1960402|ARO:3001620|OXA-75 [Acinetobacter baumannii SDF] 	0	770	54149	54919	825	246080-	770	ATGAACATTAAAGCACTCTTACTTATAACAAGCGCTATTTTTATTTCAGCCTGCTCACCTTATATAGTGACTGCTAATCCAAATCACAGCGCTTCAAAATCTGATGTAAAAGCAGAGAAAATTAAAAATTTATTTAACGAAGCACACACTACGGGTGTTTTAGTTATCCAACAAGGCCAAACTCAACAAAGCTATGGTAATGATCTTGCTCGTGCTTCGACCGAGTATGTACCTGCTTCGACCTTCAAAATGCTTAATGCTTTGATCGGCCTTGAGCACCATAAGGCAACCACCACAGAAGTATTTAAGTGGGATGGTAAAAAAAGGTTATTCCCAGAATGGGAAAAGGACATGACCCTAGGCGATGCCATGAAAGCTTCCGCTATTCCAGTTTATCAAGATTTAGCTCGTCGTATTGGACTTGAGCTCATGTCTAAGGAAGTGAAGCGTGTTGGTTATGGCAATGCAGATATCGGTACCCAAGTCGATAATTTTTGGCTGGTGGGTCCTTTAAAAATTACTCCTCAGCAAGAGGCACAGTTTGCTTACAAGCTAGCTAATAAAACGCTTCCATTTAGCCAAAAAGTCCAAGATGAAGTGCAATCCATGCTATTCATAGAAGAAAAGAATGGAAACAAAATATACGCAAAAAGTGGTTGGGGATGGGATGTAAACCCACAAGTAGGCTGGTTAACTGGATGGGTTGTTCAGCCTCAAGGGAATATTGTAGCGTTCTCCCTTAACTTAGAAATGAAAAAAGGAATACCTAG
gb|KF048919.1|+|0-825|ARO:3001534|OXA-346 [Acinetobacter baumannii] 	0	770	54149	54919	825	246080-	770	ATGAACATTAAAGCACTCTTACTTATAACAAGCGCTATTTTTATTTCAGCCTGCTCACCTTATATAGTGACTGCTAATCCAAATCACAGCGCTTCAAAATCTGATGTAAAAGCAGAGAAAATTAAAAATTTATTTAACGAAGCACACACTACGGGTGTTTTAGTTATCCAACAAGGCCAAACTCAACAAAGCTATGGTAATGATCTTGCTCGTGCTTCGACCGAGTATGTACCTGCTTCGACCTTCAAAATGCTTAATGCTTTGATCGGCCTTGAGCACCATAAGGCAACCACCACAGAAGTATTTAAGTGGGATGGTAAAAAAAGGTTATTCCCAGAATGGGAAAAGGACATGACCCTAGGCGATGCCATGAAAGCTTCCGCTATTCCAGTTTATCAAGATTTAGCTCGTCGTATTGGACTTGAGCTCATGTCTAAGGAAGTGAAGCGTGTTGGTTATGGCAATGCAGATATCGGTACCCAAGTCGATAATTTTTGGCTGGTGGGTCCTTTAAAAATTACTCCTCAGCAAGAGGCACAGTTTGCTTACAAGCTAGCTAATAAAACGCTTCCATTTAGCCAAAAAGTCCAAGATGAAGTGCAATCCATGCTATTCATAGAAGAAAAGAATGGAAACAAAATATACGCAAAAAGTGGTTGGGGATGGGATGTAAACCCACAAGTAGGCTGGTTAACTGGATGGGTTGTTCAGCCTCAAGGGAATATTGTAGCGTTCTCCCTTAACTTAGAAATGAAAAAAGGAATACCTAG
gb|AY178996.1|+|0-1152|ARO:3003850|ADC-4 [Acinetobacter baumannii] 	0	1097	63	1160	1152	126080+	1097	ATGCGATTTAAAAAAATTTCTTGTCTACTTTTATCCCCGCTTTTTATTTTTAGTACCTCAATTTATGCGGGCAATACACCAAAAGACCAAGAAATTAAAAAACTGGTAGATCAAAACTTTAAACCGTTATTAGAAAAATATGATGTGCCAGGTATGGCTGTGGGTGTTATTCAAAATAATAAAAAGTATGAAATGTATTATGGTCTTCAATCTGTTCAAGATAAAAAAGCCGTAAATAGCAGTACTATTTTTGAGCTAGGTTCTGTCAGTAAATTATTTACCGCGACAGCAGGTGGATATGCAAAAAATAAAGGAAAAATCTCTTTTGACGATACGCCTGGTAAGTATTGGAAAGAACTAAAAAATACACCGATTGACCAAGTTAACTTACTTCAACTCGCGACGTATACAAGTGGTAACCTTGCCTTGCAATTTCCAGATGAAGTAAAAACAGATCAGCAAGTTTTAACATTTTTTAAAGACTGGAAACCTAAAAACTCAATCGGTGAATATCGACAATATTCAAACCCAAGCATTGGTTTATTTGGAAAAGTTGTAGCTTTGTCTATGAATAAACCTTTCGACCAAGTCTTAGAAAAAACAATTTTTCCGGCCCTTGGCTTAAAACATAGCTATGTAAATGTACCTAAGACCCAGATGCAAAACTATGCTTTTGGCTATAACCAAGAAAATCAGCCGATTCGAGTTAACCCCGGCCCACTCGATGCCCCAGCATATGGCGTCAAATCGACACTACCCGACATGTTGAGTTTTATTCATGCCAACCTAAATCCACAAAAATATCCAGCAGATATTCAACGGGCAATTAATGAAACACATCAGGGTCGCTATCAAGTAAATACCATGTATCAGGCACTCGGTTGGGAAGAGTTTTCTTATCCGGCAACGTTACAAACTTTATTAGACAGTAATTCAGAACAGATTGTGATGAAACCTAATAAAGTGACTGCTATTTCAAAGGAACCTTCAGTTAAGATGTACCATAAAACTGGCTCAACTACCGGTTTCGGAACATATGTGGTGTTTATTCCTAAAGAAAATATTGGTTTAGTCATGTTAACCAATAAACGTATTCC
gb|AY949203|+|0-825|ARO:3001621|OXA-76 [Acinetobacter baumannii] 	0	770	54149	54919	825	246080-	770	ATGAACATTAAAGCACTCTTACTTATAACAAGCGCTATTTTTATTTCAGCCTGCTCACCTTATATAGTGACTGCTAATCCAAATCACAGCGCTTCAAAATCTGATGTAAAAGCAGAGAAAATTAAAAATTTATTTAACGAAGCACACACTACGGGTGTTTTAGTTATCCAACAAGGCCAAACTCAACAAAGCTATGGTAATGATCTTGCTCGTGCTTCGACCGAGTATGTACCTGCTTCGACCTTCAAAATGCTTAATGCTTTGATCGGCCTTGAGCACCATAAGGCAACCACCACAGAAGTATTTAAGTGGGATGGTAAAAAAAGGTTATTCCCAGAATGGGAAAAGGACATGACCCTAGGCGATGCCATGAAAGCTTCCGCTATTCCAGTTTATCAAGATTTAGCTCGTCGTATTGGACTTGAGCTCATGTCTAAGGAAGTGAAGCGTGTTGGTTATGGCAATGCAGATATCGGTACCCAAGTCGATAATTTTTGGCTGGTGGGTCCTTTAAAAATTACTCCTCAGCAAGAGGCACAGTTTGCTTACAAGCTAGCTAATAAAACGCTTCCATTTAGCCAAAAAGTCCAAGATGAAGTGCAATCCATGCTATTCATAGAAGAAAAGAATGGAAACAAAATATACGCAAAAAGTGGTTGGGGATGGGATGTAAACCCACAAGTAGGCTGGTTAACTGGATGGGTTGTTCAGCCTCAAGGGAATATTGTAGCGTTCTCCCTTAACTTAGAAATGAAAAAAGGAATACCTAG
gb|HM113562|+|0-825|ARO:3001660|OXA-176 [Acinetobacter baumannii] 	0	770	54149	54919	825	246080-	770	ATGAACATTAAAGCACTCTTACTTATAACAAGCGCTATTTTTATTTCAGCCTGCTCACCTTATATAGTGACTGCTAATCCAAATCACAGCGCTTCAAAATCTGATGTAAAAGCAGAGAAAATTAAAAATTTATTTAACGAAGCACACACTACGGGTGTTTTAGTTATCCAACAAGGCCAAACTCAACAAAGCTATGGTAATGATCTTGCTCGTGCTTCGACCGAGTATGTACCTGCTTCGACCTTCAAAATGCTTAATGCTTTGATCGGCCTTGAGCACCATAAGGCAACCACCACAGAAGTATTTAAGTGGGATGGTAAAAAAAGGTTATTCCCAGAATGGGAAAAGGACATGACCCTAGGCGATGCCATGAAAGCTTCCGCTATTCCAGTTTATCAAGATTTAGCTCGTCGTATTGGACTTGAGCTCATGTCTAAGGAAGTGAAGCGTGTTGGTTATGGCAATGCAGATATCGGTACCCAAGTCGATAATTTTTGGCTGGTGGGTCCTTTAAAAATTACTCCTCAGCAAGAGGCACAGTTTGCTTACAAGCTAGCTAATAAAACGCTTCCATTTAGCCAAAAAGTCCAAGATGAAGTGCAATCCATGCTATTCATAGAAGAAAAGAATGGAAACAAAATATACGCAAAAAGTGGTTGGGGATGGGATGTAAACCCACAAGTAGGCTGGTTAACTGGATGGGTTGTTCAGCCTCAAGGGAATATTGTAGCGTTCTCCCTTAACTTAGAAATGAAAAAAGGAATACCTAG
gb|JX121127|+|0-861|ARO:3001199|SHV-160 [Klebsiella pneumoniae] 	0	806	16	822	861	1612535+	806	ATGCGTTATATTCGCCTGTGTATTATCACCCTGTGAGCCACCCTGCCGCTGGCGGTACACGCCAGCCCGCAGCCGCTTGAGCAAATTAAACAAAGCGAAAGCCAGCTGTCGGGCCGCGTAGGCATGATAGAAATGGATCTGGCCAGCGGCCGCACGCTGACCGCCTGGCGCGCCGATGAACGCTTTCCCATGATGAGCACCTTTAAAGTAGTGCTCTGCGGCGCAGTGCTGGCGCGGGTGGATGCCGGTGACGAACAGCTGGAGCGAAAGATCCACTATCGCCAGCAGGATCTGGTGGACTACTCGCCGGTCAGCGAAAAACACCTTGCCGACGGCATGACGGTCGGCGAACTCTGCGCCGCCGCCATTACCATGAGCGATAACAGCGCCGCCAATCTGCTGCTGGCCACCGTCGGCGGCCCCGCAGGATTGACTGCCTTTTTGCGCCAGATCGGCGACAACGTCACCCGCCTTGACCGCTGGGAAACGGAACTGAATGAGGCGCTTCCCGGCGACGCCCGCGACACCACTACCCCGGCCAGCATGGCCGCGACCCTGCGCAAGCTGCTGACCAGCCAGCGTCTGAGCGCCCGTTCGCAACGGCAGCTGCTGCAGTGGATGGTGGACGATCGGGTCGCCGGACCGTTGATCCGCTCCGTGCTGCCGGCGGGCTGGTTTATCGCCGATAAGACCGGAGCTAGCAAGCGGGGTGCGCGCGGGATTGTCGCCCTGCTTGGCCCGAATAACAAAGCAGAGCGCATTGTGGTGATTTATCTGCGGGATACGCCGGCGAGCATGGCCGAGCG
gb|AF535130|+|0-861|ARO:3001100|SHV-42 [Klebsiella pneumoniae] 	0	806	16	822	861	1612535+	806	ATGCGTTATATTCGCCTGTGTATTATCACCCTGTGAGCCACCCTGCCGCTGGCGGTACACGCCAGCCCGCAGCCGCTTGAGCAAATTAAACAAAGCGAAAGCCAGCTGTCGGGCCGCGTAGGCATGATAGAAATGGATCTGGCCAGCGGCCGCACGCTGACCGCCTGGCGCGCCGATGAACGCTTTCCCATGATGAGCACCTTTAAAGTAGTGCTCTGCGGCGCAGTGCTGGCGCGGGTGGATGCCGGTGACGAACAGCTGGAGCGAAAGATCCACTATCGCCAGCAGGATCTGGTGGACTACTCGCCGGTCAGCGAAAAACACCTTGCCGACGGCATGACGGTCGGCGAACTCTGCGCCGCCGCCATTACCATGAGCGATAACAGCGCCGCCAATCTGCTGCTGGCCACCGTCGGCGGCCCCGCAGGATTGACTGCCTTTTTGCGCCAGATCGGCGACAACGTCACCCGCCTTGACCGCTGGGAAACGGAACTGAATGAGGCGCTTCCCGGCGACGCCCGCGACACCACTACCCCGGCCAGCATGGCCGCGACCCTGCGCAAGCTGCTGACCAGCCAGCGTCTGAGCGCCCGTTCGCAACGGCAGCTGCTGCAGTGGATGGTGGACGATCGGGTCGCCGGACCGTTGATCCGCTCCGTGCTGCCGGCGGGCTGGTTTATCGCCGATAAGACCGGAGCTAGCAAGCGGGGTGCGCGCGGGATTGTCGCCCTGCTTGGCCCGAATAACAAAGCAGAGCGCATTGTGGTGATTTATCTGCGGGATACGCCGGCGAGCATGGCCGAGCG
gb|HM113563|+|0-825|ARO:3001661|OXA-177 [Acinetobacter baumannii] 	0	770	54149	54919	825	246080-	770	ATGAACATTAAAGCACTCTTACTTATAACAAGCGCTATTTTTATTTCAGCCTGCTCACCTTATATAGTGACTGCTAATCCAAATCACAGCGCTTCAAAATCTGATGTAAAAGCAGAGAAAATTAAAAATTTATTTAACGAAGCACACACTACGGGTGTTTTAGTTATCCAACAAGGCCAAACTCAACAAAGCTATGGTAATGATCTTGCTCGTGCTTCGACCGAGTATGTACCTGCTTCGACCTTCAAAATGCTTAATGCTTTGATCGGCCTTGAGCACCATAAGGCAACCACCACAGAAGTATTTAAGTGGGATGGTAAAAAAAGGTTATTCCCAGAATGGGAAAAGGACATGACCCTAGGCGATGCCATGAAAGCTTCCGCTATTCCAGTTTATCAAGATTTAGCTCGTCGTATTGGACTTGAGCTCATGTCTAAGGAAGTGAAGCGTGTTGGTTATGGCAATGCAGATATCGGTACCCAAGTCGATAATTTTTGGCTGGTGGGTCCTTTAAAAATTACTCCTCAGCAAGAGGCACAGTTTGCTTACAAGCTAGCTAATAAAACGCTTCCATTTAGCCAAAAAGTCCAAGATGAAGTGCAATCCATGCTATTCATAGAAGAAAAGAATGGAAACAAAATATACGCAAAAAGTGGTTGGGGATGGGATGTAAACCCACAAGTAGGCTGGTTAACTGGATGGGTTGTTCAGCCTCAAGGGAATATTGTAGCGTTCTCCCTTAACTTAGAAATGAAAAAAGGAATACCTAG
gb|KR057746.1|+|0-1116|ARO:3004340|PDC-77 [Pseudomonas aeruginosa] 	3	1061	35594	36652	1116	232416+	1058	GAGGCCCCGGCGGATCGCCTGAAGGCACTGGTCGACGCCGCCGTACAACCGGTGATGAAGGCCAATGACATTCCGGGCCTGGCCGTAGCCATCAGCCTGAAAGGAGAACCGCATTACTTCAGCTATGGGCTGGCCTCGAAAGAGGACGGCCGCCGGGTGACGCCGGAGACCCTGTTCGAGATCGGCTCGGTGAGCAAGACCTTCACCGTCACCCTCGCCGGCTATGCCCTGGCCCAGGACAAGATGCGCCTCGACGACCGCGCCAGCCAGCACTGGCCGGCACTGCAGGGCAGCCGCTTCGACGGCATCAGCCTGCTCGACCTCGCGACCTATACCGCCGGCGGCTTGCCGCTGCAGTTCCCCGACTCGGTGCAGAAGGACCAGGCACAGATCCGCGACTACTACCGCCAGTGGCAGCCGACCTACGCGCCGGGCAGCCAGCGCCTCTATTCCAACCCGAGCATCGGCCTGTTCGGCTATCTCGCCGCGCGCAGCCTGGGCCAGCCGTTCGAACGGCTCATGGAGCAGCAATTGTTCCCGGCACTGGGCCTCGAACAGACCCACCTCGACGTGCCCGAGGCGGCGCTGGCGCAGTACGCCCAGGGCTACGGCAAGGACGACCGCCCGCTACGGGTCGGTCCCGGCCCGCTGGATGCCGAAGGCTACGGGGTGAAGACCAGCGCGGCCGACCTGCTGCGCTTCGTCGATGCCAACCTGCATCCGGAGCGCCTGGACAGGCCCTGGGCGCAGGCGCTCGATGCCACCCATCGCGGTTACTACAAGGTCGGCGACATGACCCAGGGCCTGGGCTGGGAAGCCTACGACTGGCCGATCTCCCTGAAGCGCCTGCAGGCCGGCAACTCGACGCCGATGGCGCTGCAACCACACAGGATCGCCAGGCTGCCCGCGCCACAGGCGCTGGAGGGCCAGCGCCTGCTGAACAAGACCGGCTCCACCAACGGCTTCGGCGCCTACGTGGCGTTCGTCCCGGGCCGCGACCTGGGCCTGGTGATCCTGGCCAACCGCAACTATCCCAATGCCGAGCGGGTGAAGATCGC
gb|HM113564|+|0-825|ARO:3001472|OXA-178 [Acinetobacter baumannii] 	0	770	54149	54919	825	246080-	770	ATGAACATTAAAGCACTCTTACTTATAACAAGCGCTATTTTTATTTCAGCCTGCTCACCTTATATAGTGACTGCTAATCCAAATCACAGCGCTTCAAAATCTGATGTAAAAGCAGAGAAAATTAAAAATTTATTTAACGAAGCACACACTACGGGTGTTTTAGTTATCCAACAAGGCCAAACTCAACAAAGCTATGGTAATGATCTTGCTCGTGCTTCGACCGAGTATGTACCTGCTTCGACCTTCAAAATGCTTAATGCTTTGATCGGCCTTGAGCACCATAAGGCAACCACCACAGAAGTATTTAAGTGGGATGGTAAAAAAAGGTTATTCCCAGAATGGGAAAAGGACATGACCCTAGGCGATGCCATGAAAGCTTCCGCTATTCCAGTTTATCAAGATTTAGCTCGTCGTATTGGACTTGAGCTCATGTCTAAGGAAGTGAAGCGTGTTGGTTATGGCAATGCAGATATCGGTACCCAAGTCGATAATTTTTGGCTGGTGGGTCCTTTAAAAATTACTCCTCAGCAAGAGGCACAGTTTGCTTACAAGCTAGCTAATAAAACGCTTCCATTTAGCCAAAAAGTCCAAGATGAAGTGCAATCCATGCTATTCATAGAAGAAAAGAATGGAAACAAAATATACGCAAAAAGTGGTTGGGGATGGGATGTAAACCCACAAGTAGGCTGGTTAACTGGATGGGTTGTTCAGCCTCAAGGGAATATTGTAGCGTTCTCCCTTAACTTAGAAATGAAAAAAGGAATACCTAG
gb|S82452|+|120-978|ARO:3001068|SHV-9 [Klebsiella pneumoniae] 	0	803	16	822	858	1612535+	806	ATGCGTTATATTCGCCTGTGTATTATCACCCTGTGAGCCACCCTGCCGCTGGCGGTACACGCCAGCCCGCAGCCGCTTGAGCAAATTAAACAAAGCGAAAGCCAGCTGTCGGGCCGCGTAGGCATGATAGAAATGGATCTGGCCAGCGGCCGCACGCTGACCGCCTGGCGCGCCGATGAACGCTTTCCCATGATGAGCACCTTTAAAGTAGTGCTCTGCGGCGCAGTGCTGGCGCGGGTGGATGCCGGTGACGAACAGCTGGAGCGAAAGATCCACTATCGCCAGCAGGATCTGGTGGACTACTCGCCGGTCAGCGAAAAACACCTTGCCGACGGCATGACGGTCGGCGAACTCTGCGCCGCCGCCATTACCATGAGCGATAACAGCGCCGCCAATCTGCTGCTGGCCACCGTCGGCGGCCCCGCAGGATTGACTGCCTTTTTGCGCCAGATCGGCGACAACGTCACCCGCCTTGACCGCTGGGAAACGGAACTGAATGAGGCGCTTCCCGGCGACGCCCGCGACACCACTACCCCGGCCAGCATGGCCGCGACCCTGCGCAAGCTGCTGACCAGCCAGCGTCTGAGCGCCCGTTCGCAACGGCAGCTGCTGCAGTGGATGGTGGACGATCGGGTCGCCGGACCGTTGATCCGCTCCGTGCTGCCGGCGGGCTGGTTTATCGCCGATAAGACCGGAGCTAGCAAGCGGGGTGCGCGCGGGATTGTCGCCCTGCTTGGCCCGAATAACAAAGCAGAGCGCATTGTGGTGATTTATCTGCGGGATACGCCGGCGAGCATGGCCGAGCG
gb|JX121128|+|0-861|ARO:3001200|SHV-161 [Klebsiella pneumoniae] 	0	806	16	822	861	1612535+	806	ATGCGTTATATTCGCCTGTGTATTATCACCCTGTGAGCCACCCTGCCGCTGGCGGTACACGCCAGCCCGCAGCCGCTTGAGCAAATTAAACAAAGCGAAAGCCAGCTGTCGGGCCGCGTAGGCATGATAGAAATGGATCTGGCCAGCGGCCGCACGCTGACCGCCTGGCGCGCCGATGAACGCTTTCCCATGATGAGCACCTTTAAAGTAGTGCTCTGCGGCGCAGTGCTGGCGCGGGTGGATGCCGGTGACGAACAGCTGGAGCGAAAGATCCACTATCGCCAGCAGGATCTGGTGGACTACTCGCCGGTCAGCGAAAAACACCTTGCCGACGGCATGACGGTCGGCGAACTCTGCGCCGCCGCCATTACCATGAGCGATAACAGCGCCGCCAATCTGCTGCTGGCCACCGTCGGCGGCCCCGCAGGATTGACTGCCTTTTTGCGCCAGATCGGCGACAACGTCACCCGCCTTGACCGCTGGGAAACGGAACTGAATGAGGCGCTTCCCGGCGACGCCCGCGACACCACTACCCCGGCCAGCATGGCCGCGACCCTGCGCAAGCTGCTGACCAGCCAGCGTCTGAGCGCCCGTTCGCAACGGCAGCTGCTGCAGTGGATGGTGGACGATCGGGTCGCCGGACCGTTGATCCGCTCCGTGCTGCCGGCGGGCTGGTTTATCGCCGATAAGACCGGAGCTAGCAAGCGGGGTGCGCGCGGGATTGTCGCCCTGCTTGGCCCGAATAACAAAGCAGAGCGCATTGTGGTGATTTATCTGCGGGATACGCCGGCGAGCATGGCCGAGCG
gb|HM570035|+|0-825|ARO:3001473|OXA-179 [Acinetobacter baumannii] 	0	770	54149	54919	825	246080-	770	ATGAACATTAAAGCACTCTTACTTATAACAAGCGCTATTTTTATTTCAGCCTGCTCACCTTATATAGTGACTGCTAATCCAAATCACAGCGCTTCAAAATCTGATGTAAAAGCAGAGAAAATTAAAAATTTATTTAACGAAGCACACACTACGGGTGTTTTAGTTATCCAACAAGGCCAAACTCAACAAAGCTATGGTAATGATCTTGCTCGTGCTTCGACCGAGTATGTACCTGCTTCGACCTTCAAAATGCTTAATGCTTTGATCGGCCTTGAGCACCATAAGGCAACCACCACAGAAGTATTTAAGTGGGATGGTAAAAAAAGGTTATTCCCAGAATGGGAAAAGGACATGACCCTAGGCGATGCCATGAAAGCTTCCGCTATTCCAGTTTATCAAGATTTAGCTCGTCGTATTGGACTTGAGCTCATGTCTAAGGAAGTGAAGCGTGTTGGTTATGGCAATGCAGATATCGGTACCCAAGTCGATAATTTTTGGCTGGTGGGTCCTTTAAAAATTACTCCTCAGCAAGAGGCACAGTTTGCTTACAAGCTAGCTAATAAAACGCTTCCATTTAGCCAAAAAGTCCAAGATGAAGTGCAATCCATGCTATTCATAGAAGAAAAGAATGGAAACAAAATATACGCAAAAAGTGGTTGGGGATGGGATGTAAACCCACAAGTAGGCTGGTTAACTGGATGGGTTGTTCAGCCTCAAGGGAATATTGTAGCGTTCTCCCTTAACTTAGAAATGAAAAAAGGAATACCTAG
gb|AF315786|+|1313-2114|ARO:3001429|OXA-35 [Pseudomonas aeruginosa] 	0	746	659	1405	801	104604+	746	ATGAAAACATTTGCCGCATATGTAATTATCGCGTGTCTTTCGAGTACGGCATTAGCTGGTTCAATTACAGAAAATACGTCTTGGAACAAAGAGTTCTCTGCCGAAGCCGTCAATGGTGTCTTCGTGCTTTGTAAAAGTAGCAGTAAATCCTGCGCTACCAATGACTTAGCTCGTGCATCAAAGGAATATCTTCCAGCATCAACATTTAAGATCCCCAACGCAATTATCGGCCTAGAAACTGGTGTCATAAAGAATGAGCATCAGGTTTTCAAATGGGACGGAAAGCCAAGAGCCATGAAGCAATGGGAAAGAGACTTGACCTTAAGAGGGGCAATACAAGTTTCAGCTGTTCCCGTATTTCAACAAATCGCCAGAGAAGTTGGCGAAGTAAGAATGCAGAAATACCTTAAAAAATTTTCCTATGGCAACCAGAATATCAGTGGTGGCATTGACAAATTCTGGTTGGAAGGCCAGCTTAGAATTTCCGCAGTTAATCAAGTGGAGTTTCTAGAGTCTCTATATTTAAATAAATTGTCAGCATCTAAAGAAAACCAGCTAATAGTAAAAGAGGCTTTGGTAACGGAGGCGGCACCTGAATATCTAGTGCATTCAAAAACTGGTTTTTCTGGTGTGGGAACTGAGTCAAATCCTGGTGTCGCATGGTGGGTTGGGTGGGTTGAGAAGGAGACAGAGGTTTACTTTTTCGCCTTTAACATGGATATAGACAACGAAAGTAAGTTGCCGCT
gb|AY065991|+|6-867|ARO:3001101|SHV-43 [Klebsiella pneumoniae] 	0	806	16	822	861	1612535+	806	ATGCGTTATATTCGCCTGTGTATTATCACCCTGTGAGCCACCCTGCCGCTGGCGGTACACGCCAGCCCGCAGCCGCTTGAGCAAATTAAACAAAGCGAAAGCCAGCTGTCGGGCCGCGTAGGCATGATAGAAATGGATCTGGCCAGCGGCCGCACGCTGACCGCCTGGCGCGCCGATGAACGCTTTCCCATGATGAGCACCTTTAAAGTAGTGCTCTGCGGCGCAGTGCTGGCGCGGGTGGATGCCGGTGACGAACAGCTGGAGCGAAAGATCCACTATCGCCAGCAGGATCTGGTGGACTACTCGCCGGTCAGCGAAAAACACCTTGCCGACGGCATGACGGTCGGCGAACTCTGCGCCGCCGCCATTACCATGAGCGATAACAGCGCCGCCAATCTGCTGCTGGCCACCGTCGGCGGCCCCGCAGGATTGACTGCCTTTTTGCGCCAGATCGGCGACAACGTCACCCGCCTTGACCGCTGGGAAACGGAACTGAATGAGGCGCTTCCCGGCGACGCCCGCGACACCACTACCCCGGCCAGCATGGCCGCGACCCTGCGCAAGCTGCTGACCAGCCAGCGTCTGAGCGCCCGTTCGCAACGGCAGCTGCTGCAGTGGATGGTGGACGATCGGGTCGCCGGACCGTTGATCCGCTCCGTGCTGCCGGCGGGCTGGTTTATCGCCGATAAGACCGGAGCTAGCAAGCGGGGTGCGCGCGGGATTGTCGCCCTGCTTGGCCCGAATAACAAAGCAGAGCGCATTGTGGTGATTTATCTGCGGGATACGCCGGCGAGCATGGCCGAGCG
gb|AJ575184.1|+|0-1152|ARO:3003851|ADC-5 [Acinetobacter pittii] 	0	1097	63	1160	1152	126080+	1097	ATGCGATTTAAAAAAATTTCTTGTCTACTTTTATCCCCGCTTTTTATTTTTAGTACCTCAATTTATGCGGGCAATACACCAAAAGACCAAGAAATTAAAAAACTGGTAGATCAAAACTTTAAACCGTTATTAGAAAAATATGATGTGCCAGGTATGGCTGTGGGTGTTATTCAAAATAATAAAAAGTATGAAATGTATTATGGTCTTCAATCTGTTCAAGATAAAAAAGCCGTAAATAGCAGTACTATTTTTGAGCTAGGTTCTGTCAGTAAATTATTTACCGCGACAGCAGGTGGATATGCAAAAAATAAAGGAAAAATCTCTTTTGACGATACGCCTGGTAAGTATTGGAAAGAACTAAAAAATACACCGATTGACCAAGTTAACTTACTTCAACTCGCGACGTATACAAGTGGTAACCTTGCCTTGCAATTTCCAGATGAAGTAAAAACAGATCAGCAAGTTTTAACATTTTTTAAAGACTGGAAACCTAAAAACTCAATCGGTGAATATCGACAATATTCAAACCCAAGCATTGGTTTATTTGGAAAAGTTGTAGCTTTGTCTATGAATAAACCTTTCGACCAAGTCTTAGAAAAAACAATTTTTCCGGCCCTTGGCTTAAAACATAGCTATGTAAATGTACCTAAGACCCAGATGCAAAACTATGCTTTTGGCTATAACCAAGAAAATCAGCCGATTCGAGTTAACCCCGGCCCACTCGATGCCCCAGCATATGGCGTCAAATCGACACTACCCGACATGTTGAGTTTTATTCATGCCAACCTAAATCCACAAAAATATCCAGCAGATATTCAACGGGCAATTAATGAAACACATCAGGGTCGCTATCAAGTAAATACCATGTATCAGGCACTCGGTTGGGAAGAGTTTTCTTATCCGGCAACGTTACAAACTTTATTAGACAGTAATTCAGAACAGATTGTGATGAAACCTAATAAAGTGACTGCTATTTCAAAGGAACCTTCAGTTAAGATGTACCATAAAACTGGCTCAACTACCGGTTTCGGAACATATGTGGTGTTTATTCCTAAAGAAAATATTGGTTTAGTCATGTTAACCAATAAACGTATTCC
gb|DQ836922|+|0-861|ARO:3001144|SHV-92 [Klebsiella pneumoniae] 	0	806	16	822	861	1612535+	806	ATGCGTTATATTCGCCTGTGTATTATCACCCTGTGAGCCACCCTGCCGCTGGCGGTACACGCCAGCCCGCAGCCGCTTGAGCAAATTAAACAAAGCGAAAGCCAGCTGTCGGGCCGCGTAGGCATGATAGAAATGGATCTGGCCAGCGGCCGCACGCTGACCGCCTGGCGCGCCGATGAACGCTTTCCCATGATGAGCACCTTTAAAGTAGTGCTCTGCGGCGCAGTGCTGGCGCGGGTGGATGCCGGTGACGAACAGCTGGAGCGAAAGATCCACTATCGCCAGCAGGATCTGGTGGACTACTCGCCGGTCAGCGAAAAACACCTTGCCGACGGCATGACGGTCGGCGAACTCTGCGCCGCCGCCATTACCATGAGCGATAACAGCGCCGCCAATCTGCTGCTGGCCACCGTCGGCGGCCCCGCAGGATTGACTGCCTTTTTGCGCCAGATCGGCGACAACGTCACCCGCCTTGACCGCTGGGAAACGGAACTGAATGAGGCGCTTCCCGGCGACGCCCGCGACACCACTACCCCGGCCAGCATGGCCGCGACCCTGCGCAAGCTGCTGACCAGCCAGCGTCTGAGCGCCCGTTCGCAACGGCAGCTGCTGCAGTGGATGGTGGACGATCGGGTCGCCGGACCGTTGATCCGCTCCGTGCTGCCGGCGGGCTGGTTTATCGCCGATAAGACCGGAGCTAGCAAGCGGGGTGCGCGCGGGATTGTCGCCCTGCTTGGCCCGAATAACAAAGCAGAGCGCATTGTGGTGATTTATCTGCGGGATACGCCGGCGAGCATGGCCGAGCG
gb|HM570036|+|0-825|ARO:3001474|OXA-180 [Acinetobacter baumannii] 	0	770	54149	54919	825	246080-	770	ATGAACATTAAAGCACTCTTACTTATAACAAGCGCTATTTTTATTTCAGCCTGCTCACCTTATATAGTGACTGCTAATCCAAATCACAGCGCTTCAAAATCTGATGTAAAAGCAGAGAAAATTAAAAATTTATTTAACGAAGCACACACTACGGGTGTTTTAGTTATCCAACAAGGCCAAACTCAACAAAGCTATGGTAATGATCTTGCTCGTGCTTCGACCGAGTATGTACCTGCTTCGACCTTCAAAATGCTTAATGCTTTGATCGGCCTTGAGCACCATAAGGCAACCACCACAGAAGTATTTAAGTGGGATGGTAAAAAAAGGTTATTCCCAGAATGGGAAAAGGACATGACCCTAGGCGATGCCATGAAAGCTTCCGCTATTCCAGTTTATCAAGATTTAGCTCGTCGTATTGGACTTGAGCTCATGTCTAAGGAAGTGAAGCGTGTTGGTTATGGCAATGCAGATATCGGTACCCAAGTCGATAATTTTTGGCTGGTGGGTCCTTTAAAAATTACTCCTCAGCAAGAGGCACAGTTTGCTTACAAGCTAGCTAATAAAACGCTTCCATTTAGCCAAAAAGTCCAAGATGAAGTGCAATCCATGCTATTCATAGAAGAAAAGAATGGAAACAAAATATACGCAAAAAGTGGTTGGGGATGGGATGTAAACCCACAAGTAGGCTGGTTAACTGGATGGGTTGTTCAGCCTCAAGGGAATATTGTAGCGTTCTCCCTTAACTTAGAAATGAAAAAAGGAATACCTAG
gb|KR057747.1|+|0-1116|ARO:3004341|PDC-78 [Pseudomonas aeruginosa] 	3	1061	35594	36652	1116	232416+	1058	GAGGCCCCGGCGGATCGCCTGAAGGCACTGGTCGACGCCGCCGTACAACCGGTGATGAAGGCCAATGACATTCCGGGCCTGGCCGTAGCCATCAGCCTGAAAGGAGAACCGCATTACTTCAGCTATGGGCTGGCCTCGAAAGAGGACGGCCGCCGGGTGACGCCGGAGACCCTGTTCGAGATCGGCTCGGTGAGCAAGACCTTCACCGTCACCCTCGCCGGCTATGCCCTGGCCCAGGACAAGATGCGCCTCGACGACCGCGCCAGCCAGCACTGGCCGGCACTGCAGGGCAGCCGCTTCGACGGCATCAGCCTGCTCGACCTCGCGACCTATACCGCCGGCGGCTTGCCGCTGCAGTTCCCCGACTCGGTGCAGAAGGACCAGGCACAGATCCGCGACTACTACCGCCAGTGGCAGCCGACCTACGCGCCGGGCAGCCAGCGCCTCTATTCCAACCCGAGCATCGGCCTGTTCGGCTATCTCGCCGCGCGCAGCCTGGGCCAGCCGTTCGAACGGCTCATGGAGCAGCAATTGTTCCCGGCACTGGGCCTCGAACAGACCCACCTCGACGTGCCCGAGGCGGCGCTGGCGCAGTACGCCCAGGGCTACGGCAAGGACGACCGCCCGCTACGGGTCGGTCCCGGCCCGCTGGATGCCGAAGGCTACGGGGTGAAGACCAGCGCGGCCGACCTGCTGCGCTTCGTCGATGCCAACCTGCATCCGGAGCGCCTGGACAGGCCCTGGGCGCAGGCGCTCGATGCCACCCATCGCGGTTACTACAAGGTCGGCGACATGACCCAGGGCCTGGGCTGGGAAGCCTACGACTGGCCGATCTCCCTGAAGCGCCTGCAGGCCGGCAACTCGACGCCGATGGCGCTGCAACCACACAGGATCGCCAGGCTGCCCGCGCCACAGGCGCTGGAGGGCCAGCGCCTGCTGAACAAGACCGGCTCCACCAACGGCTTCGGCGCCTACGTGGCGTTCGTCCCGGGCCGCGACCTGGGCCTGGTGATCCTGGCCAACCGCAACTATCCCAATGCCGAGCGGGTGAAGATCGC
gb|HQ662682.1|+|0-1152|ARO:3003878|ADC-56 [Acinetobacter baumannii] 	0	1097	63	1160	1152	126080+	1097	ATGCGATTTAAAAAAATTTCTTGTCTACTTTTATCCCCGCTTTTTATTTTTAGTACCTCAATTTATGCGGGCAATACACCAAAAGACCAAGAAATTAAAAAACTGGTAGATCAAAACTTTAAACCGTTATTAGAAAAATATGATGTGCCAGGTATGGCTGTGGGTGTTATTCAAAATAATAAAAAGTATGAAATGTATTATGGTCTTCAATCTGTTCAAGATAAAAAAGCCGTAAATAGCAGTACTATTTTTGAGCTAGGTTCTGTCAGTAAATTATTTACCGCGACAGCAGGTGGATATGCAAAAAATAAAGGAAAAATCTCTTTTGACGATACGCCTGGTAAGTATTGGAAAGAACTAAAAAATACACCGATTGACCAAGTTAACTTACTTCAACTCGCGACGTATACAAGTGGTAACCTTGCCTTGCAATTTCCAGATGAAGTAAAAACAGATCAGCAAGTTTTAACATTTTTTAAAGACTGGAAACCTAAAAACTCAATCGGTGAATATCGACAATATTCAAACCCAAGCATTGGTTTATTTGGAAAAGTTGTAGCTTTGTCTATGAATAAACCTTTCGACCAAGTCTTAGAAAAAACAATTTTTCCGGCCCTTGGCTTAAAACATAGCTATGTAAATGTACCTAAGACCCAGATGCAAAACTATGCTTTTGGCTATAACCAAGAAAATCAGCCGATTCGAGTTAACCCCGGCCCACTCGATGCCCCAGCATATGGCGTCAAATCGACACTACCCGACATGTTGAGTTTTATTCATGCCAACCTAAATCCACAAAAATATCCAGCAGATATTCAACGGGCAATTAATGAAACACATCAGGGTCGCTATCAAGTAAATACCATGTATCAGGCACTCGGTTGGGAAGAGTTTTCTTATCCGGCAACGTTACAAACTTTATTAGACAGTAATTCAGAACAGATTGTGATGAAACCTAATAAAGTGACTGCTATTTCAAAGGAACCTTCAGTTAAGATGTACCATAAAACTGGCTCAACTACCGGTTTCGGAACATATGTGGTGTTTATTCCTAAAGAAAATATTGGTTTAGTCATGTTAACCAATAAACGTATTCC
gb|EF373969|+|0-861|ARO:3001145|SHV-93 [Klebsiella pneumoniae] 	0	806	16	822	861	1612535+	806	ATGCGTTATATTCGCCTGTGTATTATCACCCTGTGAGCCACCCTGCCGCTGGCGGTACACGCCAGCCCGCAGCCGCTTGAGCAAATTAAACAAAGCGAAAGCCAGCTGTCGGGCCGCGTAGGCATGATAGAAATGGATCTGGCCAGCGGCCGCACGCTGACCGCCTGGCGCGCCGATGAACGCTTTCCCATGATGAGCACCTTTAAAGTAGTGCTCTGCGGCGCAGTGCTGGCGCGGGTGGATGCCGGTGACGAACAGCTGGAGCGAAAGATCCACTATCGCCAGCAGGATCTGGTGGACTACTCGCCGGTCAGCGAAAAACACCTTGCCGACGGCATGACGGTCGGCGAACTCTGCGCCGCCGCCATTACCATGAGCGATAACAGCGCCGCCAATCTGCTGCTGGCCACCGTCGGCGGCCCCGCAGGATTGACTGCCTTTTTGCGCCAGATCGGCGACAACGTCACCCGCCTTGACCGCTGGGAAACGGAACTGAATGAGGCGCTTCCCGGCGACGCCCGCGACACCACTACCCCGGCCAGCATGGCCGCGACCCTGCGCAAGCTGCTGACCAGCCAGCGTCTGAGCGCCCGTTCGCAACGGCAGCTGCTGCAGTGGATGGTGGACGATCGGGTCGCCGGACCGTTGATCCGCTCCGTGCTGCCGGCGGGCTGGTTTATCGCCGATAAGACCGGAGCTAGCAAGCGGGGTGCGCGCGGGATTGTCGCCCTGCTTGGCCCGAATAACAAAGCAGAGCGCATTGTGGTGATTTATCTGCGGGATACGCCGGCGAGCATGGCCGAGCG
gb|HQ111474|+|1056-1857|ARO:3001475|OXA-183 [Pseudomonas aeruginosa] 	0	746	659	1405	801	104604+	746	ATGAAAACATTTGCCGCATATGTAATTATCGCGTGTCTTTCGAGTACGGCATTAGCTGGTTCAATTACAGAAAATACGTCTTGGAACAAAGAGTTCTCTGCCGAAGCCGTCAATGGTGTCTTCGTGCTTTGTAAAAGTAGCAGTAAATCCTGCGCTACCAATGACTTAGCTCGTGCATCAAAGGAATATCTTCCAGCATCAACATTTAAGATCCCCAACGCAATTATCGGCCTAGAAACTGGTGTCATAAAGAATGAGCATCAGGTTTTCAAATGGGACGGAAAGCCAAGAGCCATGAAGCAATGGGAAAGAGACTTGACCTTAAGAGGGGCAATACAAGTTTCAGCTGTTCCCGTATTTCAACAAATCGCCAGAGAAGTTGGCGAAGTAAGAATGCAGAAATACCTTAAAAAATTTTCCTATGGCAACCAGAATATCAGTGGTGGCATTGACAAATTCTGGTTGGAAGGCCAGCTTAGAATTTCCGCAGTTAATCAAGTGGAGTTTCTAGAGTCTCTATATTTAAATAAATTGTCAGCATCTAAAGAAAACCAGCTAATAGTAAAAGAGGCTTTGGTAACGGAGGCGGCACCTGAATATCTAGTGCATTCAAAAACTGGTTTTTCTGGTGTGGGAACTGAGTCAAATCCTGGTGTCGCATGGTGGGTTGGGTGGGTTGAGAAGGAGACAGAGGTTTACTTTTTCGCCTTTAACATGGATATAGACAACGAAAGTAAGTTGCCGCT
gb|KF885217|+|0-825|ARO:3001552|OXA-365 [Acinetobacter baumannii] 	0	770	54149	54919	825	246080-	770	ATGAACATTAAAGCACTCTTACTTATAACAAGCGCTATTTTTATTTCAGCCTGCTCACCTTATATAGTGACTGCTAATCCAAATCACAGCGCTTCAAAATCTGATGTAAAAGCAGAGAAAATTAAAAATTTATTTAACGAAGCACACACTACGGGTGTTTTAGTTATCCAACAAGGCCAAACTCAACAAAGCTATGGTAATGATCTTGCTCGTGCTTCGACCGAGTATGTACCTGCTTCGACCTTCAAAATGCTTAATGCTTTGATCGGCCTTGAGCACCATAAGGCAACCACCACAGAAGTATTTAAGTGGGATGGTAAAAAAAGGTTATTCCCAGAATGGGAAAAGGACATGACCCTAGGCGATGCCATGAAAGCTTCCGCTATTCCAGTTTATCAAGATTTAGCTCGTCGTATTGGACTTGAGCTCATGTCTAAGGAAGTGAAGCGTGTTGGTTATGGCAATGCAGATATCGGTACCCAAGTCGATAATTTTTGGCTGGTGGGTCCTTTAAAAATTACTCCTCAGCAAGAGGCACAGTTTGCTTACAAGCTAGCTAATAAAACGCTTCCATTTAGCCAAAAAGTCCAAGATGAAGTGCAATCCATGCTATTCATAGAAGAAAAGAATGGAAACAAAATATACGCAAAAAGTGGTTGGGGATGGGATGTAAACCCACAAGTAGGCTGGTTAACTGGATGGGTTGTTCAGCCTCAAGGGAATATTGTAGCGTTCTCCCTTAACTTAGAAATGAAAAAAGGAATACCTAG
gb|KR057748.1|+|0-1116|ARO:3004342|PDC-79 [Pseudomonas aeruginosa] 	3	1061	35594	36652	1116	232416+	1058	GAGGCCCCGGCGGATCGCCTGAAGGCACTGGTCGACGCCGCCGTACAACCGGTGATGAAGGCCAATGACATTCCGGGCCTGGCCGTAGCCATCAGCCTGAAAGGAGAACCGCATTACTTCAGCTATGGGCTGGCCTCGAAAGAGGACGGCCGCCGGGTGACGCCGGAGACCCTGTTCGAGATCGGCTCGGTGAGCAAGACCTTCACCGTCACCCTCGCCGGCTATGCCCTGGCCCAGGACAAGATGCGCCTCGACGACCGCGCCAGCCAGCACTGGCCGGCACTGCAGGGCAGCCGCTTCGACGGCATCAGCCTGCTCGACCTCGCGACCTATACCGCCGGCGGCTTGCCGCTGCAGTTCCCCGACTCGGTGCAGAAGGACCAGGCACAGATCCGCGACTACTACCGCCAGTGGCAGCCGACCTACGCGCCGGGCAGCCAGCGCCTCTATTCCAACCCGAGCATCGGCCTGTTCGGCTATCTCGCCGCGCGCAGCCTGGGCCAGCCGTTCGAACGGCTCATGGAGCAGCAATTGTTCCCGGCACTGGGCCTCGAACAGACCCACCTCGACGTGCCCGAGGCGGCGCTGGCGCAGTACGCCCAGGGCTACGGCAAGGACGACCGCCCGCTACGGGTCGGTCCCGGCCCGCTGGATGCCGAAGGCTACGGGGTGAAGACCAGCGCGGCCGACCTGCTGCGCTTCGTCGATGCCAACCTGCATCCGGAGCGCCTGGACAGGCCCTGGGCGCAGGCGCTCGATGCCACCCATCGCGGTTACTACAAGGTCGGCGACATGACCCAGGGCCTGGGCTGGGAAGCCTACGACTGGCCGATCTCCCTGAAGCGCCTGCAGGCCGGCAACTCGACGCCGATGGCGCTGCAACCACACAGGATCGCCAGGCTGCCCGCGCCACAGGCGCTGGAGGGCCAGCGCCTGCTGAACAAGACCGGCTCCACCAACGGCTTCGGCGCCTACGTGGCGTTCGTCCCGGGCCGCGACCTGGGCCTGGTGATCCTGGCCAACCGCAACTATCCCAATGCCGAGCGGGTGAAGATCGC
gb|EF373970|+|0-861|ARO:3001146|SHV-94 [Klebsiella pneumoniae] 	0	806	16	822	861	1612535+	806	ATGCGTTATATTCGCCTGTGTATTATCACCCTGTGAGCCACCCTGCCGCTGGCGGTACACGCCAGCCCGCAGCCGCTTGAGCAAATTAAACAAAGCGAAAGCCAGCTGTCGGGCCGCGTAGGCATGATAGAAATGGATCTGGCCAGCGGCCGCACGCTGACCGCCTGGCGCGCCGATGAACGCTTTCCCATGATGAGCACCTTTAAAGTAGTGCTCTGCGGCGCAGTGCTGGCGCGGGTGGATGCCGGTGACGAACAGCTGGAGCGAAAGATCCACTATCGCCAGCAGGATCTGGTGGACTACTCGCCGGTCAGCGAAAAACACCTTGCCGACGGCATGACGGTCGGCGAACTCTGCGCCGCCGCCATTACCATGAGCGATAACAGCGCCGCCAATCTGCTGCTGGCCACCGTCGGCGGCCCCGCAGGATTGACTGCCTTTTTGCGCCAGATCGGCGACAACGTCACCCGCCTTGACCGCTGGGAAACGGAACTGAATGAGGCGCTTCCCGGCGACGCCCGCGACACCACTACCCCGGCCAGCATGGCCGCGACCCTGCGCAAGCTGCTGACCAGCCAGCGTCTGAGCGCCCGTTCGCAACGGCAGCTGCTGCAGTGGATGGTGGACGATCGGGTCGCCGGACCGTTGATCCGCTCCGTGCTGCCGGCGGGCTGGTTTATCGCCGATAAGACCGGAGCTAGCAAGCGGGGTGCGCGCGGGATTGTCGCCCTGCTTGGCCCGAATAACAAAGCAGAGCGCATTGTGGTGATTTATCTGCGGGATACGCCGGCGAGCATGGCCGAGCG
gb|AY949202|+|0-825|ARO:3001622|OXA-77 [Acinetobacter baumannii] 	0	770	54149	54919	825	246080-	770	ATGAACATTAAAGCACTCTTACTTATAACAAGCGCTATTTTTATTTCAGCCTGCTCACCTTATATAGTGACTGCTAATCCAAATCACAGCGCTTCAAAATCTGATGTAAAAGCAGAGAAAATTAAAAATTTATTTAACGAAGCACACACTACGGGTGTTTTAGTTATCCAACAAGGCCAAACTCAACAAAGCTATGGTAATGATCTTGCTCGTGCTTCGACCGAGTATGTACCTGCTTCGACCTTCAAAATGCTTAATGCTTTGATCGGCCTTGAGCACCATAAGGCAACCACCACAGAAGTATTTAAGTGGGATGGTAAAAAAAGGTTATTCCCAGAATGGGAAAAGGACATGACCCTAGGCGATGCCATGAAAGCTTCCGCTATTCCAGTTTATCAAGATTTAGCTCGTCGTATTGGACTTGAGCTCATGTCTAAGGAAGTGAAGCGTGTTGGTTATGGCAATGCAGATATCGGTACCCAAGTCGATAATTTTTGGCTGGTGGGTCCTTTAAAAATTACTCCTCAGCAAGAGGCACAGTTTGCTTACAAGCTAGCTAATAAAACGCTTCCATTTAGCCAAAAAGTCCAAGATGAAGTGCAATCCATGCTATTCATAGAAGAAAAGAATGGAAACAAAATATACGCAAAAAGTGGTTGGGGATGGGATGTAAACCCACAAGTAGGCTGGTTAACTGGATGGGTTGTTCAGCCTCAAGGGAATATTGTAGCGTTCTCCCTTAACTTAGAAATGAAAAAAGGAATACCTAG
gb|JX121129|+|0-858|ARO:3001201|SHV-162 [Klebsiella pneumoniae] 	0	803	16	819	858	1612535+	803	ATGCGTTATATTCGCCTGTGTATTATCACCCTGTGAGCCACCCTGCCGCTGGCGGTACACGCCAGCCCGCAGCCGCTTGAGCAAATTAAACAAAGCGAAAGCCAGCTGTCGGGCCGCGTAGGCATGATAGAAATGGATCTGGCCAGCGGCCGCACGCTGACCGCCTGGCGCGCCGATGAACGCTTTCCCATGATGAGCACCTTTAAAGTAGTGCTCTGCGGCGCAGTGCTGGCGCGGGTGGATGCCGGTGACGAACAGCTGGAGCGAAAGATCCACTATCGCCAGCAGGATCTGGTGGACTACTCGCCGGTCAGCGAAAAACACCTTGCCGACGGCATGACGGTCGGCGAACTCTGCGCCGCCGCCATTACCATGAGCGATAACAGCGCCGCCAATCTGCTGCTGGCCACCGTCGGCGGCCCCGCAGGATTGACTGCCTTTTTGCGCCAGATCGGCGACAACGTCACCCGCCTTGACCGCTGGGAAACGGAACTGAATGAGGCGCTTCCCGGCGACGCCCGCGACACCACTACCCCGGCCAGCATGGCCGCGACCCTGCGCAAGCTGCTGACCAGCCAGCGTCTGAGCGCCCGTTCGCAACGGCAGCTGCTGCAGTGGATGGTGGACGATCGGGTCGCCGGACCGTTGATCCGCTCCGTGCTGCCGGCGGGCTGGTTTATCGCCGATAAGACCGGAGCTAGCAAGCGGGGTGCGCGCGGGATTGTCGCCCTGCTTGGCCCGAATAACAAAGCAGAGCGCATTGTGGTGATTTATCTGCGGGATACGCCGGCGAGCATGGCCGA
gb|AF043381|+|943-1744|ARO:3001414|OXA-19 [Pseudomonas aeruginosa] 	0	746	659	1405	801	104604+	746	ATGAAAACATTTGCCGCATATGTAATTATCGCGTGTCTTTCGAGTACGGCATTAGCTGGTTCAATTACAGAAAATACGTCTTGGAACAAAGAGTTCTCTGCCGAAGCCGTCAATGGTGTCTTCGTGCTTTGTAAAAGTAGCAGTAAATCCTGCGCTACCAATGACTTAGCTCGTGCATCAAAGGAATATCTTCCAGCATCAACATTTAAGATCCCCAACGCAATTATCGGCCTAGAAACTGGTGTCATAAAGAATGAGCATCAGGTTTTCAAATGGGACGGAAAGCCAAGAGCCATGAAGCAATGGGAAAGAGACTTGACCTTAAGAGGGGCAATACAAGTTTCAGCTGTTCCCGTATTTCAACAAATCGCCAGAGAAGTTGGCGAAGTAAGAATGCAGAAATACCTTAAAAAATTTTCCTATGGCAACCAGAATATCAGTGGTGGCATTGACAAATTCTGGTTGGAAGGCCAGCTTAGAATTTCCGCAGTTAATCAAGTGGAGTTTCTAGAGTCTCTATATTTAAATAAATTGTCAGCATCTAAAGAAAACCAGCTAATAGTAAAAGAGGCTTTGGTAACGGAGGCGGCACCTGAATATCTAGTGCATTCAAAAACTGGTTTTTCTGGTGTGGGAACTGAGTCAAATCCTGGTGTCGCATGGTGGGTTGGGTGGGTTGAGAAGGAGACAGAGGTTTACTTTTTCGCCTTTAACATGGATATAGACAACGAAAGTAAGTTGCCGCT
gb|AY259119|+|116-977|ARO:3001102|SHV-44 [Klebsiella pneumoniae] 	0	806	16	822	861	1612535+	806	ATGCGTTATATTCGCCTGTGTATTATCACCCTGTGAGCCACCCTGCCGCTGGCGGTACACGCCAGCCCGCAGCCGCTTGAGCAAATTAAACAAAGCGAAAGCCAGCTGTCGGGCCGCGTAGGCATGATAGAAATGGATCTGGCCAGCGGCCGCACGCTGACCGCCTGGCGCGCCGATGAACGCTTTCCCATGATGAGCACCTTTAAAGTAGTGCTCTGCGGCGCAGTGCTGGCGCGGGTGGATGCCGGTGACGAACAGCTGGAGCGAAAGATCCACTATCGCCAGCAGGATCTGGTGGACTACTCGCCGGTCAGCGAAAAACACCTTGCCGACGGCATGACGGTCGGCGAACTCTGCGCCGCCGCCATTACCATGAGCGATAACAGCGCCGCCAATCTGCTGCTGGCCACCGTCGGCGGCCCCGCAGGATTGACTGCCTTTTTGCGCCAGATCGGCGACAACGTCACCCGCCTTGACCGCTGGGAAACGGAACTGAATGAGGCGCTTCCCGGCGACGCCCGCGACACCACTACCCCGGCCAGCATGGCCGCGACCCTGCGCAAGCTGCTGACCAGCCAGCGTCTGAGCGCCCGTTCGCAACGGCAGCTGCTGCAGTGGATGGTGGACGATCGGGTCGCCGGACCGTTGATCCGCTCCGTGCTGCCGGCGGGCTGGTTTATCGCCGATAAGACCGGAGCTAGCAAGCGGGGTGCGCGCGGGATTGTCGCCCTGCTTGGCCCGAATAACAAAGCAGAGCGCATTGTGGTGATTTATCTGCGGGATACGCCGGCGAGCATGGCCGAGCG
gb|JQ319653.1|+|0-1152|ARO:3004618|ADC-58 [Acinetobacter baumannii] 	0	1097	63	1160	1152	126080+	1097	ATGCGATTTAAAAAAATTTCTTGTCTACTTTTATCCCCGCTTTTTATTTTTAGTACCTCAATTTATGCGGGCAATACACCAAAAGACCAAGAAATTAAAAAACTGGTAGATCAAAACTTTAAACCGTTATTAGAAAAATATGATGTGCCAGGTATGGCTGTGGGTGTTATTCAAAATAATAAAAAGTATGAAATGTATTATGGTCTTCAATCTGTTCAAGATAAAAAAGCCGTAAATAGCAGTACTATTTTTGAGCTAGGTTCTGTCAGTAAATTATTTACCGCGACAGCAGGTGGATATGCAAAAAATAAAGGAAAAATCTCTTTTGACGATACGCCTGGTAAGTATTGGAAAGAACTAAAAAATACACCGATTGACCAAGTTAACTTACTTCAACTCGCGACGTATACAAGTGGTAACCTTGCCTTGCAATTTCCAGATGAAGTAAAAACAGATCAGCAAGTTTTAACATTTTTTAAAGACTGGAAACCTAAAAACTCAATCGGTGAATATCGACAATATTCAAACCCAAGCATTGGTTTATTTGGAAAAGTTGTAGCTTTGTCTATGAATAAACCTTTCGACCAAGTCTTAGAAAAAACAATTTTTCCGGCCCTTGGCTTAAAACATAGCTATGTAAATGTACCTAAGACCCAGATGCAAAACTATGCTTTTGGCTATAACCAAGAAAATCAGCCGATTCGAGTTAACCCCGGCCCACTCGATGCCCCAGCATATGGCGTCAAATCGACACTACCCGACATGTTGAGTTTTATTCATGCCAACCTAAATCCACAAAAATATCCAGCAGATATTCAACGGGCAATTAATGAAACACATCAGGGTCGCTATCAAGTAAATACCATGTATCAGGCACTCGGTTGGGAAGAGTTTTCTTATCCGGCAACGTTACAAACTTTATTAGACAGTAATTCAGAACAGATTGTGATGAAACCTAATAAAGTGACTGCTATTTCAAAGGAACCTTCAGTTAAGATGTACCATAAAACTGGCTCAACTACCGGTTTCGGAACATATGTGGTGTTTATTCCTAAAGAAAATATTGGTTTAGTCATGTTAACCAATAAACGTATTCC
gb|KP050485|+|0-822|ARO:3001553|OXA-366 [Acinetobacter baumannii] 	0	767	80	847	822	254088-	767	ATGAATAAATATTTTACTTGCTATGTGGTTGCTTCTCTTTTTCTTTCTGGTTGTACGGTTCAGCATAATTTAATAAATGAAACCCCGAGTCAGATTGTTCAAGGACATAATCAGGTGATTCATCAATACTTTGATGAAAAAAACACCTCAGGTGTGCTGGTTATTCAAACAGATAAAAAAATTAATCTATATGGTAATGCTCTAAGCCGCGCAAATACAGAATATGTGCCAGCCTCTACATTTAAAATGTTGAATGCCCTGATCGGATTGGAGAACCAGAAAACGGATATTAATGAAATATTTAAATGGAAGGGCGAGAAAAGGTCATTTACCGCTTGGGAAAAAGACATGACACTAGGAGAAGCCATGAAGCTTTCTGCAGTCCCAGTCTATCAGGAACTTGCGCGACGTATCGGTCTTGATCTCATGCAAAAAGAAGTAAAACGTATTGGTTTCGGTAATGCTGAAATTGGACAGCAGGTTGATAATTTCTGGTTGGTAGGACCATTAAAGGTTACGCCTATTCAAGAGGTAGAGTTTGTTTCCCAATTAGCACATACACAGCTTCCATTTAGTGAAAAAGTGCAGGCTAATGTAAAAAATATGCTTCTTTTAGAAGAGAGTAATGGCTACAAAATTTTTGGAAAGACTGGTTGGGCAATGGATATAAAACCACAAGTGGGCTGGTTGACCGGCTGGGTTGAGCAGCCAGATGGAAAAATTGTCGCTTTTGCATTAAATATGGAAATGCGGTCAGAAATGCCGGC
gb|JX121130|+|0-858|ARO:3001202|SHV-163 [Klebsiella pneumoniae] 	0	801	16	817	858	1612535+	801	ATGCGTTATATTCGCCTGTGTATTATCACCCTGTGAGCCACCCTGCCGCTGGCGGTACACGCCAGCCCGCAGCCGCTTGAGCAAATTAAACAAAGCGAAAGCCAGCTGTCGGGCCGCGTAGGCATGATAGAAATGGATCTGGCCAGCGGCCGCACGCTGACCGCCTGGCGCGCCGATGAACGCTTTCCCATGATGAGCACCTTTAAAGTAGTGCTCTGCGGCGCAGTGCTGGCGCGGGTGGATGCCGGTGACGAACAGCTGGAGCGAAAGATCCACTATCGCCAGCAGGATCTGGTGGACTACTCGCCGGTCAGCGAAAAACACCTTGCCGACGGCATGACGGTCGGCGAACTCTGCGCCGCCGCCATTACCATGAGCGATAACAGCGCCGCCAATCTGCTGCTGGCCACCGTCGGCGGCCCCGCAGGATTGACTGCCTTTTTGCGCCAGATCGGCGACAACGTCACCCGCCTTGACCGCTGGGAAACGGAACTGAATGAGGCGCTTCCCGGCGACGCCCGCGACACCACTACCCCGGCCAGCATGGCCGCGACCCTGCGCAAGCTGCTGACCAGCCAGCGTCTGAGCGCCCGTTCGCAACGGCAGCTGCTGCAGTGGATGGTGGACGATCGGGTCGCCGGACCGTTGATCCGCTCCGTGCTGCCGGCGGGCTGGTTTATCGCCGATAAGACCGGAGCTAGCAAGCGGGGTGCGCGCGGGATTGTCGCCCTGCTTGGCCCGAATAACAAAGCAGAGCGCATTGTGGTGATTTATCTGCGGGATACGCCGGCGAGCATGGCC
gb|EF373972|+|0-861|ARO:3001147|SHV-95 [Citrobacter freundii] 	0	806	16	822	861	1612535+	806	ATGCGTTATATTCGCCTGTGTATTATCACCCTGTGAGCCACCCTGCCGCTGGCGGTACACGCCAGCCCGCAGCCGCTTGAGCAAATTAAACAAAGCGAAAGCCAGCTGTCGGGCCGCGTAGGCATGATAGAAATGGATCTGGCCAGCGGCCGCACGCTGACCGCCTGGCGCGCCGATGAACGCTTTCCCATGATGAGCACCTTTAAAGTAGTGCTCTGCGGCGCAGTGCTGGCGCGGGTGGATGCCGGTGACGAACAGCTGGAGCGAAAGATCCACTATCGCCAGCAGGATCTGGTGGACTACTCGCCGGTCAGCGAAAAACACCTTGCCGACGGCATGACGGTCGGCGAACTCTGCGCCGCCGCCATTACCATGAGCGATAACAGCGCCGCCAATCTGCTGCTGGCCACCGTCGGCGGCCCCGCAGGATTGACTGCCTTTTTGCGCCAGATCGGCGACAACGTCACCCGCCTTGACCGCTGGGAAACGGAACTGAATGAGGCGCTTCCCGGCGACGCCCGCGACACCACTACCCCGGCCAGCATGGCCGCGACCCTGCGCAAGCTGCTGACCAGCCAGCGTCTGAGCGCCCGTTCGCAACGGCAGCTGCTGCAGTGGATGGTGGACGATCGGGTCGCCGGACCGTTGATCCGCTCCGTGCTGCCGGCGGGCTGGTTTATCGCCGATAAGACCGGAGCTAGCAAGCGGGGTGCGCGCGGGATTGTCGCCCTGCTTGGCCCGAATAACAAAGCAGAGCGCATTGTGGTGATTTATCTGCGGGATACGCCGGCGAGCATGGCCGAGCG
gb|AF547625|+|0-861|ARO:3001103|SHV-45 [Klebsiella pneumoniae] 	0	806	16	822	861	1612535+	806	ATGCGTTATATTCGCCTGTGTATTATCACCCTGTGAGCCACCCTGCCGCTGGCGGTACACGCCAGCCCGCAGCCGCTTGAGCAAATTAAACAAAGCGAAAGCCAGCTGTCGGGCCGCGTAGGCATGATAGAAATGGATCTGGCCAGCGGCCGCACGCTGACCGCCTGGCGCGCCGATGAACGCTTTCCCATGATGAGCACCTTTAAAGTAGTGCTCTGCGGCGCAGTGCTGGCGCGGGTGGATGCCGGTGACGAACAGCTGGAGCGAAAGATCCACTATCGCCAGCAGGATCTGGTGGACTACTCGCCGGTCAGCGAAAAACACCTTGCCGACGGCATGACGGTCGGCGAACTCTGCGCCGCCGCCATTACCATGAGCGATAACAGCGCCGCCAATCTGCTGCTGGCCACCGTCGGCGGCCCCGCAGGATTGACTGCCTTTTTGCGCCAGATCGGCGACAACGTCACCCGCCTTGACCGCTGGGAAACGGAACTGAATGAGGCGCTTCCCGGCGACGCCCGCGACACCACTACCCCGGCCAGCATGGCCGCGACCCTGCGCAAGCTGCTGACCAGCCAGCGTCTGAGCGCCCGTTCGCAACGGCAGCTGCTGCAGTGGATGGTGGACGATCGGGTCGCCGGACCGTTGATCCGCTCCGTGCTGCCGGCGGGCTGGTTTATCGCCGATAAGACCGGAGCTAGCAAGCGGGGTGCGCGCGGGATTGTCGCCCTGCTTGGCCCGAATAACAAAGCAGAGCGCATTGTGGTGATTTATCTGCGGGATACGCCGGCGAGCATGGCCGAGCG
gb|HQ425492|+|0-822|ARO:3001479|OXA-194 [Acinetobacter nosocomialis] 	0	767	54149	54916	822	246080-	767	ATGAACATTAAAGCACTCTTACTTATAACAAGCGCTATTTTTATTTCAGCCTGCTCACCTTATATAGTGACTGCTAATCCAAATCACAGCGCTTCAAAATCTGATGTAAAAGCAGAGAAAATTAAAAATTTATTTAACGAAGCACACACTACGGGTGTTTTAGTTATCCAACAAGGCCAAACTCAACAAAGCTATGGTAATGATCTTGCTCGTGCTTCGACCGAGTATGTACCTGCTTCGACCTTCAAAATGCTTAATGCTTTGATCGGCCTTGAGCACCATAAGGCAACCACCACAGAAGTATTTAAGTGGGATGGTAAAAAAAGGTTATTCCCAGAATGGGAAAAGGACATGACCCTAGGCGATGCCATGAAAGCTTCCGCTATTCCAGTTTATCAAGATTTAGCTCGTCGTATTGGACTTGAGCTCATGTCTAAGGAAGTGAAGCGTGTTGGTTATGGCAATGCAGATATCGGTACCCAAGTCGATAATTTTTGGCTGGTGGGTCCTTTAAAAATTACTCCTCAGCAAGAGGCACAGTTTGCTTACAAGCTAGCTAATAAAACGCTTCCATTTAGCCAAAAAGTCCAAGATGAAGTGCAATCCATGCTATTCATAGAAGAAAAGAATGGAAACAAAATATACGCAAAAAGTGGTTGGGGATGGGATGTAAACCCACAAGTAGGCTGGTTAACTGGATGGGTTGTTCAGCCTCAAGGGAATATTGTAGCGTTCTCCCTTAACTTAGAAATGAAAAAAGGAATACC
gb|AY862132|+|0-825|ARO:3001645|OXA-78 [Acinetobacter baumannii] 	0	770	54149	54919	825	246080-	770	ATGAACATTAAAGCACTCTTACTTATAACAAGCGCTATTTTTATTTCAGCCTGCTCACCTTATATAGTGACTGCTAATCCAAATCACAGCGCTTCAAAATCTGATGTAAAAGCAGAGAAAATTAAAAATTTATTTAACGAAGCACACACTACGGGTGTTTTAGTTATCCAACAAGGCCAAACTCAACAAAGCTATGGTAATGATCTTGCTCGTGCTTCGACCGAGTATGTACCTGCTTCGACCTTCAAAATGCTTAATGCTTTGATCGGCCTTGAGCACCATAAGGCAACCACCACAGAAGTATTTAAGTGGGATGGTAAAAAAAGGTTATTCCCAGAATGGGAAAAGGACATGACCCTAGGCGATGCCATGAAAGCTTCCGCTATTCCAGTTTATCAAGATTTAGCTCGTCGTATTGGACTTGAGCTCATGTCTAAGGAAGTGAAGCGTGTTGGTTATGGCAATGCAGATATCGGTACCCAAGTCGATAATTTTTGGCTGGTGGGTCCTTTAAAAATTACTCCTCAGCAAGAGGCACAGTTTGCTTACAAGCTAGCTAATAAAACGCTTCCATTTAGCCAAAAAGTCCAAGATGAAGTGCAATCCATGCTATTCATAGAAGAAAAGAATGGAAACAAAATATACGCAAAAAGTGGTTGGGGATGGGATGTAAACCCACAAGTAGGCTGGTTAACTGGATGGGTTGTTCAGCCTCAAGGGAATATTGTAGCGTTCTCCCTTAACTTAGAAATGAAAAAAGGAATACCTAG
gb|KT736121.1|+|1176-1977|ARO:3001555|OXA-368 [Aeromonas sobria] 	0	746	659	1405	801	104604+	746	ATGAAAACATTTGCCGCATATGTAATTATCGCGTGTCTTTCGAGTACGGCATTAGCTGGTTCAATTACAGAAAATACGTCTTGGAACAAAGAGTTCTCTGCCGAAGCCGTCAATGGTGTCTTCGTGCTTTGTAAAAGTAGCAGTAAATCCTGCGCTACCAATGACTTAGCTCGTGCATCAAAGGAATATCTTCCAGCATCAACATTTAAGATCCCCAACGCAATTATCGGCCTAGAAACTGGTGTCATAAAGAATGAGCATCAGGTTTTCAAATGGGACGGAAAGCCAAGAGCCATGAAGCAATGGGAAAGAGACTTGACCTTAAGAGGGGCAATACAAGTTTCAGCTGTTCCCGTATTTCAACAAATCGCCAGAGAAGTTGGCGAAGTAAGAATGCAGAAATACCTTAAAAAATTTTCCTATGGCAACCAGAATATCAGTGGTGGCATTGACAAATTCTGGTTGGAAGGCCAGCTTAGAATTTCCGCAGTTAATCAAGTGGAGTTTCTAGAGTCTCTATATTTAAATAAATTGTCAGCATCTAAAGAAAACCAGCTAATAGTAAAAGAGGCTTTGGTAACGGAGGCGGCACCTGAATATCTAGTGCATTCAAAAACTGGTTTTTCTGGTGTGGGAACTGAGTCAAATCCTGGTGTCGCATGGTGGGTTGGGTGGGTTGAGAAGGAGACAGAGGTTTACTTTTTCGCCTTTAACATGGATATAGACAACGAAAGTAAGTTGCCGCT
gb|HE981194|+|0-861|ARO:3001347|SHV-164 [Klebsiella pneumoniae] 	0	806	16	822	861	1612535+	806	ATGCGTTATATTCGCCTGTGTATTATCACCCTGTGAGCCACCCTGCCGCTGGCGGTACACGCCAGCCCGCAGCCGCTTGAGCAAATTAAACAAAGCGAAAGCCAGCTGTCGGGCCGCGTAGGCATGATAGAAATGGATCTGGCCAGCGGCCGCACGCTGACCGCCTGGCGCGCCGATGAACGCTTTCCCATGATGAGCACCTTTAAAGTAGTGCTCTGCGGCGCAGTGCTGGCGCGGGTGGATGCCGGTGACGAACAGCTGGAGCGAAAGATCCACTATCGCCAGCAGGATCTGGTGGACTACTCGCCGGTCAGCGAAAAACACCTTGCCGACGGCATGACGGTCGGCGAACTCTGCGCCGCCGCCATTACCATGAGCGATAACAGCGCCGCCAATCTGCTGCTGGCCACCGTCGGCGGCCCCGCAGGATTGACTGCCTTTTTGCGCCAGATCGGCGACAACGTCACCCGCCTTGACCGCTGGGAAACGGAACTGAATGAGGCGCTTCCCGGCGACGCCCGCGACACCACTACCCCGGCCAGCATGGCCGCGACCCTGCGCAAGCTGCTGACCAGCCAGCGTCTGAGCGCCCGTTCGCAACGGCAGCTGCTGCAGTGGATGGTGGACGATCGGGTCGCCGGACCGTTGATCCGCTCCGTGCTGCCGGCGGGCTGGTTTATCGCCGATAAGACCGGAGCTAGCAAGCGGGGTGCGCGCGGGATTGTCGCCCTGCTTGGCCCGAATAACAAAGCAGAGCGCATTGTGGTGATTTATCTGCGGGATACGCCGGCGAGCATGGCCGAGCG
gb|EF373971|+|0-861|ARO:3001148|SHV-96 [Acinetobacter baumannii] 	0	806	16	822	861	1612535+	806	ATGCGTTATATTCGCCTGTGTATTATCACCCTGTGAGCCACCCTGCCGCTGGCGGTACACGCCAGCCCGCAGCCGCTTGAGCAAATTAAACAAAGCGAAAGCCAGCTGTCGGGCCGCGTAGGCATGATAGAAATGGATCTGGCCAGCGGCCGCACGCTGACCGCCTGGCGCGCCGATGAACGCTTTCCCATGATGAGCACCTTTAAAGTAGTGCTCTGCGGCGCAGTGCTGGCGCGGGTGGATGCCGGTGACGAACAGCTGGAGCGAAAGATCCACTATCGCCAGCAGGATCTGGTGGACTACTCGCCGGTCAGCGAAAAACACCTTGCCGACGGCATGACGGTCGGCGAACTCTGCGCCGCCGCCATTACCATGAGCGATAACAGCGCCGCCAATCTGCTGCTGGCCACCGTCGGCGGCCCCGCAGGATTGACTGCCTTTTTGCGCCAGATCGGCGACAACGTCACCCGCCTTGACCGCTGGGAAACGGAACTGAATGAGGCGCTTCCCGGCGACGCCCGCGACACCACTACCCCGGCCAGCATGGCCGCGACCCTGCGCAAGCTGCTGACCAGCCAGCGTCTGAGCGCCCGTTCGCAACGGCAGCTGCTGCAGTGGATGGTGGACGATCGGGTCGCCGGACCGTTGATCCGCTCCGTGCTGCCGGCGGGCTGGTTTATCGCCGATAAGACCGGAGCTAGCAAGCGGGGTGCGCGCGGGATTGTCGCCCTGCTTGGCCCGAATAACAAAGCAGAGCGCATTGTGGTGATTTATCTGCGGGATACGCCGGCGAGCATGGCCGAGCG
gb|AY210887|+|111-972|ARO:3001104|SHV-46 [Klebsiella oxytoca] 	0	806	16	822	861	1612535+	806	ATGCGTTATATTCGCCTGTGTATTATCACCCTGTGAGCCACCCTGCCGCTGGCGGTACACGCCAGCCCGCAGCCGCTTGAGCAAATTAAACAAAGCGAAAGCCAGCTGTCGGGCCGCGTAGGCATGATAGAAATGGATCTGGCCAGCGGCCGCACGCTGACCGCCTGGCGCGCCGATGAACGCTTTCCCATGATGAGCACCTTTAAAGTAGTGCTCTGCGGCGCAGTGCTGGCGCGGGTGGATGCCGGTGACGAACAGCTGGAGCGAAAGATCCACTATCGCCAGCAGGATCTGGTGGACTACTCGCCGGTCAGCGAAAAACACCTTGCCGACGGCATGACGGTCGGCGAACTCTGCGCCGCCGCCATTACCATGAGCGATAACAGCGCCGCCAATCTGCTGCTGGCCACCGTCGGCGGCCCCGCAGGATTGACTGCCTTTTTGCGCCAGATCGGCGACAACGTCACCCGCCTTGACCGCTGGGAAACGGAACTGAATGAGGCGCTTCCCGGCGACGCCCGCGACACCACTACCCCGGCCAGCATGGCCGCGACCCTGCGCAAGCTGCTGACCAGCCAGCGTCTGAGCGCCCGTTCGCAACGGCAGCTGCTGCAGTGGATGGTGGACGATCGGGTCGCCGGACCGTTGATCCGCTCCGTGCTGCCGGCGGGCTGGTTTATCGCCGATAAGACCGGAGCTAGCAAGCGGGGTGCGCGCGGGATTGTCGCCCTGCTTGGCCCGAATAACAAAGCAGAGCGCATTGTGGTGATTTATCTGCGGGATACGCCGGCGAGCATGGCCGAGCG
gb|FJ666071|+|0-1194|ARO:3002507|PDC-8 [Pseudomonas aeruginosa] 	0	1139	35513	36652	1194	232416+	1139	ATGCGCGATACCAGATTCCCCTGCCTGTGCGGCATCGCCGCTTCCACACTGCTGTTCGCCACCACCCCGGCCATTGCCGATGAGGCCCCGGCGGATCGCCTGAAGGCACTGGTCGACGCCGCCGTACAACCGGTGATGAAGGCCAATGACATTCCGGGCCTGGCCGTAGCCATCAGCCTGAAAGGAGAACCGCATTACTTCAGCTATGGGCTGGCCTCGAAAGAGGACGGCCGCCGGGTGACGCCGGAGACCCTGTTCGAGATCGGCTCGGTGAGCAAGACCTTCACCGTCACCCTCGCCGGCTATGCCCTGGCCCAGGACAAGATGCGCCTCGACGACCGCGCCAGCCAGCACTGGCCGGCACTGCAGGGCAGCCGCTTCGACGGCATCAGCCTGCTCGACCTCGCGACCTATACCGCCGGCGGCTTGCCGCTGCAGTTCCCCGACTCGGTGCAGAAGGACCAGGCACAGATCCGCGACTACTACCGCCAGTGGCAGCCGACCTACGCGCCGGGCAGCCAGCGCCTCTATTCCAACCCGAGCATCGGCCTGTTCGGCTATCTCGCCGCGCGCAGCCTGGGCCAGCCGTTCGAACGGCTCATGGAGCAGCAATTGTTCCCGGCACTGGGCCTCGAACAGACCCACCTCGACGTGCCCGAGGCGGCGCTGGCGCAGTACGCCCAGGGCTACGGCAAGGACGACCGCCCGCTACGGGTCGGTCCCGGCCCGCTGGATGCCGAAGGCTACGGGGTGAAGACCAGCGCGGCCGACCTGCTGCGCTTCGTCGATGCCAACCTGCATCCGGAGCGCCTGGACAGGCCCTGGGCGCAGGCGCTCGATGCCACCCATCGCGGTTACTACAAGGTCGGCGACATGACCCAGGGCCTGGGCTGGGAAGCCTACGACTGGCCGATCTCCCTGAAGCGCCTGCAGGCCGGCAACTCGACGCCGATGGCGCTGCAACCACACAGGATCGCCAGGCTGCCCGCGCCACAGGCGCTGGAGGGCCAGCGCCTGCTGAACAAGACCGGCTCCACCAACGGCTTCGGCGCCTACGTGGCGTTCGTCCCGGGCCGCGACCTGGGCCTGGTGATCCTGGCCAACCGCAACTATCCCAATGCCGAGCGGGTGAAGATCGC
gb|HQ425493|+|0-822|ARO:3001480|OXA-195 [Acinetobacter nosocomialis] 	0	767	54149	54916	822	246080-	767	ATGAACATTAAAGCACTCTTACTTATAACAAGCGCTATTTTTATTTCAGCCTGCTCACCTTATATAGTGACTGCTAATCCAAATCACAGCGCTTCAAAATCTGATGTAAAAGCAGAGAAAATTAAAAATTTATTTAACGAAGCACACACTACGGGTGTTTTAGTTATCCAACAAGGCCAAACTCAACAAAGCTATGGTAATGATCTTGCTCGTGCTTCGACCGAGTATGTACCTGCTTCGACCTTCAAAATGCTTAATGCTTTGATCGGCCTTGAGCACCATAAGGCAACCACCACAGAAGTATTTAAGTGGGATGGTAAAAAAAGGTTATTCCCAGAATGGGAAAAGGACATGACCCTAGGCGATGCCATGAAAGCTTCCGCTATTCCAGTTTATCAAGATTTAGCTCGTCGTATTGGACTTGAGCTCATGTCTAAGGAAGTGAAGCGTGTTGGTTATGGCAATGCAGATATCGGTACCCAAGTCGATAATTTTTGGCTGGTGGGTCCTTTAAAAATTACTCCTCAGCAAGAGGCACAGTTTGCTTACAAGCTAGCTAATAAAACGCTTCCATTTAGCCAAAAAGTCCAAGATGAAGTGCAATCCATGCTATTCATAGAAGAAAAGAATGGAAACAAAATATACGCAAAAAGTGGTTGGGGATGGGATGTAAACCCACAAGTAGGCTGGTTAACTGGATGGGTTGTTCAGCCTCAAGGGAATATTGTAGCGTTCTCCCTTAACTTAGAAATGAAAAAAGGAATACC
gb|EF373973|+|0-861|ARO:3001149|SHV-97 [Enterococcus faecalis] 	0	806	16	822	861	1612535+	806	ATGCGTTATATTCGCCTGTGTATTATCACCCTGTGAGCCACCCTGCCGCTGGCGGTACACGCCAGCCCGCAGCCGCTTGAGCAAATTAAACAAAGCGAAAGCCAGCTGTCGGGCCGCGTAGGCATGATAGAAATGGATCTGGCCAGCGGCCGCACGCTGACCGCCTGGCGCGCCGATGAACGCTTTCCCATGATGAGCACCTTTAAAGTAGTGCTCTGCGGCGCAGTGCTGGCGCGGGTGGATGCCGGTGACGAACAGCTGGAGCGAAAGATCCACTATCGCCAGCAGGATCTGGTGGACTACTCGCCGGTCAGCGAAAAACACCTTGCCGACGGCATGACGGTCGGCGAACTCTGCGCCGCCGCCATTACCATGAGCGATAACAGCGCCGCCAATCTGCTGCTGGCCACCGTCGGCGGCCCCGCAGGATTGACTGCCTTTTTGCGCCAGATCGGCGACAACGTCACCCGCCTTGACCGCTGGGAAACGGAACTGAATGAGGCGCTTCCCGGCGACGCCCGCGACACCACTACCCCGGCCAGCATGGCCGCGACCCTGCGCAAGCTGCTGACCAGCCAGCGTCTGAGCGCCCGTTCGCAACGGCAGCTGCTGCAGTGGATGGTGGACGATCGGGTCGCCGGACCGTTGATCCGCTCCGTGCTGCCGGCGGGCTGGTTTATCGCCGATAAGACCGGAGCTAGCAAGCGGGGTGCGCGCGGGATTGTCGCCCTGCTTGGCCCGAATAACAAAGCAGAGCGCATTGTGGTGATTTATCTGCGGGATACGCCGGCGAGCATGGCCGAGCG
gb|EU019534|+|0-825|ARO:3001633|OXA-79 [Acinetobacter baumannii] 	0	770	54149	54919	825	246080-	770	ATGAACATTAAAGCACTCTTACTTATAACAAGCGCTATTTTTATTTCAGCCTGCTCACCTTATATAGTGACTGCTAATCCAAATCACAGCGCTTCAAAATCTGATGTAAAAGCAGAGAAAATTAAAAATTTATTTAACGAAGCACACACTACGGGTGTTTTAGTTATCCAACAAGGCCAAACTCAACAAAGCTATGGTAATGATCTTGCTCGTGCTTCGACCGAGTATGTACCTGCTTCGACCTTCAAAATGCTTAATGCTTTGATCGGCCTTGAGCACCATAAGGCAACCACCACAGAAGTATTTAAGTGGGATGGTAAAAAAAGGTTATTCCCAGAATGGGAAAAGGACATGACCCTAGGCGATGCCATGAAAGCTTCCGCTATTCCAGTTTATCAAGATTTAGCTCGTCGTATTGGACTTGAGCTCATGTCTAAGGAAGTGAAGCGTGTTGGTTATGGCAATGCAGATATCGGTACCCAAGTCGATAATTTTTGGCTGGTGGGTCCTTTAAAAATTACTCCTCAGCAAGAGGCACAGTTTGCTTACAAGCTAGCTAATAAAACGCTTCCATTTAGCCAAAAAGTCCAAGATGAAGTGCAATCCATGCTATTCATAGAAGAAAAGAATGGAAACAAAATATACGCAAAAAGTGGTTGGGGATGGGATGTAAACCCACAAGTAGGCTGGTTAACTGGATGGGTTGTTCAGCCTCAAGGGAATATTGTAGCGTTCTCCCTTAACTTAGAAATGAAAAAAGGAATACCTAG
gb|JQ319654.1|+|0-1152|ARO:3004619|ADC-59 [Acinetobacter baumannii] 	0	1097	63	1160	1152	126080+	1097	ATGCGATTTAAAAAAATTTCTTGTCTACTTTTATCCCCGCTTTTTATTTTTAGTACCTCAATTTATGCGGGCAATACACCAAAAGACCAAGAAATTAAAAAACTGGTAGATCAAAACTTTAAACCGTTATTAGAAAAATATGATGTGCCAGGTATGGCTGTGGGTGTTATTCAAAATAATAAAAAGTATGAAATGTATTATGGTCTTCAATCTGTTCAAGATAAAAAAGCCGTAAATAGCAGTACTATTTTTGAGCTAGGTTCTGTCAGTAAATTATTTACCGCGACAGCAGGTGGATATGCAAAAAATAAAGGAAAAATCTCTTTTGACGATACGCCTGGTAAGTATTGGAAAGAACTAAAAAATACACCGATTGACCAAGTTAACTTACTTCAACTCGCGACGTATACAAGTGGTAACCTTGCCTTGCAATTTCCAGATGAAGTAAAAACAGATCAGCAAGTTTTAACATTTTTTAAAGACTGGAAACCTAAAAACTCAATCGGTGAATATCGACAATATTCAAACCCAAGCATTGGTTTATTTGGAAAAGTTGTAGCTTTGTCTATGAATAAACCTTTCGACCAAGTCTTAGAAAAAACAATTTTTCCGGCCCTTGGCTTAAAACATAGCTATGTAAATGTACCTAAGACCCAGATGCAAAACTATGCTTTTGGCTATAACCAAGAAAATCAGCCGATTCGAGTTAACCCCGGCCCACTCGATGCCCCAGCATATGGCGTCAAATCGACACTACCCGACATGTTGAGTTTTATTCATGCCAACCTAAATCCACAAAAATATCCAGCAGATATTCAACGGGCAATTAATGAAACACATCAGGGTCGCTATCAAGTAAATACCATGTATCAGGCACTCGGTTGGGAAGAGTTTTCTTATCCGGCAACGTTACAAACTTTATTAGACAGTAATTCAGAACAGATTGTGATGAAACCTAATAAAGTGACTGCTATTTCAAAGGAACCTTCAGTTAAGATGTACCATAAAACTGGCTCAACTACCGGTTTCGGAACATATGTGGTGTTTATTCCTAAAGAAAATATTGGTTTAGTCATGTTAACCAATAAACGTATTCC
gb|JX121131|+|0-858|ARO:3001203|SHV-165 [Klebsiella pneumoniae] 	0	803	16	819	858	1612535+	803	ATGCGTTATATTCGCCTGTGTATTATCACCCTGTGAGCCACCCTGCCGCTGGCGGTACACGCCAGCCCGCAGCCGCTTGAGCAAATTAAACAAAGCGAAAGCCAGCTGTCGGGCCGCGTAGGCATGATAGAAATGGATCTGGCCAGCGGCCGCACGCTGACCGCCTGGCGCGCCGATGAACGCTTTCCCATGATGAGCACCTTTAAAGTAGTGCTCTGCGGCGCAGTGCTGGCGCGGGTGGATGCCGGTGACGAACAGCTGGAGCGAAAGATCCACTATCGCCAGCAGGATCTGGTGGACTACTCGCCGGTCAGCGAAAAACACCTTGCCGACGGCATGACGGTCGGCGAACTCTGCGCCGCCGCCATTACCATGAGCGATAACAGCGCCGCCAATCTGCTGCTGGCCACCGTCGGCGGCCCCGCAGGATTGACTGCCTTTTTGCGCCAGATCGGCGACAACGTCACCCGCCTTGACCGCTGGGAAACGGAACTGAATGAGGCGCTTCCCGGCGACGCCCGCGACACCACTACCCCGGCCAGCATGGCCGCGACCCTGCGCAAGCTGCTGACCAGCCAGCGTCTGAGCGCCCGTTCGCAACGGCAGCTGCTGCAGTGGATGGTGGACGATCGGGTCGCCGGACCGTTGATCCGCTCCGTGCTGCCGGCGGGCTGGTTTATCGCCGATAAGACCGGAGCTAGCAAGCGGGGTGCGCGCGGGATTGTCGCCCTGCTTGGCCCGAATAACAAAGCAGAGCGCATTGTGGTGATTTATCTGCGGGATACGCCGGCGAGCATGGCCGA
gb|AY263404|+|0-861|ARO:3001105|SHV-48 [Klebsiella pneumoniae] 	0	806	16	822	861	1612535+	806	ATGCGTTATATTCGCCTGTGTATTATCACCCTGTGAGCCACCCTGCCGCTGGCGGTACACGCCAGCCCGCAGCCGCTTGAGCAAATTAAACAAAGCGAAAGCCAGCTGTCGGGCCGCGTAGGCATGATAGAAATGGATCTGGCCAGCGGCCGCACGCTGACCGCCTGGCGCGCCGATGAACGCTTTCCCATGATGAGCACCTTTAAAGTAGTGCTCTGCGGCGCAGTGCTGGCGCGGGTGGATGCCGGTGACGAACAGCTGGAGCGAAAGATCCACTATCGCCAGCAGGATCTGGTGGACTACTCGCCGGTCAGCGAAAAACACCTTGCCGACGGCATGACGGTCGGCGAACTCTGCGCCGCCGCCATTACCATGAGCGATAACAGCGCCGCCAATCTGCTGCTGGCCACCGTCGGCGGCCCCGCAGGATTGACTGCCTTTTTGCGCCAGATCGGCGACAACGTCACCCGCCTTGACCGCTGGGAAACGGAACTGAATGAGGCGCTTCCCGGCGACGCCCGCGACACCACTACCCCGGCCAGCATGGCCGCGACCCTGCGCAAGCTGCTGACCAGCCAGCGTCTGAGCGCCCGTTCGCAACGGCAGCTGCTGCAGTGGATGGTGGACGATCGGGTCGCCGGACCGTTGATCCGCTCCGTGCTGCCGGCGGGCTGGTTTATCGCCGATAAGACCGGAGCTAGCAAGCGGGGTGCGCGCGGGATTGTCGCCCTGCTTGGCCCGAATAACAAAGCAGAGCGCATTGTGGTGATTTATCTGCGGGATACGCCGGCGAGCATGGCCGAGCG
gb|EU019535|+|0-825|ARO:3001634|OXA-80 [Acinetobacter baumannii] 	0	770	54149	54919	825	246080-	770	ATGAACATTAAAGCACTCTTACTTATAACAAGCGCTATTTTTATTTCAGCCTGCTCACCTTATATAGTGACTGCTAATCCAAATCACAGCGCTTCAAAATCTGATGTAAAAGCAGAGAAAATTAAAAATTTATTTAACGAAGCACACACTACGGGTGTTTTAGTTATCCAACAAGGCCAAACTCAACAAAGCTATGGTAATGATCTTGCTCGTGCTTCGACCGAGTATGTACCTGCTTCGACCTTCAAAATGCTTAATGCTTTGATCGGCCTTGAGCACCATAAGGCAACCACCACAGAAGTATTTAAGTGGGATGGTAAAAAAAGGTTATTCCCAGAATGGGAAAAGGACATGACCCTAGGCGATGCCATGAAAGCTTCCGCTATTCCAGTTTATCAAGATTTAGCTCGTCGTATTGGACTTGAGCTCATGTCTAAGGAAGTGAAGCGTGTTGGTTATGGCAATGCAGATATCGGTACCCAAGTCGATAATTTTTGGCTGGTGGGTCCTTTAAAAATTACTCCTCAGCAAGAGGCACAGTTTGCTTACAAGCTAGCTAATAAAACGCTTCCATTTAGCCAAAAAGTCCAAGATGAAGTGCAATCCATGCTATTCATAGAAGAAAAGAATGGAAACAAAATATACGCAAAAAGTGGTTGGGGATGGGATGTAAACCCACAAGTAGGCTGGTTAACTGGATGGGTTGTTCAGCCTCAAGGGAATATTGTAGCGTTCTCCCTTAACTTAGAAATGAAAAAAGGAATACCTAG
gb|AM941844|+|0-861|ARO:3001336|SHV-98 [Klebsiella pneumoniae] 	0	806	16	822	861	1612535+	806	ATGCGTTATATTCGCCTGTGTATTATCACCCTGTGAGCCACCCTGCCGCTGGCGGTACACGCCAGCCCGCAGCCGCTTGAGCAAATTAAACAAAGCGAAAGCCAGCTGTCGGGCCGCGTAGGCATGATAGAAATGGATCTGGCCAGCGGCCGCACGCTGACCGCCTGGCGCGCCGATGAACGCTTTCCCATGATGAGCACCTTTAAAGTAGTGCTCTGCGGCGCAGTGCTGGCGCGGGTGGATGCCGGTGACGAACAGCTGGAGCGAAAGATCCACTATCGCCAGCAGGATCTGGTGGACTACTCGCCGGTCAGCGAAAAACACCTTGCCGACGGCATGACGGTCGGCGAACTCTGCGCCGCCGCCATTACCATGAGCGATAACAGCGCCGCCAATCTGCTGCTGGCCACCGTCGGCGGCCCCGCAGGATTGACTGCCTTTTTGCGCCAGATCGGCGACAACGTCACCCGCCTTGACCGCTGGGAAACGGAACTGAATGAGGCGCTTCCCGGCGACGCCCGCGACACCACTACCCCGGCCAGCATGGCCGCGACCCTGCGCAAGCTGCTGACCAGCCAGCGTCTGAGCGCCCGTTCGCAACGGCAGCTGCTGCAGTGGATGGTGGACGATCGGGTCGCCGGACCGTTGATCCGCTCCGTGCTGCCGGCGGGCTGGTTTATCGCCGATAAGACCGGAGCTAGCAAGCGGGGTGCGCGCGGGATTGTCGCCCTGCTTGGCCCGAATAACAAAGCAGAGCGCATTGTGGTGATTTATCTGCGGGATACGCCGGCGAGCATGGCCGAGCG
gb|EU019536|+|0-825|ARO:3001635|OXA-82 [Acinetobacter baumannii] 	0	770	54149	54919	825	246080-	770	ATGAACATTAAAGCACTCTTACTTATAACAAGCGCTATTTTTATTTCAGCCTGCTCACCTTATATAGTGACTGCTAATCCAAATCACAGCGCTTCAAAATCTGATGTAAAAGCAGAGAAAATTAAAAATTTATTTAACGAAGCACACACTACGGGTGTTTTAGTTATCCAACAAGGCCAAACTCAACAAAGCTATGGTAATGATCTTGCTCGTGCTTCGACCGAGTATGTACCTGCTTCGACCTTCAAAATGCTTAATGCTTTGATCGGCCTTGAGCACCATAAGGCAACCACCACAGAAGTATTTAAGTGGGATGGTAAAAAAAGGTTATTCCCAGAATGGGAAAAGGACATGACCCTAGGCGATGCCATGAAAGCTTCCGCTATTCCAGTTTATCAAGATTTAGCTCGTCGTATTGGACTTGAGCTCATGTCTAAGGAAGTGAAGCGTGTTGGTTATGGCAATGCAGATATCGGTACCCAAGTCGATAATTTTTGGCTGGTGGGTCCTTTAAAAATTACTCCTCAGCAAGAGGCACAGTTTGCTTACAAGCTAGCTAATAAAACGCTTCCATTTAGCCAAAAAGTCCAAGATGAAGTGCAATCCATGCTATTCATAGAAGAAAAGAATGGAAACAAAATATACGCAAAAAGTGGTTGGGGATGGGATGTAAACCCACAAGTAGGCTGGTTAACTGGATGGGTTGTTCAGCCTCAAGGGAATATTGTAGCGTTCTCCCTTAACTTAGAAATGAAAAAAGGAATACCTAG
gb|AY528718|+|413-1274|ARO:3001106|SHV-49 [Klebsiella pneumoniae] 	0	806	16	822	861	1612535+	806	ATGCGTTATATTCGCCTGTGTATTATCACCCTGTGAGCCACCCTGCCGCTGGCGGTACACGCCAGCCCGCAGCCGCTTGAGCAAATTAAACAAAGCGAAAGCCAGCTGTCGGGCCGCGTAGGCATGATAGAAATGGATCTGGCCAGCGGCCGCACGCTGACCGCCTGGCGCGCCGATGAACGCTTTCCCATGATGAGCACCTTTAAAGTAGTGCTCTGCGGCGCAGTGCTGGCGCGGGTGGATGCCGGTGACGAACAGCTGGAGCGAAAGATCCACTATCGCCAGCAGGATCTGGTGGACTACTCGCCGGTCAGCGAAAAACACCTTGCCGACGGCATGACGGTCGGCGAACTCTGCGCCGCCGCCATTACCATGAGCGATAACAGCGCCGCCAATCTGCTGCTGGCCACCGTCGGCGGCCCCGCAGGATTGACTGCCTTTTTGCGCCAGATCGGCGACAACGTCACCCGCCTTGACCGCTGGGAAACGGAACTGAATGAGGCGCTTCCCGGCGACGCCCGCGACACCACTACCCCGGCCAGCATGGCCGCGACCCTGCGCAAGCTGCTGACCAGCCAGCGTCTGAGCGCCCGTTCGCAACGGCAGCTGCTGCAGTGGATGGTGGACGATCGGGTCGCCGGACCGTTGATCCGCTCCGTGCTGCCGGCGGGCTGGTTTATCGCCGATAAGACCGGAGCTAGCAAGCGGGGTGCGCGCGGGATTGTCGCCCTGCTTGGCCCGAATAACAAAGCAGAGCGCATTGTGGTGATTTATCTGCGGGATACGCCGGCGAGCATGGCCGAGCG
gb|HQ425494|+|0-822|ARO:3001481|OXA-196 [Acinetobacter nosocomialis] 	0	767	54149	54916	822	246080-	767	ATGAACATTAAAGCACTCTTACTTATAACAAGCGCTATTTTTATTTCAGCCTGCTCACCTTATATAGTGACTGCTAATCCAAATCACAGCGCTTCAAAATCTGATGTAAAAGCAGAGAAAATTAAAAATTTATTTAACGAAGCACACACTACGGGTGTTTTAGTTATCCAACAAGGCCAAACTCAACAAAGCTATGGTAATGATCTTGCTCGTGCTTCGACCGAGTATGTACCTGCTTCGACCTTCAAAATGCTTAATGCTTTGATCGGCCTTGAGCACCATAAGGCAACCACCACAGAAGTATTTAAGTGGGATGGTAAAAAAAGGTTATTCCCAGAATGGGAAAAGGACATGACCCTAGGCGATGCCATGAAAGCTTCCGCTATTCCAGTTTATCAAGATTTAGCTCGTCGTATTGGACTTGAGCTCATGTCTAAGGAAGTGAAGCGTGTTGGTTATGGCAATGCAGATATCGGTACCCAAGTCGATAATTTTTGGCTGGTGGGTCCTTTAAAAATTACTCCTCAGCAAGAGGCACAGTTTGCTTACAAGCTAGCTAATAAAACGCTTCCATTTAGCCAAAAAGTCCAAGATGAAGTGCAATCCATGCTATTCATAGAAGAAAAGAATGGAAACAAAATATACGCAAAAAGTGGTTGGGGATGGGATGTAAACCCACAAGTAGGCTGGTTAACTGGATGGGTTGTTCAGCCTCAAGGGAATATTGTAGCGTTCTCCCTTAACTTAGAAATGAAAAAAGGAATACC
gb|AB733453|+|3-849|ARO:3001204|SHV-167 [Klebsiella pneumoniae] 	0	791	16	807	846	1612535+	791	ATGCGTTATATTCGCCTGTGTATTATCACCCTGTGAGCCACCCTGCCGCTGGCGGTACACGCCAGCCCGCAGCCGCTTGAGCAAATTAAACAAAGCGAAAGCCAGCTGTCGGGCCGCGTAGGCATGATAGAAATGGATCTGGCCAGCGGCCGCACGCTGACCGCCTGGCGCGCCGATGAACGCTTTCCCATGATGAGCACCTTTAAAGTAGTGCTCTGCGGCGCAGTGCTGGCGCGGGTGGATGCCGGTGACGAACAGCTGGAGCGAAAGATCCACTATCGCCAGCAGGATCTGGTGGACTACTCGCCGGTCAGCGAAAAACACCTTGCCGACGGCATGACGGTCGGCGAACTCTGCGCCGCCGCCATTACCATGAGCGATAACAGCGCCGCCAATCTGCTGCTGGCCACCGTCGGCGGCCCCGCAGGATTGACTGCCTTTTTGCGCCAGATCGGCGACAACGTCACCCGCCTTGACCGCTGGGAAACGGAACTGAATGAGGCGCTTCCCGGCGACGCCCGCGACACCACTACCCCGGCCAGCATGGCCGCGACCCTGCGCAAGCTGCTGACCAGCCAGCGTCTGAGCGCCCGTTCGCAACGGCAGCTGCTGCAGTGGATGGTGGACGATCGGGTCGCCGGACCGTTGATCCGCTCCGTGCTGCCGGCGGGCTGGTTTATCGCCGATAAGACCGGAGCTAGCAAGCGGGGTGCGCGCGGGATTGTCGCCCTGCTTGGCCCGAATAACAAAGCAGAGCGCATTGTGGTGATTTATCTGCGGGATACGCCGGC
gb|DQ309277|+|0-825|ARO:3001623|OXA-83 [Acinetobacter baumannii] 	0	770	54149	54919	825	246080-	770	ATGAACATTAAAGCACTCTTACTTATAACAAGCGCTATTTTTATTTCAGCCTGCTCACCTTATATAGTGACTGCTAATCCAAATCACAGCGCTTCAAAATCTGATGTAAAAGCAGAGAAAATTAAAAATTTATTTAACGAAGCACACACTACGGGTGTTTTAGTTATCCAACAAGGCCAAACTCAACAAAGCTATGGTAATGATCTTGCTCGTGCTTCGACCGAGTATGTACCTGCTTCGACCTTCAAAATGCTTAATGCTTTGATCGGCCTTGAGCACCATAAGGCAACCACCACAGAAGTATTTAAGTGGGATGGTAAAAAAAGGTTATTCCCAGAATGGGAAAAGGACATGACCCTAGGCGATGCCATGAAAGCTTCCGCTATTCCAGTTTATCAAGATTTAGCTCGTCGTATTGGACTTGAGCTCATGTCTAAGGAAGTGAAGCGTGTTGGTTATGGCAATGCAGATATCGGTACCCAAGTCGATAATTTTTGGCTGGTGGGTCCTTTAAAAATTACTCCTCAGCAAGAGGCACAGTTTGCTTACAAGCTAGCTAATAAAACGCTTCCATTTAGCCAAAAAGTCCAAGATGAAGTGCAATCCATGCTATTCATAGAAGAAAAGAATGGAAACAAAATATACGCAAAAAGTGGTTGGGGATGGGATGTAAACCCACAAGTAGGCTGGTTAACTGGATGGGTTGTTCAGCCTCAAGGGAATATTGTAGCGTTCTCCCTTAACTTAGAAATGAAAAAAGGAATACCTAG
gb|AM941845|+|0-861|ARO:3001337|SHV-99 [Klebsiella pneumoniae] 	0	806	16	822	861	1612535+	806	ATGCGTTATATTCGCCTGTGTATTATCACCCTGTGAGCCACCCTGCCGCTGGCGGTACACGCCAGCCCGCAGCCGCTTGAGCAAATTAAACAAAGCGAAAGCCAGCTGTCGGGCCGCGTAGGCATGATAGAAATGGATCTGGCCAGCGGCCGCACGCTGACCGCCTGGCGCGCCGATGAACGCTTTCCCATGATGAGCACCTTTAAAGTAGTGCTCTGCGGCGCAGTGCTGGCGCGGGTGGATGCCGGTGACGAACAGCTGGAGCGAAAGATCCACTATCGCCAGCAGGATCTGGTGGACTACTCGCCGGTCAGCGAAAAACACCTTGCCGACGGCATGACGGTCGGCGAACTCTGCGCCGCCGCCATTACCATGAGCGATAACAGCGCCGCCAATCTGCTGCTGGCCACCGTCGGCGGCCCCGCAGGATTGACTGCCTTTTTGCGCCAGATCGGCGACAACGTCACCCGCCTTGACCGCTGGGAAACGGAACTGAATGAGGCGCTTCCCGGCGACGCCCGCGACACCACTACCCCGGCCAGCATGGCCGCGACCCTGCGCAAGCTGCTGACCAGCCAGCGTCTGAGCGCCCGTTCGCAACGGCAGCTGCTGCAGTGGATGGTGGACGATCGGGTCGCCGGACCGTTGATCCGCTCCGTGCTGCCGGCGGGCTGGTTTATCGCCGATAAGACCGGAGCTAGCAAGCGGGGTGCGCGCGGGATTGTCGCCCTGCTTGGCCCGAATAACAAAGCAGAGCGCATTGTGGTGATTTATCTGCGGGATACGCCGGCGAGCATGGCCGAGCG
gb|DQ309276|+|0-825|ARO:3001624|OXA-84 [Acinetobacter baumannii] 	0	770	54149	54919	825	246080-	770	ATGAACATTAAAGCACTCTTACTTATAACAAGCGCTATTTTTATTTCAGCCTGCTCACCTTATATAGTGACTGCTAATCCAAATCACAGCGCTTCAAAATCTGATGTAAAAGCAGAGAAAATTAAAAATTTATTTAACGAAGCACACACTACGGGTGTTTTAGTTATCCAACAAGGCCAAACTCAACAAAGCTATGGTAATGATCTTGCTCGTGCTTCGACCGAGTATGTACCTGCTTCGACCTTCAAAATGCTTAATGCTTTGATCGGCCTTGAGCACCATAAGGCAACCACCACAGAAGTATTTAAGTGGGATGGTAAAAAAAGGTTATTCCCAGAATGGGAAAAGGACATGACCCTAGGCGATGCCATGAAAGCTTCCGCTATTCCAGTTTATCAAGATTTAGCTCGTCGTATTGGACTTGAGCTCATGTCTAAGGAAGTGAAGCGTGTTGGTTATGGCAATGCAGATATCGGTACCCAAGTCGATAATTTTTGGCTGGTGGGTCCTTTAAAAATTACTCCTCAGCAAGAGGCACAGTTTGCTTACAAGCTAGCTAATAAAACGCTTCCATTTAGCCAAAAAGTCCAAGATGAAGTGCAATCCATGCTATTCATAGAAGAAAAGAATGGAAACAAAATATACGCAAAAAGTGGTTGGGGATGGGATGTAAACCCACAAGTAGGCTGGTTAACTGGATGGGTTGTTCAGCCTCAAGGGAATATTGTAGCGTTCTCCCTTAACTTAGAAATGAAAAAAGGAATACCTAG
gb|AE016879.1|+|2933334-2933889|ARO:3005045|SatA [Bacillus anthracis str. Ames] 	34	500	0	466	555	247433-	466	ATTTAGATAATTTCCCGGAGATTGATGACAGTTTTATAGTGAATGCTCGGTTAATGCTTTCTCTTTCAAAAGTAAATAGACGCATAGAATATACAGTAGAAGACGTTCCGAGTTATGAAAAAAGTTATTTACAAAATGATAATGAAGAACTGGTGTACAATGAATATATAAATAAGCCAAATCAAATAATTTACATAGCACTGTTACATAACCAAATTATTGGATTCATAGTATTGAAAAAGAATTGGAATAACTATGCTTACATAGAAGATATAACGGTGGATAAAAAATATCGTACACTCGGGGTTGGTAAAAGATTAATTGCTCAAGCAAAACAGTGGGCAAAAGAAGGCAACATGCCAGGTATCATGCTTGAAACGCAAAATAATAATGTCGCAGCATGTAAGTTCTATGAAAAATGCGGATTTGTAATTGGTGGATTTGATTTTCTTGTTTATAAAGGCTT
gb|JX870080|+|0-861|ARO:3001352|SHV-168 [Klebsiella pneumoniae] 	0	806	16	822	861	1612535+	806	ATGCGTTATATTCGCCTGTGTATTATCACCCTGTGAGCCACCCTGCCGCTGGCGGTACACGCCAGCCCGCAGCCGCTTGAGCAAATTAAACAAAGCGAAAGCCAGCTGTCGGGCCGCGTAGGCATGATAGAAATGGATCTGGCCAGCGGCCGCACGCTGACCGCCTGGCGCGCCGATGAACGCTTTCCCATGATGAGCACCTTTAAAGTAGTGCTCTGCGGCGCAGTGCTGGCGCGGGTGGATGCCGGTGACGAACAGCTGGAGCGAAAGATCCACTATCGCCAGCAGGATCTGGTGGACTACTCGCCGGTCAGCGAAAAACACCTTGCCGACGGCATGACGGTCGGCGAACTCTGCGCCGCCGCCATTACCATGAGCGATAACAGCGCCGCCAATCTGCTGCTGGCCACCGTCGGCGGCCCCGCAGGATTGACTGCCTTTTTGCGCCAGATCGGCGACAACGTCACCCGCCTTGACCGCTGGGAAACGGAACTGAATGAGGCGCTTCCCGGCGACGCCCGCGACACCACTACCCCGGCCAGCATGGCCGCGACCCTGCGCAAGCTGCTGACCAGCCAGCGTCTGAGCGCCCGTTCGCAACGGCAGCTGCTGCAGTGGATGGTGGACGATCGGGTCGCCGGACCGTTGATCCGCTCCGTGCTGCCGGCGGGCTGGTTTATCGCCGATAAGACCGGAGCTAGCAAGCGGGGTGCGCGCGGGATTGTCGCCCTGCTTGGCCCGAATAACAAAGCAGAGCGCATTGTGGTGATTTATCTGCGGGATACGCCGGCGAGCATGGCCGAGCG
gb|HQ425495|+|0-822|ARO:3001482|OXA-197 [Acinetobacter nosocomialis] 	0	767	54149	54916	822	246080-	767	ATGAACATTAAAGCACTCTTACTTATAACAAGCGCTATTTTTATTTCAGCCTGCTCACCTTATATAGTGACTGCTAATCCAAATCACAGCGCTTCAAAATCTGATGTAAAAGCAGAGAAAATTAAAAATTTATTTAACGAAGCACACACTACGGGTGTTTTAGTTATCCAACAAGGCCAAACTCAACAAAGCTATGGTAATGATCTTGCTCGTGCTTCGACCGAGTATGTACCTGCTTCGACCTTCAAAATGCTTAATGCTTTGATCGGCCTTGAGCACCATAAGGCAACCACCACAGAAGTATTTAAGTGGGATGGTAAAAAAAGGTTATTCCCAGAATGGGAAAAGGACATGACCCTAGGCGATGCCATGAAAGCTTCCGCTATTCCAGTTTATCAAGATTTAGCTCGTCGTATTGGACTTGAGCTCATGTCTAAGGAAGTGAAGCGTGTTGGTTATGGCAATGCAGATATCGGTACCCAAGTCGATAATTTTTGGCTGGTGGGTCCTTTAAAAATTACTCCTCAGCAAGAGGCACAGTTTGCTTACAAGCTAGCTAATAAAACGCTTCCATTTAGCCAAAAAGTCCAAGATGAAGTGCAATCCATGCTATTCATAGAAGAAAAGAATGGAAACAAAATATACGCAAAAAGTGGTTGGGGATGGGATGTAAACCCACAAGTAGGCTGGTTAACTGGATGGGTTGTTCAGCCTCAAGGGAATATTGTAGCGTTCTCCCTTAACTTAGAAATGAAAAAAGGAATACC
gb|X55640|+|111-972|ARO:3001064|SHV-5 [Klebsiella pneumoniae] 	0	806	16	822	861	1612535+	806	ATGCGTTATATTCGCCTGTGTATTATCACCCTGTGAGCCACCCTGCCGCTGGCGGTACACGCCAGCCCGCAGCCGCTTGAGCAAATTAAACAAAGCGAAAGCCAGCTGTCGGGCCGCGTAGGCATGATAGAAATGGATCTGGCCAGCGGCCGCACGCTGACCGCCTGGCGCGCCGATGAACGCTTTCCCATGATGAGCACCTTTAAAGTAGTGCTCTGCGGCGCAGTGCTGGCGCGGGTGGATGCCGGTGACGAACAGCTGGAGCGAAAGATCCACTATCGCCAGCAGGATCTGGTGGACTACTCGCCGGTCAGCGAAAAACACCTTGCCGACGGCATGACGGTCGGCGAACTCTGCGCCGCCGCCATTACCATGAGCGATAACAGCGCCGCCAATCTGCTGCTGGCCACCGTCGGCGGCCCCGCAGGATTGACTGCCTTTTTGCGCCAGATCGGCGACAACGTCACCCGCCTTGACCGCTGGGAAACGGAACTGAATGAGGCGCTTCCCGGCGACGCCCGCGACACCACTACCCCGGCCAGCATGGCCGCGACCCTGCGCAAGCTGCTGACCAGCCAGCGTCTGAGCGCCCGTTCGCAACGGCAGCTGCTGCAGTGGATGGTGGACGATCGGGTCGCCGGACCGTTGATCCGCTCCGTGCTGCCGGCGGGCTGGTTTATCGCCGATAAGACCGGAGCTAGCAAGCGGGGTGCGCGCGGGATTGTCGCCCTGCTTGGCCCGAATAACAAAGCAGAGCGCATTGTGGTGATTTATCTGCGGGATACGCCGGCGAGCATGGCCGAGCG
gb|DQ149247|+|0-825|ARO:3001703|OXA-86 [Acinetobacter baumannii] 	0	770	54149	54919	825	246080-	770	ATGAACATTAAAGCACTCTTACTTATAACAAGCGCTATTTTTATTTCAGCCTGCTCACCTTATATAGTGACTGCTAATCCAAATCACAGCGCTTCAAAATCTGATGTAAAAGCAGAGAAAATTAAAAATTTATTTAACGAAGCACACACTACGGGTGTTTTAGTTATCCAACAAGGCCAAACTCAACAAAGCTATGGTAATGATCTTGCTCGTGCTTCGACCGAGTATGTACCTGCTTCGACCTTCAAAATGCTTAATGCTTTGATCGGCCTTGAGCACCATAAGGCAACCACCACAGAAGTATTTAAGTGGGATGGTAAAAAAAGGTTATTCCCAGAATGGGAAAAGGACATGACCCTAGGCGATGCCATGAAAGCTTCCGCTATTCCAGTTTATCAAGATTTAGCTCGTCGTATTGGACTTGAGCTCATGTCTAAGGAAGTGAAGCGTGTTGGTTATGGCAATGCAGATATCGGTACCCAAGTCGATAATTTTTGGCTGGTGGGTCCTTTAAAAATTACTCCTCAGCAAGAGGCACAGTTTGCTTACAAGCTAGCTAATAAAACGCTTCCATTTAGCCAAAAAGTCCAAGATGAAGTGCAATCCATGCTATTCATAGAAGAAAAGAATGGAAACAAAATATACGCAAAAAGTGGTTGGGGATGGGATGTAAACCCACAAGTAGGCTGGTTAACTGGATGGGTTGTTCAGCCTCAAGGGAATATTGTAGCGTTCTCCCTTAACTTAGAAATGAAAAAAGGAATACCTAG
gb|KX354370.1|+|0-1194|ARO:3004343|PDC-80 [Pseudomonas aeruginosa] 	0	1139	35513	36652	1194	232416+	1139	ATGCGCGATACCAGATTCCCCTGCCTGTGCGGCATCGCCGCTTCCACACTGCTGTTCGCCACCACCCCGGCCATTGCCGATGAGGCCCCGGCGGATCGCCTGAAGGCACTGGTCGACGCCGCCGTACAACCGGTGATGAAGGCCAATGACATTCCGGGCCTGGCCGTAGCCATCAGCCTGAAAGGAGAACCGCATTACTTCAGCTATGGGCTGGCCTCGAAAGAGGACGGCCGCCGGGTGACGCCGGAGACCCTGTTCGAGATCGGCTCGGTGAGCAAGACCTTCACCGTCACCCTCGCCGGCTATGCCCTGGCCCAGGACAAGATGCGCCTCGACGACCGCGCCAGCCAGCACTGGCCGGCACTGCAGGGCAGCCGCTTCGACGGCATCAGCCTGCTCGACCTCGCGACCTATACCGCCGGCGGCTTGCCGCTGCAGTTCCCCGACTCGGTGCAGAAGGACCAGGCACAGATCCGCGACTACTACCGCCAGTGGCAGCCGACCTACGCGCCGGGCAGCCAGCGCCTCTATTCCAACCCGAGCATCGGCCTGTTCGGCTATCTCGCCGCGCGCAGCCTGGGCCAGCCGTTCGAACGGCTCATGGAGCAGCAATTGTTCCCGGCACTGGGCCTCGAACAGACCCACCTCGACGTGCCCGAGGCGGCGCTGGCGCAGTACGCCCAGGGCTACGGCAAGGACGACCGCCCGCTACGGGTCGGTCCCGGCCCGCTGGATGCCGAAGGCTACGGGGTGAAGACCAGCGCGGCCGACCTGCTGCGCTTCGTCGATGCCAACCTGCATCCGGAGCGCCTGGACAGGCCCTGGGCGCAGGCGCTCGATGCCACCCATCGCGGTTACTACAAGGTCGGCGACATGACCCAGGGCCTGGGCTGGGAAGCCTACGACTGGCCGATCTCCCTGAAGCGCCTGCAGGCCGGCAACTCGACGCCGATGGCGCTGCAACCACACAGGATCGCCAGGCTGCCCGCGCCACAGGCGCTGGAGGGCCAGCGCCTGCTGAACAAGACCGGCTCCACCAACGGCTTCGGCGCCTACGTGGCGTTCGTCCCGGGCCGCGACCTGGGCCTGGTGATCCTGGCCAACCGCAACTATCCCAATGCCGAGCGGGTGAAGATCGC
gb|HQ734811|+|0-825|ARO:3001665|OXA-200 [Acinetobacter baumannii] 	0	770	54149	54919	825	246080-	770	ATGAACATTAAAGCACTCTTACTTATAACAAGCGCTATTTTTATTTCAGCCTGCTCACCTTATATAGTGACTGCTAATCCAAATCACAGCGCTTCAAAATCTGATGTAAAAGCAGAGAAAATTAAAAATTTATTTAACGAAGCACACACTACGGGTGTTTTAGTTATCCAACAAGGCCAAACTCAACAAAGCTATGGTAATGATCTTGCTCGTGCTTCGACCGAGTATGTACCTGCTTCGACCTTCAAAATGCTTAATGCTTTGATCGGCCTTGAGCACCATAAGGCAACCACCACAGAAGTATTTAAGTGGGATGGTAAAAAAAGGTTATTCCCAGAATGGGAAAAGGACATGACCCTAGGCGATGCCATGAAAGCTTCCGCTATTCCAGTTTATCAAGATTTAGCTCGTCGTATTGGACTTGAGCTCATGTCTAAGGAAGTGAAGCGTGTTGGTTATGGCAATGCAGATATCGGTACCCAAGTCGATAATTTTTGGCTGGTGGGTCCTTTAAAAATTACTCCTCAGCAAGAGGCACAGTTTGCTTACAAGCTAGCTAATAAAACGCTTCCATTTAGCCAAAAAGTCCAAGATGAAGTGCAATCCATGCTATTCATAGAAGAAAAGAATGGAAACAAAATATACGCAAAAAGTGGTTGGGGATGGGATGTAAACCCACAAGTAGGCTGGTTAACTGGATGGGTTGTTCAGCCTCAAGGGAATATTGTAGCGTTCTCCCTTAACTTAGAAATGAAAAAAGGAATACCTAG
gb|MG601730.1|+|0-1152|ARO:3003852|ADC-6 [Acinetobacter baumannii] 	0	1097	63	1160	1152	126080+	1097	ATGCGATTTAAAAAAATTTCTTGTCTACTTTTATCCCCGCTTTTTATTTTTAGTACCTCAATTTATGCGGGCAATACACCAAAAGACCAAGAAATTAAAAAACTGGTAGATCAAAACTTTAAACCGTTATTAGAAAAATATGATGTGCCAGGTATGGCTGTGGGTGTTATTCAAAATAATAAAAAGTATGAAATGTATTATGGTCTTCAATCTGTTCAAGATAAAAAAGCCGTAAATAGCAGTACTATTTTTGAGCTAGGTTCTGTCAGTAAATTATTTACCGCGACAGCAGGTGGATATGCAAAAAATAAAGGAAAAATCTCTTTTGACGATACGCCTGGTAAGTATTGGAAAGAACTAAAAAATACACCGATTGACCAAGTTAACTTACTTCAACTCGCGACGTATACAAGTGGTAACCTTGCCTTGCAATTTCCAGATGAAGTAAAAACAGATCAGCAAGTTTTAACATTTTTTAAAGACTGGAAACCTAAAAACTCAATCGGTGAATATCGACAATATTCAAACCCAAGCATTGGTTTATTTGGAAAAGTTGTAGCTTTGTCTATGAATAAACCTTTCGACCAAGTCTTAGAAAAAACAATTTTTCCGGCCCTTGGCTTAAAACATAGCTATGTAAATGTACCTAAGACCCAGATGCAAAACTATGCTTTTGGCTATAACCAAGAAAATCAGCCGATTCGAGTTAACCCCGGCCCACTCGATGCCCCAGCATATGGCGTCAAATCGACACTACCCGACATGTTGAGTTTTATTCATGCCAACCTAAATCCACAAAAATATCCAGCAGATATTCAACGGGCAATTAATGAAACACATCAGGGTCGCTATCAAGTAAATACCATGTATCAGGCACTCGGTTGGGAAGAGTTTTCTTATCCGGCAACGTTACAAACTTTATTAGACAGTAATTCAGAACAGATTGTGATGAAACCTAATAAAGTGACTGCTATTTCAAAGGAACCTTCAGTTAAGATGTACCATAAAACTGGCTCAACTACCGGTTTCGGAACATATGTGGTGTTTATTCCTAAAGAAAATATTGGTTTAGTCATGTTAACCAATAAACGTATTCC
gb|AB871653|+|11870-12695|ARO:3001557|OXA-371 [Acinetobacter baumannii] 	0	770	54149	54919	825	246080-	770	ATGAACATTAAAGCACTCTTACTTATAACAAGCGCTATTTTTATTTCAGCCTGCTCACCTTATATAGTGACTGCTAATCCAAATCACAGCGCTTCAAAATCTGATGTAAAAGCAGAGAAAATTAAAAATTTATTTAACGAAGCACACACTACGGGTGTTTTAGTTATCCAACAAGGCCAAACTCAACAAAGCTATGGTAATGATCTTGCTCGTGCTTCGACCGAGTATGTACCTGCTTCGACCTTCAAAATGCTTAATGCTTTGATCGGCCTTGAGCACCATAAGGCAACCACCACAGAAGTATTTAAGTGGGATGGTAAAAAAAGGTTATTCCCAGAATGGGAAAAGGACATGACCCTAGGCGATGCCATGAAAGCTTCCGCTATTCCAGTTTATCAAGATTTAGCTCGTCGTATTGGACTTGAGCTCATGTCTAAGGAAGTGAAGCGTGTTGGTTATGGCAATGCAGATATCGGTACCCAAGTCGATAATTTTTGGCTGGTGGGTCCTTTAAAAATTACTCCTCAGCAAGAGGCACAGTTTGCTTACAAGCTAGCTAATAAAACGCTTCCATTTAGCCAAAAAGTCCAAGATGAAGTGCAATCCATGCTATTCATAGAAGAAAAGAATGGAAACAAAATATACGCAAAAAGTGGTTGGGGATGGGATGTAAACCCACAAGTAGGCTGGTTAACTGGATGGGTTGTTCAGCCTCAAGGGAATATTGTAGCGTTCTCCCTTAACTTAGAAATGAAAAAAGGAATACCTAG
gb|AL513383|+|161910-162771|ARO:3000873|TEM-1 [Salmonella enterica subsp. enterica serovar Typhi str. CT18] 	0	806	46	852	861	3478183-	806	ATGAGTATTCAACATTTCCGTGTCGCCCTTATTCCCTTTTTTGCGGCATTTTGCCTTCCTGTTTTTGCTCACCCAGAAACGCTGGTGAAAGTAAAAGATGCTGAAGATCAGTTGGGTGCACGAGTGGGTTACATCGAGCTGGATCTCAACAGCGGTAAGATCCTTGAGAGTTTTCGCCCCGAAGAACGTTTTCCAATGATGAGCACTTTTAAAGTTCTGCTATGTGGTGCGGTATTATCCCGTGTTGACGCCGGGCAAGAGCAACTCGGTCGCCGCATACACTATTCTCAGAATGACTTGGTTGAGTACTCACCAGTCACAGAAAAGCATCTTACGGATGGCATGACAGTAAGAGAATTATGCAGTGCTGCCATAACCATGAGTGATAACACTGCGGCCAACTTACTTCTGACAACGATCGGAGGACCGAAGGAGCTAACCGCTTTTTTGCACAACATGGGGGATCATGTAACCCGCCTTGATCGTTGGGAACCGGAGCTGAATGAAGCCATACCAAACGACGAGCGTGACACCACGATGCCTGCAGCAATGGCAACAACGTTGCGCAAACTATTAACTGGCGAACTACTTACTCTAGCTTCCCGGCAACAATTAATAGACTGGATGGAGGCGGATAAAGTTGCAGGACCACTTCTGCGCTCGGCCCTTCCGGCTGGCTGGTTTATTGCTGATAAATCTGGAGCCGGTGAGCGTGGATCTCGCGGTATCATTGCAGCACTGGGGCCAGATGGTAAGCCCTCCCGTATCGTAGTTATCTACACGACGGGGAGTCAGGCAACTATGGA
gb|HQ734812|+|0-825|ARO:3001666|OXA-201 [Acinetobacter baumannii] 	0	770	54149	54919	825	246080-	770	ATGAACATTAAAGCACTCTTACTTATAACAAGCGCTATTTTTATTTCAGCCTGCTCACCTTATATAGTGACTGCTAATCCAAATCACAGCGCTTCAAAATCTGATGTAAAAGCAGAGAAAATTAAAAATTTATTTAACGAAGCACACACTACGGGTGTTTTAGTTATCCAACAAGGCCAAACTCAACAAAGCTATGGTAATGATCTTGCTCGTGCTTCGACCGAGTATGTACCTGCTTCGACCTTCAAAATGCTTAATGCTTTGATCGGCCTTGAGCACCATAAGGCAACCACCACAGAAGTATTTAAGTGGGATGGTAAAAAAAGGTTATTCCCAGAATGGGAAAAGGACATGACCCTAGGCGATGCCATGAAAGCTTCCGCTATTCCAGTTTATCAAGATTTAGCTCGTCGTATTGGACTTGAGCTCATGTCTAAGGAAGTGAAGCGTGTTGGTTATGGCAATGCAGATATCGGTACCCAAGTCGATAATTTTTGGCTGGTGGGTCCTTTAAAAATTACTCCTCAGCAAGAGGCACAGTTTGCTTACAAGCTAGCTAATAAAACGCTTCCATTTAGCCAAAAAGTCCAAGATGAAGTGCAATCCATGCTATTCATAGAAGAAAAGAATGGAAACAAAATATACGCAAAAAGTGGTTGGGGATGGGATGTAAACCCACAAGTAGGCTGGTTAACTGGATGGGTTGTTCAGCCTCAAGGGAATATTGTAGCGTTCTCCCTTAACTTAGAAATGAAAAAAGGAATACCTAG
gb|DQ348075|+|0-825|ARO:3001704|OXA-87 [Acinetobacter baumannii] 	0	770	54149	54919	825	246080-	770	ATGAACATTAAAGCACTCTTACTTATAACAAGCGCTATTTTTATTTCAGCCTGCTCACCTTATATAGTGACTGCTAATCCAAATCACAGCGCTTCAAAATCTGATGTAAAAGCAGAGAAAATTAAAAATTTATTTAACGAAGCACACACTACGGGTGTTTTAGTTATCCAACAAGGCCAAACTCAACAAAGCTATGGTAATGATCTTGCTCGTGCTTCGACCGAGTATGTACCTGCTTCGACCTTCAAAATGCTTAATGCTTTGATCGGCCTTGAGCACCATAAGGCAACCACCACAGAAGTATTTAAGTGGGATGGTAAAAAAAGGTTATTCCCAGAATGGGAAAAGGACATGACCCTAGGCGATGCCATGAAAGCTTCCGCTATTCCAGTTTATCAAGATTTAGCTCGTCGTATTGGACTTGAGCTCATGTCTAAGGAAGTGAAGCGTGTTGGTTATGGCAATGCAGATATCGGTACCCAAGTCGATAATTTTTGGCTGGTGGGTCCTTTAAAAATTACTCCTCAGCAAGAGGCACAGTTTGCTTACAAGCTAGCTAATAAAACGCTTCCATTTAGCCAAAAAGTCCAAGATGAAGTGCAATCCATGCTATTCATAGAAGAAAAGAATGGAAACAAAATATACGCAAAAAGTGGTTGGGGATGGGATGTAAACCCACAAGTAGGCTGGTTAACTGGATGGGTTGTTCAGCCTCAAGGGAATATTGTAGCGTTCTCCCTTAACTTAGAAATGAAAAAAGGAATACCTAG
gb|AY288915|+|0-861|ARO:3001107|SHV-50 [Klebsiella pneumoniae] 	0	806	16	822	861	1612535+	806	ATGCGTTATATTCGCCTGTGTATTATCACCCTGTGAGCCACCCTGCCGCTGGCGGTACACGCCAGCCCGCAGCCGCTTGAGCAAATTAAACAAAGCGAAAGCCAGCTGTCGGGCCGCGTAGGCATGATAGAAATGGATCTGGCCAGCGGCCGCACGCTGACCGCCTGGCGCGCCGATGAACGCTTTCCCATGATGAGCACCTTTAAAGTAGTGCTCTGCGGCGCAGTGCTGGCGCGGGTGGATGCCGGTGACGAACAGCTGGAGCGAAAGATCCACTATCGCCAGCAGGATCTGGTGGACTACTCGCCGGTCAGCGAAAAACACCTTGCCGACGGCATGACGGTCGGCGAACTCTGCGCCGCCGCCATTACCATGAGCGATAACAGCGCCGCCAATCTGCTGCTGGCCACCGTCGGCGGCCCCGCAGGATTGACTGCCTTTTTGCGCCAGATCGGCGACAACGTCACCCGCCTTGACCGCTGGGAAACGGAACTGAATGAGGCGCTTCCCGGCGACGCCCGCGACACCACTACCCCGGCCAGCATGGCCGCGACCCTGCGCAAGCTGCTGACCAGCCAGCGTCTGAGCGCCCGTTCGCAACGGCAGCTGCTGCAGTGGATGGTGGACGATCGGGTCGCCGGACCGTTGATCCGCTCCGTGCTGCCGGCGGGCTGGTTTATCGCCGATAAGACCGGAGCTAGCAAGCGGGGTGCGCGCGGGATTGTCGCCCTGCTTGGCCCGAATAACAAAGCAGAGCGCATTGTGGTGATTTATCTGCGGGATACGCCGGCGAGCATGGCCGAGCG
gb|KF513177|+|0-861|ARO:3001356|SHV-172 [Klebsiella pneumoniae] 	0	806	16	822	861	1612535+	806	ATGCGTTATATTCGCCTGTGTATTATCACCCTGTGAGCCACCCTGCCGCTGGCGGTACACGCCAGCCCGCAGCCGCTTGAGCAAATTAAACAAAGCGAAAGCCAGCTGTCGGGCCGCGTAGGCATGATAGAAATGGATCTGGCCAGCGGCCGCACGCTGACCGCCTGGCGCGCCGATGAACGCTTTCCCATGATGAGCACCTTTAAAGTAGTGCTCTGCGGCGCAGTGCTGGCGCGGGTGGATGCCGGTGACGAACAGCTGGAGCGAAAGATCCACTATCGCCAGCAGGATCTGGTGGACTACTCGCCGGTCAGCGAAAAACACCTTGCCGACGGCATGACGGTCGGCGAACTCTGCGCCGCCGCCATTACCATGAGCGATAACAGCGCCGCCAATCTGCTGCTGGCCACCGTCGGCGGCCCCGCAGGATTGACTGCCTTTTTGCGCCAGATCGGCGACAACGTCACCCGCCTTGACCGCTGGGAAACGGAACTGAATGAGGCGCTTCCCGGCGACGCCCGCGACACCACTACCCCGGCCAGCATGGCCGCGACCCTGCGCAAGCTGCTGACCAGCCAGCGTCTGAGCGCCCGTTCGCAACGGCAGCTGCTGCAGTGGATGGTGGACGATCGGGTCGCCGGACCGTTGATCCGCTCCGTGCTGCCGGCGGGCTGGTTTATCGCCGATAAGACCGGAGCTAGCAAGCGGGGTGCGCGCGGGATTGTCGCCCTGCTTGGCCCGAATAACAAAGCAGAGCGCATTGTGGTGATTTATCTGCGGGATACGCCGGCGAGCATGGCCGAGCG
gb|HQ734813|+|0-825|ARO:3001667|OXA-202 [Acinetobacter baumannii] 	0	770	54149	54919	825	246080-	770	ATGAACATTAAAGCACTCTTACTTATAACAAGCGCTATTTTTATTTCAGCCTGCTCACCTTATATAGTGACTGCTAATCCAAATCACAGCGCTTCAAAATCTGATGTAAAAGCAGAGAAAATTAAAAATTTATTTAACGAAGCACACACTACGGGTGTTTTAGTTATCCAACAAGGCCAAACTCAACAAAGCTATGGTAATGATCTTGCTCGTGCTTCGACCGAGTATGTACCTGCTTCGACCTTCAAAATGCTTAATGCTTTGATCGGCCTTGAGCACCATAAGGCAACCACCACAGAAGTATTTAAGTGGGATGGTAAAAAAAGGTTATTCCCAGAATGGGAAAAGGACATGACCCTAGGCGATGCCATGAAAGCTTCCGCTATTCCAGTTTATCAAGATTTAGCTCGTCGTATTGGACTTGAGCTCATGTCTAAGGAAGTGAAGCGTGTTGGTTATGGCAATGCAGATATCGGTACCCAAGTCGATAATTTTTGGCTGGTGGGTCCTTTAAAAATTACTCCTCAGCAAGAGGCACAGTTTGCTTACAAGCTAGCTAATAAAACGCTTCCATTTAGCCAAAAAGTCCAAGATGAAGTGCAATCCATGCTATTCATAGAAGAAAAGAATGGAAACAAAATATACGCAAAAAGTGGTTGGGGATGGGATGTAAACCCACAAGTAGGCTGGTTAACTGGATGGGTTGTTCAGCCTCAAGGGAATATTGTAGCGTTCTCCCTTAACTTAGAAATGAAAAAAGGAATACCTAG
gb|DQ392963|+|8-833|ARO:3001626|OXA-88 [Acinetobacter baumannii] 	0	770	54149	54919	825	246080-	770	ATGAACATTAAAGCACTCTTACTTATAACAAGCGCTATTTTTATTTCAGCCTGCTCACCTTATATAGTGACTGCTAATCCAAATCACAGCGCTTCAAAATCTGATGTAAAAGCAGAGAAAATTAAAAATTTATTTAACGAAGCACACACTACGGGTGTTTTAGTTATCCAACAAGGCCAAACTCAACAAAGCTATGGTAATGATCTTGCTCGTGCTTCGACCGAGTATGTACCTGCTTCGACCTTCAAAATGCTTAATGCTTTGATCGGCCTTGAGCACCATAAGGCAACCACCACAGAAGTATTTAAGTGGGATGGTAAAAAAAGGTTATTCCCAGAATGGGAAAAGGACATGACCCTAGGCGATGCCATGAAAGCTTCCGCTATTCCAGTTTATCAAGATTTAGCTCGTCGTATTGGACTTGAGCTCATGTCTAAGGAAGTGAAGCGTGTTGGTTATGGCAATGCAGATATCGGTACCCAAGTCGATAATTTTTGGCTGGTGGGTCCTTTAAAAATTACTCCTCAGCAAGAGGCACAGTTTGCTTACAAGCTAGCTAATAAAACGCTTCCATTTAGCCAAAAAGTCCAAGATGAAGTGCAATCCATGCTATTCATAGAAGAAAAGAATGGAAACAAAATATACGCAAAAAGTGGTTGGGGATGGGATGTAAACCCACAAGTAGGCTGGTTAACTGGATGGGTTGTTCAGCCTCAAGGGAATATTGTAGCGTTCTCCCTTAACTTAGAAATGAAAAAAGGAATACCTAG
gb|JQ692087.1|+|0-1152|ARO:3004620|ADC-60 [Acinetobacter baumannii] 	0	1097	63	1160	1152	126080+	1097	ATGCGATTTAAAAAAATTTCTTGTCTACTTTTATCCCCGCTTTTTATTTTTAGTACCTCAATTTATGCGGGCAATACACCAAAAGACCAAGAAATTAAAAAACTGGTAGATCAAAACTTTAAACCGTTATTAGAAAAATATGATGTGCCAGGTATGGCTGTGGGTGTTATTCAAAATAATAAAAAGTATGAAATGTATTATGGTCTTCAATCTGTTCAAGATAAAAAAGCCGTAAATAGCAGTACTATTTTTGAGCTAGGTTCTGTCAGTAAATTATTTACCGCGACAGCAGGTGGATATGCAAAAAATAAAGGAAAAATCTCTTTTGACGATACGCCTGGTAAGTATTGGAAAGAACTAAAAAATACACCGATTGACCAAGTTAACTTACTTCAACTCGCGACGTATACAAGTGGTAACCTTGCCTTGCAATTTCCAGATGAAGTAAAAACAGATCAGCAAGTTTTAACATTTTTTAAAGACTGGAAACCTAAAAACTCAATCGGTGAATATCGACAATATTCAAACCCAAGCATTGGTTTATTTGGAAAAGTTGTAGCTTTGTCTATGAATAAACCTTTCGACCAAGTCTTAGAAAAAACAATTTTTCCGGCCCTTGGCTTAAAACATAGCTATGTAAATGTACCTAAGACCCAGATGCAAAACTATGCTTTTGGCTATAACCAAGAAAATCAGCCGATTCGAGTTAACCCCGGCCCACTCGATGCCCCAGCATATGGCGTCAAATCGACACTACCCGACATGTTGAGTTTTATTCATGCCAACCTAAATCCACAAAAATATCCAGCAGATATTCAACGGGCAATTAATGAAACACATCAGGGTCGCTATCAAGTAAATACCATGTATCAGGCACTCGGTTGGGAAGAGTTTTCTTATCCGGCAACGTTACAAACTTTATTAGACAGTAATTCAGAACAGATTGTGATGAAACCTAATAAAGTGACTGCTATTTCAAAGGAACCTTCAGTTAAGATGTACCATAAAACTGGCTCAACTACCGGTTTCGGAACATATGTGGTGTTTATTCCTAAAGAAAATATTGGTTTAGTCATGTTAACCAATAAACGTATTCC
gb|AF093512|+|197-1058|ARO:3000882|TEM-10 [Morganella morganii] 	0	806	46	852	861	3478183-	806	ATGAGTATTCAACATTTCCGTGTCGCCCTTATTCCCTTTTTTGCGGCATTTTGCCTTCCTGTTTTTGCTCACCCAGAAACGCTGGTGAAAGTAAAAGATGCTGAAGATCAGTTGGGTGCACGAGTGGGTTACATCGAGCTGGATCTCAACAGCGGTAAGATCCTTGAGAGTTTTCGCCCCGAAGAACGTTTTCCAATGATGAGCACTTTTAAAGTTCTGCTATGTGGTGCGGTATTATCCCGTGTTGACGCCGGGCAAGAGCAACTCGGTCGCCGCATACACTATTCTCAGAATGACTTGGTTGAGTACTCACCAGTCACAGAAAAGCATCTTACGGATGGCATGACAGTAAGAGAATTATGCAGTGCTGCCATAACCATGAGTGATAACACTGCGGCCAACTTACTTCTGACAACGATCGGAGGACCGAAGGAGCTAACCGCTTTTTTGCACAACATGGGGGATCATGTAACCCGCCTTGATCGTTGGGAACCGGAGCTGAATGAAGCCATACCAAACGACGAGCGTGACACCACGATGCCTGCAGCAATGGCAACAACGTTGCGCAAACTATTAACTGGCGAACTACTTACTCTAGCTTCCCGGCAACAATTAATAGACTGGATGGAGGCGGATAAAGTTGCAGGACCACTTCTGCGCTCGGCCCTTCCGGCTGGCTGGTTTATTGCTGATAAATCTGGAGCCGGTGAGCGTGGATCTCGCGGTATCATTGCAGCACTGGGGCCAGATGGTAAGCCCTCCCGTATCGTAGTTATCTACACGACGGGGAGTCAGGCAACTATGGA
gb|HQ998857|+|0-825|ARO:3001664|OXA-203 [Acinetobacter baumannii] 	0	770	54149	54919	825	246080-	770	ATGAACATTAAAGCACTCTTACTTATAACAAGCGCTATTTTTATTTCAGCCTGCTCACCTTATATAGTGACTGCTAATCCAAATCACAGCGCTTCAAAATCTGATGTAAAAGCAGAGAAAATTAAAAATTTATTTAACGAAGCACACACTACGGGTGTTTTAGTTATCCAACAAGGCCAAACTCAACAAAGCTATGGTAATGATCTTGCTCGTGCTTCGACCGAGTATGTACCTGCTTCGACCTTCAAAATGCTTAATGCTTTGATCGGCCTTGAGCACCATAAGGCAACCACCACAGAAGTATTTAAGTGGGATGGTAAAAAAAGGTTATTCCCAGAATGGGAAAAGGACATGACCCTAGGCGATGCCATGAAAGCTTCCGCTATTCCAGTTTATCAAGATTTAGCTCGTCGTATTGGACTTGAGCTCATGTCTAAGGAAGTGAAGCGTGTTGGTTATGGCAATGCAGATATCGGTACCCAAGTCGATAATTTTTGGCTGGTGGGTCCTTTAAAAATTACTCCTCAGCAAGAGGCACAGTTTGCTTACAAGCTAGCTAATAAAACGCTTCCATTTAGCCAAAAAGTCCAAGATGAAGTGCAATCCATGCTATTCATAGAAGAAAAGAATGGAAACAAAATATACGCAAAAAGTGGTTGGGGATGGGATGTAAACCCACAAGTAGGCTGGTTAACTGGATGGGTTGTTCAGCCTCAAGGGAATATTGTAGCGTTCTCCCTTAACTTAGAAATGAAAAAAGGAATACCTAG
gb|DQ445683|+|0-825|ARO:3001625|OXA-89 [Acinetobacter baumannii] 	0	770	54149	54919	825	246080-	770	ATGAACATTAAAGCACTCTTACTTATAACAAGCGCTATTTTTATTTCAGCCTGCTCACCTTATATAGTGACTGCTAATCCAAATCACAGCGCTTCAAAATCTGATGTAAAAGCAGAGAAAATTAAAAATTTATTTAACGAAGCACACACTACGGGTGTTTTAGTTATCCAACAAGGCCAAACTCAACAAAGCTATGGTAATGATCTTGCTCGTGCTTCGACCGAGTATGTACCTGCTTCGACCTTCAAAATGCTTAATGCTTTGATCGGCCTTGAGCACCATAAGGCAACCACCACAGAAGTATTTAAGTGGGATGGTAAAAAAAGGTTATTCCCAGAATGGGAAAAGGACATGACCCTAGGCGATGCCATGAAAGCTTCCGCTATTCCAGTTTATCAAGATTTAGCTCGTCGTATTGGACTTGAGCTCATGTCTAAGGAAGTGAAGCGTGTTGGTTATGGCAATGCAGATATCGGTACCCAAGTCGATAATTTTTGGCTGGTGGGTCCTTTAAAAATTACTCCTCAGCAAGAGGCACAGTTTGCTTACAAGCTAGCTAATAAAACGCTTCCATTTAGCCAAAAAGTCCAAGATGAAGTGCAATCCATGCTATTCATAGAAGAAAAGAATGGAAACAAAATATACGCAAAAAGTGGTTGGGGATGGGATGTAAACCCACAAGTAGGCTGGTTAACTGGATGGGTTGTTCAGCCTCAAGGGAATATTGTAGCGTTCTCCCTTAACTTAGAAATGAAAAAAGGAATACCTAG
gb|AY289548|+|0-861|ARO:3001108|SHV-51 [Klebsiella pneumoniae] 	0	806	16	822	861	1612535+	806	ATGCGTTATATTCGCCTGTGTATTATCACCCTGTGAGCCACCCTGCCGCTGGCGGTACACGCCAGCCCGCAGCCGCTTGAGCAAATTAAACAAAGCGAAAGCCAGCTGTCGGGCCGCGTAGGCATGATAGAAATGGATCTGGCCAGCGGCCGCACGCTGACCGCCTGGCGCGCCGATGAACGCTTTCCCATGATGAGCACCTTTAAAGTAGTGCTCTGCGGCGCAGTGCTGGCGCGGGTGGATGCCGGTGACGAACAGCTGGAGCGAAAGATCCACTATCGCCAGCAGGATCTGGTGGACTACTCGCCGGTCAGCGAAAAACACCTTGCCGACGGCATGACGGTCGGCGAACTCTGCGCCGCCGCCATTACCATGAGCGATAACAGCGCCGCCAATCTGCTGCTGGCCACCGTCGGCGGCCCCGCAGGATTGACTGCCTTTTTGCGCCAGATCGGCGACAACGTCACCCGCCTTGACCGCTGGGAAACGGAACTGAATGAGGCGCTTCCCGGCGACGCCCGCGACACCACTACCCCGGCCAGCATGGCCGCGACCCTGCGCAAGCTGCTGACCAGCCAGCGTCTGAGCGCCCGTTCGCAACGGCAGCTGCTGCAGTGGATGGTGGACGATCGGGTCGCCGGACCGTTGATCCGCTCCGTGCTGCCGGCGGGCTGGTTTATCGCCGATAAGACCGGAGCTAGCAAGCGGGGTGCGCGCGGGATTGTCGCCCTGCTTGGCCCGAATAACAAAGCAGAGCGCATTGTGGTGATTTATCTGCGGGATACGCCGGCGAGCATGGCCGAGCG
gb|JQ753702.1|+|0-1152|ARO:3003879|ADC-61 [Acinetobacter baumannii] 	0	1097	63	1160	1152	126080+	1097	ATGCGATTTAAAAAAATTTCTTGTCTACTTTTATCCCCGCTTTTTATTTTTAGTACCTCAATTTATGCGGGCAATACACCAAAAGACCAAGAAATTAAAAAACTGGTAGATCAAAACTTTAAACCGTTATTAGAAAAATATGATGTGCCAGGTATGGCTGTGGGTGTTATTCAAAATAATAAAAAGTATGAAATGTATTATGGTCTTCAATCTGTTCAAGATAAAAAAGCCGTAAATAGCAGTACTATTTTTGAGCTAGGTTCTGTCAGTAAATTATTTACCGCGACAGCAGGTGGATATGCAAAAAATAAAGGAAAAATCTCTTTTGACGATACGCCTGGTAAGTATTGGAAAGAACTAAAAAATACACCGATTGACCAAGTTAACTTACTTCAACTCGCGACGTATACAAGTGGTAACCTTGCCTTGCAATTTCCAGATGAAGTAAAAACAGATCAGCAAGTTTTAACATTTTTTAAAGACTGGAAACCTAAAAACTCAATCGGTGAATATCGACAATATTCAAACCCAAGCATTGGTTTATTTGGAAAAGTTGTAGCTTTGTCTATGAATAAACCTTTCGACCAAGTCTTAGAAAAAACAATTTTTCCGGCCCTTGGCTTAAAACATAGCTATGTAAATGTACCTAAGACCCAGATGCAAAACTATGCTTTTGGCTATAACCAAGAAAATCAGCCGATTCGAGTTAACCCCGGCCCACTCGATGCCCCAGCATATGGCGTCAAATCGACACTACCCGACATGTTGAGTTTTATTCATGCCAACCTAAATCCACAAAAATATCCAGCAGATATTCAACGGGCAATTAATGAAACACATCAGGGTCGCTATCAAGTAAATACCATGTATCAGGCACTCGGTTGGGAAGAGTTTTCTTATCCGGCAACGTTACAAACTTTATTAGACAGTAATTCAGAACAGATTGTGATGAAACCTAATAAAGTGACTGCTATTTCAAAGGAACCTTCAGTTAAGATGTACCATAAAACTGGCTCAACTACCGGTTTCGGAACATATGTGGTGTTTATTCCTAAAGAAAATATTGGTTTAGTCATGTTAACCAATAAACGTATTCC
gb|AB634250|+|0-825|ARO:3001484|OXA-206 [Acinetobacter baumannii] 	0	770	54149	54919	825	246080-	770	ATGAACATTAAAGCACTCTTACTTATAACAAGCGCTATTTTTATTTCAGCCTGCTCACCTTATATAGTGACTGCTAATCCAAATCACAGCGCTTCAAAATCTGATGTAAAAGCAGAGAAAATTAAAAATTTATTTAACGAAGCACACACTACGGGTGTTTTAGTTATCCAACAAGGCCAAACTCAACAAAGCTATGGTAATGATCTTGCTCGTGCTTCGACCGAGTATGTACCTGCTTCGACCTTCAAAATGCTTAATGCTTTGATCGGCCTTGAGCACCATAAGGCAACCACCACAGAAGTATTTAAGTGGGATGGTAAAAAAAGGTTATTCCCAGAATGGGAAAAGGACATGACCCTAGGCGATGCCATGAAAGCTTCCGCTATTCCAGTTTATCAAGATTTAGCTCGTCGTATTGGACTTGAGCTCATGTCTAAGGAAGTGAAGCGTGTTGGTTATGGCAATGCAGATATCGGTACCCAAGTCGATAATTTTTGGCTGGTGGGTCCTTTAAAAATTACTCCTCAGCAAGAGGCACAGTTTGCTTACAAGCTAGCTAATAAAACGCTTCCATTTAGCCAAAAAGTCCAAGATGAAGTGCAATCCATGCTATTCATAGAAGAAAAGAATGGAAACAAAATATACGCAAAAAGTGGTTGGGGATGGGATGTAAACCCACAAGTAGGCTGGTTAACTGGATGGGTTGTTCAGCCTCAAGGGAATATTGTAGCGTTCTCCCTTAACTTAGAAATGAAAAAAGGAATACCTAG
gb|KF513178|+|0-861|ARO:3001357|SHV-173 [Klebsiella pneumoniae] 	0	806	16	822	861	1612535+	806	ATGCGTTATATTCGCCTGTGTATTATCACCCTGTGAGCCACCCTGCCGCTGGCGGTACACGCCAGCCCGCAGCCGCTTGAGCAAATTAAACAAAGCGAAAGCCAGCTGTCGGGCCGCGTAGGCATGATAGAAATGGATCTGGCCAGCGGCCGCACGCTGACCGCCTGGCGCGCCGATGAACGCTTTCCCATGATGAGCACCTTTAAAGTAGTGCTCTGCGGCGCAGTGCTGGCGCGGGTGGATGCCGGTGACGAACAGCTGGAGCGAAAGATCCACTATCGCCAGCAGGATCTGGTGGACTACTCGCCGGTCAGCGAAAAACACCTTGCCGACGGCATGACGGTCGGCGAACTCTGCGCCGCCGCCATTACCATGAGCGATAACAGCGCCGCCAATCTGCTGCTGGCCACCGTCGGCGGCCCCGCAGGATTGACTGCCTTTTTGCGCCAGATCGGCGACAACGTCACCCGCCTTGACCGCTGGGAAACGGAACTGAATGAGGCGCTTCCCGGCGACGCCCGCGACACCACTACCCCGGCCAGCATGGCCGCGACCCTGCGCAAGCTGCTGACCAGCCAGCGTCTGAGCGCCCGTTCGCAACGGCAGCTGCTGCAGTGGATGGTGGACGATCGGGTCGCCGGACCGTTGATCCGCTCCGTGCTGCCGGCGGGCTGGTTTATCGCCGATAAGACCGGAGCTAGCAAGCGGGGTGCGCGCGGGATTGTCGCCCTGCTTGGCCCGAATAACAAAGCAGAGCGCATTGTGGTGATTTATCTGCGGGATACGCCGGCGAGCATGGCCGAGCG
gb|M55547|+|0-825|ARO:3001404|OXA-9 [Klebsiella pneumoniae] 	0	770	39	809	825	48423030-	770	ATGAAAAAAATTTTGCTGCTGCATATGTTGGTGTTCGTTTCCGCCACTCTCCCAATCAGTTCCGTGGCTTCTGATGAGGTTGAAACGCTTAAATGCACCATCATCGCAGACGCCATTACCGGAAATACCTTATATGAGACCGGAGAATGTGCCCGTCGTGTGTCTCCGTGCTCGTCTTTTAAACTTCCATTGGCAATCATGGGGTTTTATAGTGGAATCTTGCAGTCGCCAAAATCACCTACGTGGGAATTGAAGCCGGAATACAACCCGTCTCCGAGAGATCGCACATACAAACAAGTCTATCCGGCGCTATGGCAAAGCGACTCTGTTGTCTGGTTCTCGCAGCAATTAACAAGCCGTCTGGGAGTTGATCGGTTCACGGAATACGTAAAGAAATTTGAGTACGGTAATCAAGATGTTTCCGGTGACTCGGGGAAGCATAACGGCTTGACCCAGTCATGGCTGATGTCGTCGCTCACCATATCTCCCAAGGAGCAAATTCAGTTTCTTCTACGCTTTGTCGCGCATAAGCTGCCTGTATCCGAAGCGGCTTATGACATGGCGTATGCCACAATCCCGCAGTACCAGGCAGCCGAAGGATGGGCTGTACATGGAAAAAGCGGCAGCGGCTGGCTTCGGGACAATAACGGCAAGATAAATGAAAGTCGTCCGCAGGGCTGGTTCGTGGGCTGGGCTGAAAAAAACGGACGGCAAGTTGTTTTCGCCCGATTGGAAATAGGAAAGGAAAAGTCCGATATTCCCGGCGGGTC
gb|AF495873|+|0-861|ARO:3000964|TEM-101 [Escherichia coli] 	0	806	46	852	861	3478183-	806	ATGAGTATTCAACATTTCCGTGTCGCCCTTATTCCCTTTTTTGCGGCATTTTGCCTTCCTGTTTTTGCTCACCCAGAAACGCTGGTGAAAGTAAAAGATGCTGAAGATCAGTTGGGTGCACGAGTGGGTTACATCGAGCTGGATCTCAACAGCGGTAAGATCCTTGAGAGTTTTCGCCCCGAAGAACGTTTTCCAATGATGAGCACTTTTAAAGTTCTGCTATGTGGTGCGGTATTATCCCGTGTTGACGCCGGGCAAGAGCAACTCGGTCGCCGCATACACTATTCTCAGAATGACTTGGTTGAGTACTCACCAGTCACAGAAAAGCATCTTACGGATGGCATGACAGTAAGAGAATTATGCAGTGCTGCCATAACCATGAGTGATAACACTGCGGCCAACTTACTTCTGACAACGATCGGAGGACCGAAGGAGCTAACCGCTTTTTTGCACAACATGGGGGATCATGTAACCCGCCTTGATCGTTGGGAACCGGAGCTGAATGAAGCCATACCAAACGACGAGCGTGACACCACGATGCCTGCAGCAATGGCAACAACGTTGCGCAAACTATTAACTGGCGAACTACTTACTCTAGCTTCCCGGCAACAATTAATAGACTGGATGGAGGCGGATAAAGTTGCAGGACCACTTCTGCGCTCGGCCCTTCCGGCTGGCTGGTTTATTGCTGATAAATCTGGAGCCGGTGAGCGTGGATCTCGCGGTATCATTGCAGCACTGGGGCCAGATGGTAAGCCCTCCCGTATCGTAGTTATCTACACGACGGGGAGTCAGGCAACTATGGA
gb|HG931732.1|+|0-825|ARO:3001559|OXA-373 [Acinetobacter johnsonii] 	0	770	156	929	825	5350482-	773	ATGAAAACTTTACAGTTGGGCCTCATCGTCCTCATTACTACCTTCGGTTCTGCATGTACCATAATAAGAAGCCCCTCCATAGAAACAGCTAAAAACCATGAGCAACAAAGTGCGCAGCAGCAGATCCAACAGGCCTTCGATCAACTCCAAACCACGGGGGTGATTGTCATAAAGGATAAGCATGGCTTACACAGCTACGGCAATGACTTGAGCCGTGCTCAGACACCCTATGTACCCGCCTCTACCTTTAAAATGCTGAATGCCTTAATCGGACTAGAACATGGTAAAGCAACCAGCACCGAGGTGTTTAAATGGGATGGTCAAAAGAACAGCTTCCCTGCTTGGGAAAAAGACATGACTTTAGGGCAAGCCATGCAAGCATCTGCCGTTCCTGTTTATCAGGAGCTAGCACGGCGCATTGGCCTAGATCTAATGCAAAAAGAAGTACAGCGCATTGGATATGGCAATCAACAGATTGGCACCGTTGTCGATAATTTTTGGTTAGTCGGTCCACTGCAAATTACGCCTGTTCAAGAAGTCCTTTTTGTAGAGAAGCTGGCCAATACGCAACTCGCTTTTAAGCCAGATGTGCAACATACCGTACAAGACATGCTGCTGATTGAACAAAAACCGAATTATAAACTCTACGCCAAATCTGGTTGGGGCATGGACCTAGAACCGCAAGTGGGCTGGTGGACAGGCTGGGTCGAAACAGCAACAGGTGAAAAAGTGTATTTTGCTTTGAATATGCATATGAAAACAGGAATTTCAGC
gb|KR057750.1|+|0-1116|ARO:3004344|PDC-81 [Pseudomonas aeruginosa] 	3	1061	35594	36652	1116	232416+	1058	GAGGCCCCGGCGGATCGCCTGAAGGCACTGGTCGACGCCGCCGTACAACCGGTGATGAAGGCCAATGACATTCCGGGCCTGGCCGTAGCCATCAGCCTGAAAGGAGAACCGCATTACTTCAGCTATGGGCTGGCCTCGAAAGAGGACGGCCGCCGGGTGACGCCGGAGACCCTGTTCGAGATCGGCTCGGTGAGCAAGACCTTCACCGTCACCCTCGCCGGCTATGCCCTGGCCCAGGACAAGATGCGCCTCGACGACCGCGCCAGCCAGCACTGGCCGGCACTGCAGGGCAGCCGCTTCGACGGCATCAGCCTGCTCGACCTCGCGACCTATACCGCCGGCGGCTTGCCGCTGCAGTTCCCCGACTCGGTGCAGAAGGACCAGGCACAGATCCGCGACTACTACCGCCAGTGGCAGCCGACCTACGCGCCGGGCAGCCAGCGCCTCTATTCCAACCCGAGCATCGGCCTGTTCGGCTATCTCGCCGCGCGCAGCCTGGGCCAGCCGTTCGAACGGCTCATGGAGCAGCAATTGTTCCCGGCACTGGGCCTCGAACAGACCCACCTCGACGTGCCCGAGGCGGCGCTGGCGCAGTACGCCCAGGGCTACGGCAAGGACGACCGCCCGCTACGGGTCGGTCCCGGCCCGCTGGATGCCGAAGGCTACGGGGTGAAGACCAGCGCGGCCGACCTGCTGCGCTTCGTCGATGCCAACCTGCATCCGGAGCGCCTGGACAGGCCCTGGGCGCAGGCGCTCGATGCCACCCATCGCGGTTACTACAAGGTCGGCGACATGACCCAGGGCCTGGGCTGGGAAGCCTACGACTGGCCGATCTCCCTGAAGCGCCTGCAGGCCGGCAACTCGACGCCGATGGCGCTGCAACCACACAGGATCGCCAGGCTGCCCGCGCCACAGGCGCTGGAGGGCCAGCGCCTGCTGAACAAGACCGGCTCCACCAACGGCTTCGGCGCCTACGTGGCGTTCGTCCCGGGCCGCGACCTGGGCCTGGTGATCCTGGCCAACCGCAACTATCCCAATGCCGAGCGGGTGAAGATCGC
gb|FR853176|+|0-825|ARO:3001486|OXA-208 [Acinetobacter baumannii] 	0	770	54149	54919	825	246080-	770	ATGAACATTAAAGCACTCTTACTTATAACAAGCGCTATTTTTATTTCAGCCTGCTCACCTTATATAGTGACTGCTAATCCAAATCACAGCGCTTCAAAATCTGATGTAAAAGCAGAGAAAATTAAAAATTTATTTAACGAAGCACACACTACGGGTGTTTTAGTTATCCAACAAGGCCAAACTCAACAAAGCTATGGTAATGATCTTGCTCGTGCTTCGACCGAGTATGTACCTGCTTCGACCTTCAAAATGCTTAATGCTTTGATCGGCCTTGAGCACCATAAGGCAACCACCACAGAAGTATTTAAGTGGGATGGTAAAAAAAGGTTATTCCCAGAATGGGAAAAGGACATGACCCTAGGCGATGCCATGAAAGCTTCCGCTATTCCAGTTTATCAAGATTTAGCTCGTCGTATTGGACTTGAGCTCATGTCTAAGGAAGTGAAGCGTGTTGGTTATGGCAATGCAGATATCGGTACCCAAGTCGATAATTTTTGGCTGGTGGGTCCTTTAAAAATTACTCCTCAGCAAGAGGCACAGTTTGCTTACAAGCTAGCTAATAAAACGCTTCCATTTAGCCAAAAAGTCCAAGATGAAGTGCAATCCATGCTATTCATAGAAGAAAAGAATGGAAACAAAATATACGCAAAAAGTGGTTGGGGATGGGATGTAAACCCACAAGTAGGCTGGTTAACTGGATGGGTTGTTCAGCCTCAAGGGAATATTGTAGCGTTCTCCCTTAACTTAGAAATGAAAAAAGGAATACCTAG
gb|AM231719|+|0-825|ARO:3001650|OXA-90 [Acinetobacter baumannii] 	0	770	54149	54919	825	246080-	770	ATGAACATTAAAGCACTCTTACTTATAACAAGCGCTATTTTTATTTCAGCCTGCTCACCTTATATAGTGACTGCTAATCCAAATCACAGCGCTTCAAAATCTGATGTAAAAGCAGAGAAAATTAAAAATTTATTTAACGAAGCACACACTACGGGTGTTTTAGTTATCCAACAAGGCCAAACTCAACAAAGCTATGGTAATGATCTTGCTCGTGCTTCGACCGAGTATGTACCTGCTTCGACCTTCAAAATGCTTAATGCTTTGATCGGCCTTGAGCACCATAAGGCAACCACCACAGAAGTATTTAAGTGGGATGGTAAAAAAAGGTTATTCCCAGAATGGGAAAAGGACATGACCCTAGGCGATGCCATGAAAGCTTCCGCTATTCCAGTTTATCAAGATTTAGCTCGTCGTATTGGACTTGAGCTCATGTCTAAGGAAGTGAAGCGTGTTGGTTATGGCAATGCAGATATCGGTACCCAAGTCGATAATTTTTGGCTGGTGGGTCCTTTAAAAATTACTCCTCAGCAAGAGGCACAGTTTGCTTACAAGCTAGCTAATAAAACGCTTCCATTTAGCCAAAAAGTCCAAGATGAAGTGCAATCCATGCTATTCATAGAAGAAAAGAATGGAAACAAAATATACGCAAAAAGTGGTTGGGGATGGGATGTAAACCCACAAGTAGGCTGGTTAACTGGATGGGTTGTTCAGCCTCAAGGGAATATTGTAGCGTTCTCCCTTAACTTAGAAATGAAAAAAGGAATACCTAG
gb|KF986255|+|16-841|ARO:3001560|OXA-374 [Acinetobacter baumannii] 	0	770	54149	54919	825	246080-	770	ATGAACATTAAAGCACTCTTACTTATAACAAGCGCTATTTTTATTTCAGCCTGCTCACCTTATATAGTGACTGCTAATCCAAATCACAGCGCTTCAAAATCTGATGTAAAAGCAGAGAAAATTAAAAATTTATTTAACGAAGCACACACTACGGGTGTTTTAGTTATCCAACAAGGCCAAACTCAACAAAGCTATGGTAATGATCTTGCTCGTGCTTCGACCGAGTATGTACCTGCTTCGACCTTCAAAATGCTTAATGCTTTGATCGGCCTTGAGCACCATAAGGCAACCACCACAGAAGTATTTAAGTGGGATGGTAAAAAAAGGTTATTCCCAGAATGGGAAAAGGACATGACCCTAGGCGATGCCATGAAAGCTTCCGCTATTCCAGTTTATCAAGATTTAGCTCGTCGTATTGGACTTGAGCTCATGTCTAAGGAAGTGAAGCGTGTTGGTTATGGCAATGCAGATATCGGTACCCAAGTCGATAATTTTTGGCTGGTGGGTCCTTTAAAAATTACTCCTCAGCAAGAGGCACAGTTTGCTTACAAGCTAGCTAATAAAACGCTTCCATTTAGCCAAAAAGTCCAAGATGAAGTGCAATCCATGCTATTCATAGAAGAAAAGAATGGAAACAAAATATACGCAAAAAGTGGTTGGGGATGGGATGTAAACCCACAAGTAGGCTGGTTAACTGGATGGGTTGTTCAGCCTCAAGGGAATATTGTAGCGTTCTCCCTTAACTTAGAAATGAAAAAAGGAATACCTAG
gb|HQ845196|+|0-861|ARO:3001109|SHV-52 [Klebsiella pneumoniae] 	0	806	16	822	861	1612535+	806	ATGCGTTATATTCGCCTGTGTATTATCACCCTGTGAGCCACCCTGCCGCTGGCGGTACACGCCAGCCCGCAGCCGCTTGAGCAAATTAAACAAAGCGAAAGCCAGCTGTCGGGCCGCGTAGGCATGATAGAAATGGATCTGGCCAGCGGCCGCACGCTGACCGCCTGGCGCGCCGATGAACGCTTTCCCATGATGAGCACCTTTAAAGTAGTGCTCTGCGGCGCAGTGCTGGCGCGGGTGGATGCCGGTGACGAACAGCTGGAGCGAAAGATCCACTATCGCCAGCAGGATCTGGTGGACTACTCGCCGGTCAGCGAAAAACACCTTGCCGACGGCATGACGGTCGGCGAACTCTGCGCCGCCGCCATTACCATGAGCGATAACAGCGCCGCCAATCTGCTGCTGGCCACCGTCGGCGGCCCCGCAGGATTGACTGCCTTTTTGCGCCAGATCGGCGACAACGTCACCCGCCTTGACCGCTGGGAAACGGAACTGAATGAGGCGCTTCCCGGCGACGCCCGCGACACCACTACCCCGGCCAGCATGGCCGCGACCCTGCGCAAGCTGCTGACCAGCCAGCGTCTGAGCGCCCGTTCGCAACGGCAGCTGCTGCAGTGGATGGTGGACGATCGGGTCGCCGGACCGTTGATCCGCTCCGTGCTGCCGGCGGGCTGGTTTATCGCCGATAAGACCGGAGCTAGCAAGCGGGGTGCGCGCGGGATTGTCGCCCTGCTTGGCCCGAATAACAAAGCAGAGCGCATTGTGGTGATTTATCTGCGGGATACGCCGGCGAGCATGGCCGAGCG
gb|KF986256.1|-|40-865|ARO:3001561|OXA-375 [Acinetobacter baumannii] 	0	770	54149	54919	825	246080-	770	ATGAACATTAAAGCACTCTTACTTATAACAAGCGCTATTTTTATTTCAGCCTGCTCACCTTATATAGTGACTGCTAATCCAAATCACAGCGCTTCAAAATCTGATGTAAAAGCAGAGAAAATTAAAAATTTATTTAACGAAGCACACACTACGGGTGTTTTAGTTATCCAACAAGGCCAAACTCAACAAAGCTATGGTAATGATCTTGCTCGTGCTTCGACCGAGTATGTACCTGCTTCGACCTTCAAAATGCTTAATGCTTTGATCGGCCTTGAGCACCATAAGGCAACCACCACAGAAGTATTTAAGTGGGATGGTAAAAAAAGGTTATTCCCAGAATGGGAAAAGGACATGACCCTAGGCGATGCCATGAAAGCTTCCGCTATTCCAGTTTATCAAGATTTAGCTCGTCGTATTGGACTTGAGCTCATGTCTAAGGAAGTGAAGCGTGTTGGTTATGGCAATGCAGATATCGGTACCCAAGTCGATAATTTTTGGCTGGTGGGTCCTTTAAAAATTACTCCTCAGCAAGAGGCACAGTTTGCTTACAAGCTAGCTAATAAAACGCTTCCATTTAGCCAAAAAGTCCAAGATGAAGTGCAATCCATGCTATTCATAGAAGAAAAGAATGGAAACAAAATATACGCAAAAAGTGGTTGGGGATGGGATGTAAACCCACAAGTAGGCTGGTTAACTGGATGGGTTGTTCAGCCTCAAGGGAATATTGTAGCGTTCTCCCTTAACTTAGAAATGAAAAAAGGAATACCTAG
gb|DQ519086|+|1198-2023|ARO:3001627|OXA-91 [Acinetobacter baumannii] 	0	770	54149	54919	825	246080-	770	ATGAACATTAAAGCACTCTTACTTATAACAAGCGCTATTTTTATTTCAGCCTGCTCACCTTATATAGTGACTGCTAATCCAAATCACAGCGCTTCAAAATCTGATGTAAAAGCAGAGAAAATTAAAAATTTATTTAACGAAGCACACACTACGGGTGTTTTAGTTATCCAACAAGGCCAAACTCAACAAAGCTATGGTAATGATCTTGCTCGTGCTTCGACCGAGTATGTACCTGCTTCGACCTTCAAAATGCTTAATGCTTTGATCGGCCTTGAGCACCATAAGGCAACCACCACAGAAGTATTTAAGTGGGATGGTAAAAAAAGGTTATTCCCAGAATGGGAAAAGGACATGACCCTAGGCGATGCCATGAAAGCTTCCGCTATTCCAGTTTATCAAGATTTAGCTCGTCGTATTGGACTTGAGCTCATGTCTAAGGAAGTGAAGCGTGTTGGTTATGGCAATGCAGATATCGGTACCCAAGTCGATAATTTTTGGCTGGTGGGTCCTTTAAAAATTACTCCTCAGCAAGAGGCACAGTTTGCTTACAAGCTAGCTAATAAAACGCTTCCATTTAGCCAAAAAGTCCAAGATGAAGTGCAATCCATGCTATTCATAGAAGAAAAGAATGGAAACAAAATATACGCAAAAAGTGGTTGGGGATGGGATGTAAACCCACAAGTAGGCTGGTTAACTGGATGGGTTGTTCAGCCTCAAGGGAATATTGTAGCGTTCTCCCTTAACTTAGAAATGAAAAAAGGAATACCTAG
gb|KF705209|+|0-861|ARO:3001361|SHV-178 [Klebsiella pneumoniae] 	0	806	16	822	861	1612535+	806	ATGCGTTATATTCGCCTGTGTATTATCACCCTGTGAGCCACCCTGCCGCTGGCGGTACACGCCAGCCCGCAGCCGCTTGAGCAAATTAAACAAAGCGAAAGCCAGCTGTCGGGCCGCGTAGGCATGATAGAAATGGATCTGGCCAGCGGCCGCACGCTGACCGCCTGGCGCGCCGATGAACGCTTTCCCATGATGAGCACCTTTAAAGTAGTGCTCTGCGGCGCAGTGCTGGCGCGGGTGGATGCCGGTGACGAACAGCTGGAGCGAAAGATCCACTATCGCCAGCAGGATCTGGTGGACTACTCGCCGGTCAGCGAAAAACACCTTGCCGACGGCATGACGGTCGGCGAACTCTGCGCCGCCGCCATTACCATGAGCGATAACAGCGCCGCCAATCTGCTGCTGGCCACCGTCGGCGGCCCCGCAGGATTGACTGCCTTTTTGCGCCAGATCGGCGACAACGTCACCCGCCTTGACCGCTGGGAAACGGAACTGAATGAGGCGCTTCCCGGCGACGCCCGCGACACCACTACCCCGGCCAGCATGGCCGCGACCCTGCGCAAGCTGCTGACCAGCCAGCGTCTGAGCGCCCGTTCGCAACGGCAGCTGCTGCAGTGGATGGTGGACGATCGGGTCGCCGGACCGTTGATCCGCTCCGTGCTGCCGGCGGGCTGGTTTATCGCCGATAAGACCGGAGCTAGCAAGCGGGGTGCGCGCGGGATTGTCGCCCTGCTTGGCCCGAATAACAAAGCAGAGCGCATTGTGGTGATTTATCTGCGGGATACGCCGGCGAGCATGGCCGAGCG
gb|AY040093|+|68-929|ARO:3000965|TEM-102 [Plasmid pWW100] 	0	806	46	852	861	3478183-	806	ATGAGTATTCAACATTTCCGTGTCGCCCTTATTCCCTTTTTTGCGGCATTTTGCCTTCCTGTTTTTGCTCACCCAGAAACGCTGGTGAAAGTAAAAGATGCTGAAGATCAGTTGGGTGCACGAGTGGGTTACATCGAGCTGGATCTCAACAGCGGTAAGATCCTTGAGAGTTTTCGCCCCGAAGAACGTTTTCCAATGATGAGCACTTTTAAAGTTCTGCTATGTGGTGCGGTATTATCCCGTGTTGACGCCGGGCAAGAGCAACTCGGTCGCCGCATACACTATTCTCAGAATGACTTGGTTGAGTACTCACCAGTCACAGAAAAGCATCTTACGGATGGCATGACAGTAAGAGAATTATGCAGTGCTGCCATAACCATGAGTGATAACACTGCGGCCAACTTACTTCTGACAACGATCGGAGGACCGAAGGAGCTAACCGCTTTTTTGCACAACATGGGGGATCATGTAACCCGCCTTGATCGTTGGGAACCGGAGCTGAATGAAGCCATACCAAACGACGAGCGTGACACCACGATGCCTGCAGCAATGGCAACAACGTTGCGCAAACTATTAACTGGCGAACTACTTACTCTAGCTTCCCGGCAACAATTAATAGACTGGATGGAGGCGGATAAAGTTGCAGGACCACTTCTGCGCTCGGCCCTTCCGGCTGGCTGGTTTATTGCTGATAAATCTGGAGCCGGTGAGCGTGGATCTCGCGGTATCATTGCAGCACTGGGGCCAGATGGTAAGCCCTCCCGTATCGTAGTTATCTACACGACGGGGAGTCAGGCAACTATGGA
gb|JN861779|+|0-825|ARO:3001710|OXA-211 [Acinetobacter johnsonii] 	0	770	156	929	825	5350482-	773	ATGAAAACTTTACAGTTGGGCCTCATCGTCCTCATTACTACCTTCGGTTCTGCATGTACCATAATAAGAAGCCCCTCCATAGAAACAGCTAAAAACCATGAGCAACAAAGTGCGCAGCAGCAGATCCAACAGGCCTTCGATCAACTCCAAACCACGGGGGTGATTGTCATAAAGGATAAGCATGGCTTACACAGCTACGGCAATGACTTGAGCCGTGCTCAGACACCCTATGTACCCGCCTCTACCTTTAAAATGCTGAATGCCTTAATCGGACTAGAACATGGTAAAGCAACCAGCACCGAGGTGTTTAAATGGGATGGTCAAAAGAACAGCTTCCCTGCTTGGGAAAAAGACATGACTTTAGGGCAAGCCATGCAAGCATCTGCCGTTCCTGTTTATCAGGAGCTAGCACGGCGCATTGGCCTAGATCTAATGCAAAAAGAAGTACAGCGCATTGGATATGGCAATCAACAGATTGGCACCGTTGTCGATAATTTTTGGTTAGTCGGTCCACTGCAAATTACGCCTGTTCAAGAAGTCCTTTTTGTAGAGAAGCTGGCCAATACGCAACTCGCTTTTAAGCCAGATGTGCAACATACCGTACAAGACATGCTGCTGATTGAACAAAAACCGAATTATAAACTCTACGCCAAATCTGGTTGGGGCATGGACCTAGAACCGCAAGTGGGCTGGTGGACAGGCTGGGTCGAAACAGCAACAGGTGAAAAAGTGTATTTTGCTTTGAATATGCATATGAAAACAGGAATTTCAGC
gb|KR057751.1|+|0-1116|ARO:3004345|PDC-82 [Pseudomonas aeruginosa] 	3	1061	35594	36652	1116	232416+	1058	GAGGCCCCGGCGGATCGCCTGAAGGCACTGGTCGACGCCGCCGTACAACCGGTGATGAAGGCCAATGACATTCCGGGCCTGGCCGTAGCCATCAGCCTGAAAGGAGAACCGCATTACTTCAGCTATGGGCTGGCCTCGAAAGAGGACGGCCGCCGGGTGACGCCGGAGACCCTGTTCGAGATCGGCTCGGTGAGCAAGACCTTCACCGTCACCCTCGCCGGCTATGCCCTGGCCCAGGACAAGATGCGCCTCGACGACCGCGCCAGCCAGCACTGGCCGGCACTGCAGGGCAGCCGCTTCGACGGCATCAGCCTGCTCGACCTCGCGACCTATACCGCCGGCGGCTTGCCGCTGCAGTTCCCCGACTCGGTGCAGAAGGACCAGGCACAGATCCGCGACTACTACCGCCAGTGGCAGCCGACCTACGCGCCGGGCAGCCAGCGCCTCTATTCCAACCCGAGCATCGGCCTGTTCGGCTATCTCGCCGCGCGCAGCCTGGGCCAGCCGTTCGAACGGCTCATGGAGCAGCAATTGTTCCCGGCACTGGGCCTCGAACAGACCCACCTCGACGTGCCCGAGGCGGCGCTGGCGCAGTACGCCCAGGGCTACGGCAAGGACGACCGCCCGCTACGGGTCGGTCCCGGCCCGCTGGATGCCGAAGGCTACGGGGTGAAGACCAGCGCGGCCGACCTGCTGCGCTTCGTCGATGCCAACCTGCATCCGGAGCGCCTGGACAGGCCCTGGGCGCAGGCGCTCGATGCCACCCATCGCGGTTACTACAAGGTCGGCGACATGACCCAGGGCCTGGGCTGGGAAGCCTACGACTGGCCGATCTCCCTGAAGCGCCTGCAGGCCGGCAACTCGACGCCGATGGCGCTGCAACCACACAGGATCGCCAGGCTGCCCGCGCCACAGGCGCTGGAGGGCCAGCGCCTGCTGAACAAGACCGGCTCCACCAACGGCTTCGGCGCCTACGTGGCGTTCGTCCCGGGCCGCGACCTGGGCCTGGTGATCCTGGCCAACCGCAACTATCCCAATGCCGAGCGGGTGAAGATCGC
gb|KF986257|+|20-845|ARO:3001562|OXA-376 [Acinetobacter baumannii] 	0	770	54149	54919	825	246080-	770	ATGAACATTAAAGCACTCTTACTTATAACAAGCGCTATTTTTATTTCAGCCTGCTCACCTTATATAGTGACTGCTAATCCAAATCACAGCGCTTCAAAATCTGATGTAAAAGCAGAGAAAATTAAAAATTTATTTAACGAAGCACACACTACGGGTGTTTTAGTTATCCAACAAGGCCAAACTCAACAAAGCTATGGTAATGATCTTGCTCGTGCTTCGACCGAGTATGTACCTGCTTCGACCTTCAAAATGCTTAATGCTTTGATCGGCCTTGAGCACCATAAGGCAACCACCACAGAAGTATTTAAGTGGGATGGTAAAAAAAGGTTATTCCCAGAATGGGAAAAGGACATGACCCTAGGCGATGCCATGAAAGCTTCCGCTATTCCAGTTTATCAAGATTTAGCTCGTCGTATTGGACTTGAGCTCATGTCTAAGGAAGTGAAGCGTGTTGGTTATGGCAATGCAGATATCGGTACCCAAGTCGATAATTTTTGGCTGGTGGGTCCTTTAAAAATTACTCCTCAGCAAGAGGCACAGTTTGCTTACAAGCTAGCTAATAAAACGCTTCCATTTAGCCAAAAAGTCCAAGATGAAGTGCAATCCATGCTATTCATAGAAGAAAAGAATGGAAACAAAATATACGCAAAAAGTGGTTGGGGATGGGATGTAAACCCACAAGTAGGCTGGTTAACTGGATGGGTTGTTCAGCCTCAAGGGAATATTGTAGCGTTCTCCCTTAACTTAGAAATGAAAAAAGGAATACCTAG
gb|DQ335566|+|0-825|ARO:3001632|OXA-92 [Acinetobacter baumannii] 	0	770	54149	54919	825	246080-	770	ATGAACATTAAAGCACTCTTACTTATAACAAGCGCTATTTTTATTTCAGCCTGCTCACCTTATATAGTGACTGCTAATCCAAATCACAGCGCTTCAAAATCTGATGTAAAAGCAGAGAAAATTAAAAATTTATTTAACGAAGCACACACTACGGGTGTTTTAGTTATCCAACAAGGCCAAACTCAACAAAGCTATGGTAATGATCTTGCTCGTGCTTCGACCGAGTATGTACCTGCTTCGACCTTCAAAATGCTTAATGCTTTGATCGGCCTTGAGCACCATAAGGCAACCACCACAGAAGTATTTAAGTGGGATGGTAAAAAAAGGTTATTCCCAGAATGGGAAAAGGACATGACCCTAGGCGATGCCATGAAAGCTTCCGCTATTCCAGTTTATCAAGATTTAGCTCGTCGTATTGGACTTGAGCTCATGTCTAAGGAAGTGAAGCGTGTTGGTTATGGCAATGCAGATATCGGTACCCAAGTCGATAATTTTTGGCTGGTGGGTCCTTTAAAAATTACTCCTCAGCAAGAGGCACAGTTTGCTTACAAGCTAGCTAATAAAACGCTTCCATTTAGCCAAAAAGTCCAAGATGAAGTGCAATCCATGCTATTCATAGAAGAAAAGAATGGAAACAAAATATACGCAAAAAGTGGTTGGGGATGGGATGTAAACCCACAAGTAGGCTGGTTAACTGGATGGGTTGTTCAGCCTCAAGGGAATATTGTAGCGTTCTCCCTTAACTTAGAAATGAAAAAAGGAATACCTAG
gb|KF705208|+|0-861|ARO:3001362|SHV-179 [Klebsiella pneumoniae] 	0	806	16	822	861	1612535+	806	ATGCGTTATATTCGCCTGTGTATTATCACCCTGTGAGCCACCCTGCCGCTGGCGGTACACGCCAGCCCGCAGCCGCTTGAGCAAATTAAACAAAGCGAAAGCCAGCTGTCGGGCCGCGTAGGCATGATAGAAATGGATCTGGCCAGCGGCCGCACGCTGACCGCCTGGCGCGCCGATGAACGCTTTCCCATGATGAGCACCTTTAAAGTAGTGCTCTGCGGCGCAGTGCTGGCGCGGGTGGATGCCGGTGACGAACAGCTGGAGCGAAAGATCCACTATCGCCAGCAGGATCTGGTGGACTACTCGCCGGTCAGCGAAAAACACCTTGCCGACGGCATGACGGTCGGCGAACTCTGCGCCGCCGCCATTACCATGAGCGATAACAGCGCCGCCAATCTGCTGCTGGCCACCGTCGGCGGCCCCGCAGGATTGACTGCCTTTTTGCGCCAGATCGGCGACAACGTCACCCGCCTTGACCGCTGGGAAACGGAACTGAATGAGGCGCTTCCCGGCGACGCCCGCGACACCACTACCCCGGCCAGCATGGCCGCGACCCTGCGCAAGCTGCTGACCAGCCAGCGTCTGAGCGCCCGTTCGCAACGGCAGCTGCTGCAGTGGATGGTGGACGATCGGGTCGCCGGACCGTTGATCCGCTCCGTGCTGCCGGCGGGCTGGTTTATCGCCGATAAGACCGGAGCTAGCAAGCGGGGTGCGCGCGGGATTGTCGCCCTGCTTGGCCCGAATAACAAAGCAGAGCGCATTGTGGTGATTTATCTGCGGGATACGCCGGCGAGCATGGCCGAGCG
gb|AF516719|+|214-1075|ARO:3000967|TEM-104 [Klebsiella pneumoniae] 	0	806	46	852	861	3478183-	806	ATGAGTATTCAACATTTCCGTGTCGCCCTTATTCCCTTTTTTGCGGCATTTTGCCTTCCTGTTTTTGCTCACCCAGAAACGCTGGTGAAAGTAAAAGATGCTGAAGATCAGTTGGGTGCACGAGTGGGTTACATCGAGCTGGATCTCAACAGCGGTAAGATCCTTGAGAGTTTTCGCCCCGAAGAACGTTTTCCAATGATGAGCACTTTTAAAGTTCTGCTATGTGGTGCGGTATTATCCCGTGTTGACGCCGGGCAAGAGCAACTCGGTCGCCGCATACACTATTCTCAGAATGACTTGGTTGAGTACTCACCAGTCACAGAAAAGCATCTTACGGATGGCATGACAGTAAGAGAATTATGCAGTGCTGCCATAACCATGAGTGATAACACTGCGGCCAACTTACTTCTGACAACGATCGGAGGACCGAAGGAGCTAACCGCTTTTTTGCACAACATGGGGGATCATGTAACCCGCCTTGATCGTTGGGAACCGGAGCTGAATGAAGCCATACCAAACGACGAGCGTGACACCACGATGCCTGCAGCAATGGCAACAACGTTGCGCAAACTATTAACTGGCGAACTACTTACTCTAGCTTCCCGGCAACAATTAATAGACTGGATGGAGGCGGATAAAGTTGCAGGACCACTTCTGCGCTCGGCCCTTCCGGCTGGCTGGTTTATTGCTGATAAATCTGGAGCCGGTGAGCGTGGATCTCGCGGTATCATTGCAGCACTGGGGCCAGATGGTAAGCCCTCCCGTATCGTAGTTATCTACACGACGGGGAGTCAGGCAACTATGGA
gb|KF986258|+|14-839|ARO:3001563|OXA-377 [Acinetobacter baumannii] 	0	770	54149	54919	825	246080-	770	ATGAACATTAAAGCACTCTTACTTATAACAAGCGCTATTTTTATTTCAGCCTGCTCACCTTATATAGTGACTGCTAATCCAAATCACAGCGCTTCAAAATCTGATGTAAAAGCAGAGAAAATTAAAAATTTATTTAACGAAGCACACACTACGGGTGTTTTAGTTATCCAACAAGGCCAAACTCAACAAAGCTATGGTAATGATCTTGCTCGTGCTTCGACCGAGTATGTACCTGCTTCGACCTTCAAAATGCTTAATGCTTTGATCGGCCTTGAGCACCATAAGGCAACCACCACAGAAGTATTTAAGTGGGATGGTAAAAAAAGGTTATTCCCAGAATGGGAAAAGGACATGACCCTAGGCGATGCCATGAAAGCTTCCGCTATTCCAGTTTATCAAGATTTAGCTCGTCGTATTGGACTTGAGCTCATGTCTAAGGAAGTGAAGCGTGTTGGTTATGGCAATGCAGATATCGGTACCCAAGTCGATAATTTTTGGCTGGTGGGTCCTTTAAAAATTACTCCTCAGCAAGAGGCACAGTTTGCTTACAAGCTAGCTAATAAAACGCTTCCATTTAGCCAAAAAGTCCAAGATGAAGTGCAATCCATGCTATTCATAGAAGAAAAGAATGGAAACAAAATATACGCAAAAAGTGGTTGGGGATGGGATGTAAACCCACAAGTAGGCTGGTTAACTGGATGGGTTGTTCAGCCTCAAGGGAATATTGTAGCGTTCTCCCTTAACTTAGAAATGAAAAAAGGAATACCTAG
gb|DQ519087|+|38-863|ARO:3001628|OXA-93 [Acinetobacter baumannii] 	0	770	54149	54919	825	246080-	770	ATGAACATTAAAGCACTCTTACTTATAACAAGCGCTATTTTTATTTCAGCCTGCTCACCTTATATAGTGACTGCTAATCCAAATCACAGCGCTTCAAAATCTGATGTAAAAGCAGAGAAAATTAAAAATTTATTTAACGAAGCACACACTACGGGTGTTTTAGTTATCCAACAAGGCCAAACTCAACAAAGCTATGGTAATGATCTTGCTCGTGCTTCGACCGAGTATGTACCTGCTTCGACCTTCAAAATGCTTAATGCTTTGATCGGCCTTGAGCACCATAAGGCAACCACCACAGAAGTATTTAAGTGGGATGGTAAAAAAAGGTTATTCCCAGAATGGGAAAAGGACATGACCCTAGGCGATGCCATGAAAGCTTCCGCTATTCCAGTTTATCAAGATTTAGCTCGTCGTATTGGACTTGAGCTCATGTCTAAGGAAGTGAAGCGTGTTGGTTATGGCAATGCAGATATCGGTACCCAAGTCGATAATTTTTGGCTGGTGGGTCCTTTAAAAATTACTCCTCAGCAAGAGGCACAGTTTGCTTACAAGCTAGCTAATAAAACGCTTCCATTTAGCCAAAAAGTCCAAGATGAAGTGCAATCCATGCTATTCATAGAAGAAAAGAATGGAAACAAAATATACGCAAAAAGTGGTTGGGGATGGGATGTAAACCCACAAGTAGGCTGGTTAACTGGATGGGTTGTTCAGCCTCAAGGGAATATTGTAGCGTTCTCCCTTAACTTAGAAATGAAAAAAGGAATACCTAG
gb|AF516720|+|214-1075|ARO:3000968|TEM-105 [Escherichia coli] 	0	806	46	852	861	3478183-	806	ATGAGTATTCAACATTTCCGTGTCGCCCTTATTCCCTTTTTTGCGGCATTTTGCCTTCCTGTTTTTGCTCACCCAGAAACGCTGGTGAAAGTAAAAGATGCTGAAGATCAGTTGGGTGCACGAGTGGGTTACATCGAGCTGGATCTCAACAGCGGTAAGATCCTTGAGAGTTTTCGCCCCGAAGAACGTTTTCCAATGATGAGCACTTTTAAAGTTCTGCTATGTGGTGCGGTATTATCCCGTGTTGACGCCGGGCAAGAGCAACTCGGTCGCCGCATACACTATTCTCAGAATGACTTGGTTGAGTACTCACCAGTCACAGAAAAGCATCTTACGGATGGCATGACAGTAAGAGAATTATGCAGTGCTGCCATAACCATGAGTGATAACACTGCGGCCAACTTACTTCTGACAACGATCGGAGGACCGAAGGAGCTAACCGCTTTTTTGCACAACATGGGGGATCATGTAACCCGCCTTGATCGTTGGGAACCGGAGCTGAATGAAGCCATACCAAACGACGAGCGTGACACCACGATGCCTGCAGCAATGGCAACAACGTTGCGCAAACTATTAACTGGCGAACTACTTACTCTAGCTTCCCGGCAACAATTAATAGACTGGATGGAGGCGGATAAAGTTGCAGGACCACTTCTGCGCTCGGCCCTTCCGGCTGGCTGGTTTATTGCTGATAAATCTGGAGCCGGTGAGCGTGGATCTCGCGGTATCATTGCAGCACTGGGGCCAGATGGTAAGCCCTCCCGTATCGTAGTTATCTACACGACGGGGAGTCAGGCAACTATGGA
gb|DQ519088|+|8-833|ARO:3001629|OXA-94 [Acinetobacter baumannii] 	0	770	54149	54919	825	246080-	770	ATGAACATTAAAGCACTCTTACTTATAACAAGCGCTATTTTTATTTCAGCCTGCTCACCTTATATAGTGACTGCTAATCCAAATCACAGCGCTTCAAAATCTGATGTAAAAGCAGAGAAAATTAAAAATTTATTTAACGAAGCACACACTACGGGTGTTTTAGTTATCCAACAAGGCCAAACTCAACAAAGCTATGGTAATGATCTTGCTCGTGCTTCGACCGAGTATGTACCTGCTTCGACCTTCAAAATGCTTAATGCTTTGATCGGCCTTGAGCACCATAAGGCAACCACCACAGAAGTATTTAAGTGGGATGGTAAAAAAAGGTTATTCCCAGAATGGGAAAAGGACATGACCCTAGGCGATGCCATGAAAGCTTCCGCTATTCCAGTTTATCAAGATTTAGCTCGTCGTATTGGACTTGAGCTCATGTCTAAGGAAGTGAAGCGTGTTGGTTATGGCAATGCAGATATCGGTACCCAAGTCGATAATTTTTGGCTGGTGGGTCCTTTAAAAATTACTCCTCAGCAAGAGGCACAGTTTGCTTACAAGCTAGCTAATAAAACGCTTCCATTTAGCCAAAAAGTCCAAGATGAAGTGCAATCCATGCTATTCATAGAAGAAAAGAATGGAAACAAAATATACGCAAAAAGTGGTTGGGGATGGGATGTAAACCCACAAGTAGGCTGGTTAACTGGATGGGTTGTTCAGCCTCAAGGGAATATTGTAGCGTTCTCCCTTAACTTAGAAATGAAAAAAGGAATACCTAG
gb|AF132290|+|87-948|ARO:3001076|SHV-18 [Klebsiella pneumoniae] 	0	806	16	822	861	1612535+	806	ATGCGTTATATTCGCCTGTGTATTATCACCCTGTGAGCCACCCTGCCGCTGGCGGTACACGCCAGCCCGCAGCCGCTTGAGCAAATTAAACAAAGCGAAAGCCAGCTGTCGGGCCGCGTAGGCATGATAGAAATGGATCTGGCCAGCGGCCGCACGCTGACCGCCTGGCGCGCCGATGAACGCTTTCCCATGATGAGCACCTTTAAAGTAGTGCTCTGCGGCGCAGTGCTGGCGCGGGTGGATGCCGGTGACGAACAGCTGGAGCGAAAGATCCACTATCGCCAGCAGGATCTGGTGGACTACTCGCCGGTCAGCGAAAAACACCTTGCCGACGGCATGACGGTCGGCGAACTCTGCGCCGCCGCCATTACCATGAGCGATAACAGCGCCGCCAATCTGCTGCTGGCCACCGTCGGCGGCCCCGCAGGATTGACTGCCTTTTTGCGCCAGATCGGCGACAACGTCACCCGCCTTGACCGCTGGGAAACGGAACTGAATGAGGCGCTTCCCGGCGACGCCCGCGACACCACTACCCCGGCCAGCATGGCCGCGACCCTGCGCAAGCTGCTGACCAGCCAGCGTCTGAGCGCCCGTTCGCAACGGCAGCTGCTGCAGTGGATGGTGGACGATCGGGTCGCCGGACCGTTGATCCGCTCCGTGCTGCCGGCGGGCTGGTTTATCGCCGATAAGACCGGAGCTAGCAAGCGGGGTGCGCGCGGGATTGTCGCCCTGCTTGGCCCGAATAACAAAGCAGAGCGCATTGTGGTGATTTATCTGCGGGATACGCCGGCGAGCATGGCCGAGCG
gb|KF986259.1|-|16-841|ARO:3001564|OXA-378 [Acinetobacter baumannii] 	0	770	54149	54919	825	246080-	770	ATGAACATTAAAGCACTCTTACTTATAACAAGCGCTATTTTTATTTCAGCCTGCTCACCTTATATAGTGACTGCTAATCCAAATCACAGCGCTTCAAAATCTGATGTAAAAGCAGAGAAAATTAAAAATTTATTTAACGAAGCACACACTACGGGTGTTTTAGTTATCCAACAAGGCCAAACTCAACAAAGCTATGGTAATGATCTTGCTCGTGCTTCGACCGAGTATGTACCTGCTTCGACCTTCAAAATGCTTAATGCTTTGATCGGCCTTGAGCACCATAAGGCAACCACCACAGAAGTATTTAAGTGGGATGGTAAAAAAAGGTTATTCCCAGAATGGGAAAAGGACATGACCCTAGGCGATGCCATGAAAGCTTCCGCTATTCCAGTTTATCAAGATTTAGCTCGTCGTATTGGACTTGAGCTCATGTCTAAGGAAGTGAAGCGTGTTGGTTATGGCAATGCAGATATCGGTACCCAAGTCGATAATTTTTGGCTGGTGGGTCCTTTAAAAATTACTCCTCAGCAAGAGGCACAGTTTGCTTACAAGCTAGCTAATAAAACGCTTCCATTTAGCCAAAAAGTCCAAGATGAAGTGCAATCCATGCTATTCATAGAAGAAAAGAATGGAAACAAAATATACGCAAAAAGTGGTTGGGGATGGGATGTAAACCCACAAGTAGGCTGGTTAACTGGATGGGTTGTTCAGCCTCAAGGGAATATTGTAGCGTTCTCCCTTAACTTAGAAATGAAAAAAGGAATACCTAG
gb|AY101578|+|214-1075|ARO:3000969|TEM-106 [Escherichia coli] 	0	806	46	852	861	3478183-	806	ATGAGTATTCAACATTTCCGTGTCGCCCTTATTCCCTTTTTTGCGGCATTTTGCCTTCCTGTTTTTGCTCACCCAGAAACGCTGGTGAAAGTAAAAGATGCTGAAGATCAGTTGGGTGCACGAGTGGGTTACATCGAGCTGGATCTCAACAGCGGTAAGATCCTTGAGAGTTTTCGCCCCGAAGAACGTTTTCCAATGATGAGCACTTTTAAAGTTCTGCTATGTGGTGCGGTATTATCCCGTGTTGACGCCGGGCAAGAGCAACTCGGTCGCCGCATACACTATTCTCAGAATGACTTGGTTGAGTACTCACCAGTCACAGAAAAGCATCTTACGGATGGCATGACAGTAAGAGAATTATGCAGTGCTGCCATAACCATGAGTGATAACACTGCGGCCAACTTACTTCTGACAACGATCGGAGGACCGAAGGAGCTAACCGCTTTTTTGCACAACATGGGGGATCATGTAACCCGCCTTGATCGTTGGGAACCGGAGCTGAATGAAGCCATACCAAACGACGAGCGTGACACCACGATGCCTGCAGCAATGGCAACAACGTTGCGCAAACTATTAACTGGCGAACTACTTACTCTAGCTTCCCGGCAACAATTAATAGACTGGATGGAGGCGGATAAAGTTGCAGGACCACTTCTGCGCTCGGCCCTTCCGGCTGGCTGGTTTATTGCTGATAAATCTGGAGCCGGTGAGCGTGGATCTCGCGGTATCATTGCAGCACTGGGGCCAGATGGTAAGCCCTCCCGTATCGTAGTTATCTACACGACGGGGAGTCAGGCAACTATGGA
gb|AY874537|+|177-1038|ARO:3000883|TEM-11 [Proteus mirabilis] 	0	806	46	852	861	3478183-	806	ATGAGTATTCAACATTTCCGTGTCGCCCTTATTCCCTTTTTTGCGGCATTTTGCCTTCCTGTTTTTGCTCACCCAGAAACGCTGGTGAAAGTAAAAGATGCTGAAGATCAGTTGGGTGCACGAGTGGGTTACATCGAGCTGGATCTCAACAGCGGTAAGATCCTTGAGAGTTTTCGCCCCGAAGAACGTTTTCCAATGATGAGCACTTTTAAAGTTCTGCTATGTGGTGCGGTATTATCCCGTGTTGACGCCGGGCAAGAGCAACTCGGTCGCCGCATACACTATTCTCAGAATGACTTGGTTGAGTACTCACCAGTCACAGAAAAGCATCTTACGGATGGCATGACAGTAAGAGAATTATGCAGTGCTGCCATAACCATGAGTGATAACACTGCGGCCAACTTACTTCTGACAACGATCGGAGGACCGAAGGAGCTAACCGCTTTTTTGCACAACATGGGGGATCATGTAACCCGCCTTGATCGTTGGGAACCGGAGCTGAATGAAGCCATACCAAACGACGAGCGTGACACCACGATGCCTGCAGCAATGGCAACAACGTTGCGCAAACTATTAACTGGCGAACTACTTACTCTAGCTTCCCGGCAACAATTAATAGACTGGATGGAGGCGGATAAAGTTGCAGGACCACTTCTGCGCTCGGCCCTTCCGGCTGGCTGGTTTATTGCTGATAAATCTGGAGCCGGTGAGCGTGGATCTCGCGGTATCATTGCAGCACTGGGGCCAGATGGTAAGCCCTCCCGTATCGTAGTTATCTACACGACGGGGAGTCAGGCAACTATGGA
gb|DQ519089|+|8-833|ARO:3001630|OXA-95 [Acinetobacter baumannii] 	0	770	54149	54919	825	246080-	770	ATGAACATTAAAGCACTCTTACTTATAACAAGCGCTATTTTTATTTCAGCCTGCTCACCTTATATAGTGACTGCTAATCCAAATCACAGCGCTTCAAAATCTGATGTAAAAGCAGAGAAAATTAAAAATTTATTTAACGAAGCACACACTACGGGTGTTTTAGTTATCCAACAAGGCCAAACTCAACAAAGCTATGGTAATGATCTTGCTCGTGCTTCGACCGAGTATGTACCTGCTTCGACCTTCAAAATGCTTAATGCTTTGATCGGCCTTGAGCACCATAAGGCAACCACCACAGAAGTATTTAAGTGGGATGGTAAAAAAAGGTTATTCCCAGAATGGGAAAAGGACATGACCCTAGGCGATGCCATGAAAGCTTCCGCTATTCCAGTTTATCAAGATTTAGCTCGTCGTATTGGACTTGAGCTCATGTCTAAGGAAGTGAAGCGTGTTGGTTATGGCAATGCAGATATCGGTACCCAAGTCGATAATTTTTGGCTGGTGGGTCCTTTAAAAATTACTCCTCAGCAAGAGGCACAGTTTGCTTACAAGCTAGCTAATAAAACGCTTCCATTTAGCCAAAAAGTCCAAGATGAAGTGCAATCCATGCTATTCATAGAAGAAAAGAATGGAAACAAAATATACGCAAAAAGTGGTTGGGGATGGGATGTAAACCCACAAGTAGGCTGGTTAACTGGATGGGTTGTTCAGCCTCAAGGGAATATTGTAGCGTTCTCCCTTAACTTAGAAATGAAAAAAGGAATACCTAG
gb|AY072920|+|0-861|ARO:3000973|TEM-110 [Klebsiella pneumoniae] 	0	806	46	852	861	3478183-	806	ATGAGTATTCAACATTTCCGTGTCGCCCTTATTCCCTTTTTTGCGGCATTTTGCCTTCCTGTTTTTGCTCACCCAGAAACGCTGGTGAAAGTAAAAGATGCTGAAGATCAGTTGGGTGCACGAGTGGGTTACATCGAGCTGGATCTCAACAGCGGTAAGATCCTTGAGAGTTTTCGCCCCGAAGAACGTTTTCCAATGATGAGCACTTTTAAAGTTCTGCTATGTGGTGCGGTATTATCCCGTGTTGACGCCGGGCAAGAGCAACTCGGTCGCCGCATACACTATTCTCAGAATGACTTGGTTGAGTACTCACCAGTCACAGAAAAGCATCTTACGGATGGCATGACAGTAAGAGAATTATGCAGTGCTGCCATAACCATGAGTGATAACACTGCGGCCAACTTACTTCTGACAACGATCGGAGGACCGAAGGAGCTAACCGCTTTTTTGCACAACATGGGGGATCATGTAACCCGCCTTGATCGTTGGGAACCGGAGCTGAATGAAGCCATACCAAACGACGAGCGTGACACCACGATGCCTGCAGCAATGGCAACAACGTTGCGCAAACTATTAACTGGCGAACTACTTACTCTAGCTTCCCGGCAACAATTAATAGACTGGATGGAGGCGGATAAAGTTGCAGGACCACTTCTGCGCTCGGCCCTTCCGGCTGGCTGGTTTATTGCTGATAAATCTGGAGCCGGTGAGCGTGGATCTCGCGGTATCATTGCAGCACTGGGGCCAGATGGTAAGCCCTCCCGTATCGTAGTTATCTACACGACGGGGAGTCAGGCAACTATGGA
gb|JQ867374.1|+|0-1152|ARO:3004632|ADC-62 [Acinetobacter baumannii] 	0	1097	63	1160	1152	126080+	1097	ATGCGATTTAAAAAAATTTCTTGTCTACTTTTATCCCCGCTTTTTATTTTTAGTACCTCAATTTATGCGGGCAATACACCAAAAGACCAAGAAATTAAAAAACTGGTAGATCAAAACTTTAAACCGTTATTAGAAAAATATGATGTGCCAGGTATGGCTGTGGGTGTTATTCAAAATAATAAAAAGTATGAAATGTATTATGGTCTTCAATCTGTTCAAGATAAAAAAGCCGTAAATAGCAGTACTATTTTTGAGCTAGGTTCTGTCAGTAAATTATTTACCGCGACAGCAGGTGGATATGCAAAAAATAAAGGAAAAATCTCTTTTGACGATACGCCTGGTAAGTATTGGAAAGAACTAAAAAATACACCGATTGACCAAGTTAACTTACTTCAACTCGCGACGTATACAAGTGGTAACCTTGCCTTGCAATTTCCAGATGAAGTAAAAACAGATCAGCAAGTTTTAACATTTTTTAAAGACTGGAAACCTAAAAACTCAATCGGTGAATATCGACAATATTCAAACCCAAGCATTGGTTTATTTGGAAAAGTTGTAGCTTTGTCTATGAATAAACCTTTCGACCAAGTCTTAGAAAAAACAATTTTTCCGGCCCTTGGCTTAAAACATAGCTATGTAAATGTACCTAAGACCCAGATGCAAAACTATGCTTTTGGCTATAACCAAGAAAATCAGCCGATTCGAGTTAACCCCGGCCCACTCGATGCCCCAGCATATGGCGTCAAATCGACACTACCCGACATGTTGAGTTTTATTCATGCCAACCTAAATCCACAAAAATATCCAGCAGATATTCAACGGGCAATTAATGAAACACATCAGGGTCGCTATCAAGTAAATACCATGTATCAGGCACTCGGTTGGGAAGAGTTTTCTTATCCGGCAACGTTACAAACTTTATTAGACAGTAATTCAGAACAGATTGTGATGAAACCTAATAAAGTGACTGCTATTTCAAAGGAACCTTCAGTTAAGATGTACCATAAAACTGGCTCAACTACCGGTTTCGGAACATATGTGGTGTTTATTCCTAAAGAAAATATTGGTTTAGTCATGTTAACCAATAAACGTATTCC
gb|AY101764|+|206-1067|ARO:3000970|TEM-107 [Klebsiella pneumoniae] 	0	806	46	852	861	3478183-	806	ATGAGTATTCAACATTTCCGTGTCGCCCTTATTCCCTTTTTTGCGGCATTTTGCCTTCCTGTTTTTGCTCACCCAGAAACGCTGGTGAAAGTAAAAGATGCTGAAGATCAGTTGGGTGCACGAGTGGGTTACATCGAGCTGGATCTCAACAGCGGTAAGATCCTTGAGAGTTTTCGCCCCGAAGAACGTTTTCCAATGATGAGCACTTTTAAAGTTCTGCTATGTGGTGCGGTATTATCCCGTGTTGACGCCGGGCAAGAGCAACTCGGTCGCCGCATACACTATTCTCAGAATGACTTGGTTGAGTACTCACCAGTCACAGAAAAGCATCTTACGGATGGCATGACAGTAAGAGAATTATGCAGTGCTGCCATAACCATGAGTGATAACACTGCGGCCAACTTACTTCTGACAACGATCGGAGGACCGAAGGAGCTAACCGCTTTTTTGCACAACATGGGGGATCATGTAACCCGCCTTGATCGTTGGGAACCGGAGCTGAATGAAGCCATACCAAACGACGAGCGTGACACCACGATGCCTGCAGCAATGGCAACAACGTTGCGCAAACTATTAACTGGCGAACTACTTACTCTAGCTTCCCGGCAACAATTAATAGACTGGATGGAGGCGGATAAAGTTGCAGGACCACTTCTGCGCTCGGCCCTTCCGGCTGGCTGGTTTATTGCTGATAAATCTGGAGCCGGTGAGCGTGGATCTCGCGGTATCATTGCAGCACTGGGGCCAGATGGTAAGCCCTCCCGTATCGTAGTTATCTACACGACGGGGAGTCAGGCAACTATGGA
gb|AF468003|+|0-861|ARO:3000974|TEM-111 [Escherichia coli] 	0	806	46	852	861	3478183-	806	ATGAGTATTCAACATTTCCGTGTCGCCCTTATTCCCTTTTTTGCGGCATTTTGCCTTCCTGTTTTTGCTCACCCAGAAACGCTGGTGAAAGTAAAAGATGCTGAAGATCAGTTGGGTGCACGAGTGGGTTACATCGAGCTGGATCTCAACAGCGGTAAGATCCTTGAGAGTTTTCGCCCCGAAGAACGTTTTCCAATGATGAGCACTTTTAAAGTTCTGCTATGTGGTGCGGTATTATCCCGTGTTGACGCCGGGCAAGAGCAACTCGGTCGCCGCATACACTATTCTCAGAATGACTTGGTTGAGTACTCACCAGTCACAGAAAAGCATCTTACGGATGGCATGACAGTAAGAGAATTATGCAGTGCTGCCATAACCATGAGTGATAACACTGCGGCCAACTTACTTCTGACAACGATCGGAGGACCGAAGGAGCTAACCGCTTTTTTGCACAACATGGGGGATCATGTAACCCGCCTTGATCGTTGGGAACCGGAGCTGAATGAAGCCATACCAAACGACGAGCGTGACACCACGATGCCTGCAGCAATGGCAACAACGTTGCGCAAACTATTAACTGGCGAACTACTTACTCTAGCTTCCCGGCAACAATTAATAGACTGGATGGAGGCGGATAAAGTTGCAGGACCACTTCTGCGCTCGGCCCTTCCGGCTGGCTGGTTTATTGCTGATAAATCTGGAGCCGGTGAGCGTGGATCTCGCGGTATCATTGCAGCACTGGGGCCAGATGGTAAGCCCTCCCGTATCGTAGTTATCTACACGACGGGGAGTCAGGCAACTATGGA
gb|JN861780|+|0-825|ARO:3001711|OXA-212 [Acinetobacter johnsonii] 	0	770	156	929	825	5350482-	773	ATGAAAACTTTACAGTTGGGCCTCATCGTCCTCATTACTACCTTCGGTTCTGCATGTACCATAATAAGAAGCCCCTCCATAGAAACAGCTAAAAACCATGAGCAACAAAGTGCGCAGCAGCAGATCCAACAGGCCTTCGATCAACTCCAAACCACGGGGGTGATTGTCATAAAGGATAAGCATGGCTTACACAGCTACGGCAATGACTTGAGCCGTGCTCAGACACCCTATGTACCCGCCTCTACCTTTAAAATGCTGAATGCCTTAATCGGACTAGAACATGGTAAAGCAACCAGCACCGAGGTGTTTAAATGGGATGGTCAAAAGAACAGCTTCCCTGCTTGGGAAAAAGACATGACTTTAGGGCAAGCCATGCAAGCATCTGCCGTTCCTGTTTATCAGGAGCTAGCACGGCGCATTGGCCTAGATCTAATGCAAAAAGAAGTACAGCGCATTGGATATGGCAATCAACAGATTGGCACCGTTGTCGATAATTTTTGGTTAGTCGGTCCACTGCAAATTACGCCTGTTCAAGAAGTCCTTTTTGTAGAGAAGCTGGCCAATACGCAACTCGCTTTTAAGCCAGATGTGCAACATACCGTACAAGACATGCTGCTGATTGAACAAAAACCGAATTATAAACTCTACGCCAAATCTGGTTGGGGCATGGACCTAGAACCGCAAGTGGGCTGGTGGACAGGCTGGGTCGAAACAGCAACAGGTGAAAAAGTGTATTTTGCTTTGAATATGCATATGAAAACAGGAATTTCAGC
gb|AY590467|+|0-729|ARO:3001110|SHV-53 [Klebsiella pneumoniae] Partial	0	674	36	710	729	1612535+	674	TATTATCACCCTGTGAGCCACCCTGCCGCTGGCGGTACACGCCAGCCCGCAGCCGCTTGAGCAAATTAAACAAAGCGAAAGCCAGCTGTCGGGCCGCGTAGGCATGATAGAAATGGATCTGGCCAGCGGCCGCACGCTGACCGCCTGGCGCGCCGATGAACGCTTTCCCATGATGAGCACCTTTAAAGTAGTGCTCTGCGGCGCAGTGCTGGCGCGGGTGGATGCCGGTGACGAACAGCTGGAGCGAAAGATCCACTATCGCCAGCAGGATCTGGTGGACTACTCGCCGGTCAGCGAAAAACACCTTGCCGACGGCATGACGGTCGGCGAACTCTGCGCCGCCGCCATTACCATGAGCGATAACAGCGCCGCCAATCTGCTGCTGGCCACCGTCGGCGGCCCCGCAGGATTGACTGCCTTTTTGCGCCAGATCGGCGACAACGTCACCCGCCTTGACCGCTGGGAAACGGAACTGAATGAGGCGCTTCCCGGCGACGCCCGCGACACCACTACCCCGGCCAGCATGGCCGCGACCCTGCGCAAGCTGCTGACCAGCCAGCGTCTGAGCGCCCGTTCGCAACGGCAGCTGCTGCAGTGGATGGTGGACGATCGGGTCGCCGGACCGTTGATCCGCTCCGTGCTGCCGGCGGGCTGGTTTATCGCCGATAAGACCG
gb|KF986260|+|20-845|ARO:3001565|OXA-379 [Acinetobacter baumannii] 	0	770	54149	54919	825	246080-	770	ATGAACATTAAAGCACTCTTACTTATAACAAGCGCTATTTTTATTTCAGCCTGCTCACCTTATATAGTGACTGCTAATCCAAATCACAGCGCTTCAAAATCTGATGTAAAAGCAGAGAAAATTAAAAATTTATTTAACGAAGCACACACTACGGGTGTTTTAGTTATCCAACAAGGCCAAACTCAACAAAGCTATGGTAATGATCTTGCTCGTGCTTCGACCGAGTATGTACCTGCTTCGACCTTCAAAATGCTTAATGCTTTGATCGGCCTTGAGCACCATAAGGCAACCACCACAGAAGTATTTAAGTGGGATGGTAAAAAAAGGTTATTCCCAGAATGGGAAAAGGACATGACCCTAGGCGATGCCATGAAAGCTTCCGCTATTCCAGTTTATCAAGATTTAGCTCGTCGTATTGGACTTGAGCTCATGTCTAAGGAAGTGAAGCGTGTTGGTTATGGCAATGCAGATATCGGTACCCAAGTCGATAATTTTTGGCTGGTGGGTCCTTTAAAAATTACTCCTCAGCAAGAGGCACAGTTTGCTTACAAGCTAGCTAATAAAACGCTTCCATTTAGCCAAAAAGTCCAAGATGAAGTGCAATCCATGCTATTCATAGAAGAAAAGAATGGAAACAAAATATACGCAAAAAGTGGTTGGGGATGGGATGTAAACCCACAAGTAGGCTGGTTAACTGGATGGGTTGTTCAGCCTCAAGGGAATATTGTAGCGTTCTCCCTTAACTTAGAAATGAAAAAAGGAATACCTAG
gb|AF506748|+|38-899|ARO:3000971|TEM-108 [Salmonella enterica subsp. enterica serovar Typhimurium] 	8	806	54	852	861	3478183-	798	TCAACATTTCCGTGTCGCCCTTATTCCCTTTTTTGCGGCATTTTGCCTTCCTGTTTTTGCTCACCCAGAAACGCTGGTGAAAGTAAAAGATGCTGAAGATCAGTTGGGTGCACGAGTGGGTTACATCGAGCTGGATCTCAACAGCGGTAAGATCCTTGAGAGTTTTCGCCCCGAAGAACGTTTTCCAATGATGAGCACTTTTAAAGTTCTGCTATGTGGTGCGGTATTATCCCGTGTTGACGCCGGGCAAGAGCAACTCGGTCGCCGCATACACTATTCTCAGAATGACTTGGTTGAGTACTCACCAGTCACAGAAAAGCATCTTACGGATGGCATGACAGTAAGAGAATTATGCAGTGCTGCCATAACCATGAGTGATAACACTGCGGCCAACTTACTTCTGACAACGATCGGAGGACCGAAGGAGCTAACCGCTTTTTTGCACAACATGGGGGATCATGTAACCCGCCTTGATCGTTGGGAACCGGAGCTGAATGAAGCCATACCAAACGACGAGCGTGACACCACGATGCCTGCAGCAATGGCAACAACGTTGCGCAAACTATTAACTGGCGAACTACTTACTCTAGCTTCCCGGCAACAATTAATAGACTGGATGGAGGCGGATAAAGTTGCAGGACCACTTCTGCGCTCGGCCCTTCCGGCTGGCTGGTTTATTGCTGATAAATCTGGAGCCGGTGAGCGTGGATCTCGCGGTATCATTGCAGCACTGGGGCCAGATGGTAAGCCCTCCCGTATCGTAGTTATCTACACGACGGGGAGTCAGGCAACTATGGA
gb|AY589493|+|166-1027|ARO:3000975|TEM-112 [Escherichia coli] 	0	806	46	852	861	3478183-	806	ATGAGTATTCAACATTTCCGTGTCGCCCTTATTCCCTTTTTTGCGGCATTTTGCCTTCCTGTTTTTGCTCACCCAGAAACGCTGGTGAAAGTAAAAGATGCTGAAGATCAGTTGGGTGCACGAGTGGGTTACATCGAGCTGGATCTCAACAGCGGTAAGATCCTTGAGAGTTTTCGCCCCGAAGAACGTTTTCCAATGATGAGCACTTTTAAAGTTCTGCTATGTGGTGCGGTATTATCCCGTGTTGACGCCGGGCAAGAGCAACTCGGTCGCCGCATACACTATTCTCAGAATGACTTGGTTGAGTACTCACCAGTCACAGAAAAGCATCTTACGGATGGCATGACAGTAAGAGAATTATGCAGTGCTGCCATAACCATGAGTGATAACACTGCGGCCAACTTACTTCTGACAACGATCGGAGGACCGAAGGAGCTAACCGCTTTTTTGCACAACATGGGGGATCATGTAACCCGCCTTGATCGTTGGGAACCGGAGCTGAATGAAGCCATACCAAACGACGAGCGTGACACCACGATGCCTGCAGCAATGGCAACAACGTTGCGCAAACTATTAACTGGCGAACTACTTACTCTAGCTTCCCGGCAACAATTAATAGACTGGATGGAGGCGGATAAAGTTGCAGGACCACTTCTGCGCTCGGCCCTTCCGGCTGGCTGGTTTATTGCTGATAAATCTGGAGCCGGTGAGCGTGGATCTCGCGGTATCATTGCAGCACTGGGGCCAGATGGTAAGCCCTCCCGTATCGTAGTTATCTACACGACGGGGAGTCAGGCAACTATGGA
gb|JX169789.1|+|0-1152|ARO:3004633|ADC-67 [Acinetobacter baumannii] 	0	1097	63	1160	1152	126080+	1097	ATGCGATTTAAAAAAATTTCTTGTCTACTTTTATCCCCGCTTTTTATTTTTAGTACCTCAATTTATGCGGGCAATACACCAAAAGACCAAGAAATTAAAAAACTGGTAGATCAAAACTTTAAACCGTTATTAGAAAAATATGATGTGCCAGGTATGGCTGTGGGTGTTATTCAAAATAATAAAAAGTATGAAATGTATTATGGTCTTCAATCTGTTCAAGATAAAAAAGCCGTAAATAGCAGTACTATTTTTGAGCTAGGTTCTGTCAGTAAATTATTTACCGCGACAGCAGGTGGATATGCAAAAAATAAAGGAAAAATCTCTTTTGACGATACGCCTGGTAAGTATTGGAAAGAACTAAAAAATACACCGATTGACCAAGTTAACTTACTTCAACTCGCGACGTATACAAGTGGTAACCTTGCCTTGCAATTTCCAGATGAAGTAAAAACAGATCAGCAAGTTTTAACATTTTTTAAAGACTGGAAACCTAAAAACTCAATCGGTGAATATCGACAATATTCAAACCCAAGCATTGGTTTATTTGGAAAAGTTGTAGCTTTGTCTATGAATAAACCTTTCGACCAAGTCTTAGAAAAAACAATTTTTCCGGCCCTTGGCTTAAAACATAGCTATGTAAATGTACCTAAGACCCAGATGCAAAACTATGCTTTTGGCTATAACCAAGAAAATCAGCCGATTCGAGTTAACCCCGGCCCACTCGATGCCCCAGCATATGGCGTCAAATCGACACTACCCGACATGTTGAGTTTTATTCATGCCAACCTAAATCCACAAAAATATCCAGCAGATATTCAACGGGCAATTAATGAAACACATCAGGGTCGCTATCAAGTAAATACCATGTATCAGGCACTCGGTTGGGAAGAGTTTTCTTATCCGGCAACGTTACAAACTTTATTAGACAGTAATTCAGAACAGATTGTGATGAAACCTAATAAAGTGACTGCTATTTCAAAGGAACCTTCAGTTAAGATGTACCATAAAACTGGCTCAACTACCGGTTTCGGAACATATGTGGTGTTTATTCCTAAAGAAAATATTGGTTTAGTCATGTTAACCAATAAACGTATTCC
gb|KR057752.1|+|0-1116|ARO:3004346|PDC-83 [Pseudomonas aeruginosa] 	3	1061	35594	36652	1116	232416+	1058	GAGGCCCCGGCGGATCGCCTGAAGGCACTGGTCGACGCCGCCGTACAACCGGTGATGAAGGCCAATGACATTCCGGGCCTGGCCGTAGCCATCAGCCTGAAAGGAGAACCGCATTACTTCAGCTATGGGCTGGCCTCGAAAGAGGACGGCCGCCGGGTGACGCCGGAGACCCTGTTCGAGATCGGCTCGGTGAGCAAGACCTTCACCGTCACCCTCGCCGGCTATGCCCTGGCCCAGGACAAGATGCGCCTCGACGACCGCGCCAGCCAGCACTGGCCGGCACTGCAGGGCAGCCGCTTCGACGGCATCAGCCTGCTCGACCTCGCGACCTATACCGCCGGCGGCTTGCCGCTGCAGTTCCCCGACTCGGTGCAGAAGGACCAGGCACAGATCCGCGACTACTACCGCCAGTGGCAGCCGACCTACGCGCCGGGCAGCCAGCGCCTCTATTCCAACCCGAGCATCGGCCTGTTCGGCTATCTCGCCGCGCGCAGCCTGGGCCAGCCGTTCGAACGGCTCATGGAGCAGCAATTGTTCCCGGCACTGGGCCTCGAACAGACCCACCTCGACGTGCCCGAGGCGGCGCTGGCGCAGTACGCCCAGGGCTACGGCAAGGACGACCGCCCGCTACGGGTCGGTCCCGGCCCGCTGGATGCCGAAGGCTACGGGGTGAAGACCAGCGCGGCCGACCTGCTGCGCTTCGTCGATGCCAACCTGCATCCGGAGCGCCTGGACAGGCCCTGGGCGCAGGCGCTCGATGCCACCCATCGCGGTTACTACAAGGTCGGCGACATGACCCAGGGCCTGGGCTGGGAAGCCTACGACTGGCCGATCTCCCTGAAGCGCCTGCAGGCCGGCAACTCGACGCCGATGGCGCTGCAACCACACAGGATCGCCAGGCTGCCCGCGCCACAGGCGCTGGAGGGCCAGCGCCTGCTGAACAAGACCGGCTCCACCAACGGCTTCGGCGCCTACGTGGCGTTCGTCCCGGGCCGCGACCTGGGCCTGGTGATCCTGGCCAACCGCAACTATCCCAATGCCGAGCGGGTGAAGATCGC
gb|AM279652|+|0-825|ARO:3001646|OXA-98 [Acinetobacter baumannii] 	0	770	54149	54919	825	246080-	770	ATGAACATTAAAGCACTCTTACTTATAACAAGCGCTATTTTTATTTCAGCCTGCTCACCTTATATAGTGACTGCTAATCCAAATCACAGCGCTTCAAAATCTGATGTAAAAGCAGAGAAAATTAAAAATTTATTTAACGAAGCACACACTACGGGTGTTTTAGTTATCCAACAAGGCCAAACTCAACAAAGCTATGGTAATGATCTTGCTCGTGCTTCGACCGAGTATGTACCTGCTTCGACCTTCAAAATGCTTAATGCTTTGATCGGCCTTGAGCACCATAAGGCAACCACCACAGAAGTATTTAAGTGGGATGGTAAAAAAAGGTTATTCCCAGAATGGGAAAAGGACATGACCCTAGGCGATGCCATGAAAGCTTCCGCTATTCCAGTTTATCAAGATTTAGCTCGTCGTATTGGACTTGAGCTCATGTCTAAGGAAGTGAAGCGTGTTGGTTATGGCAATGCAGATATCGGTACCCAAGTCGATAATTTTTGGCTGGTGGGTCCTTTAAAAATTACTCCTCAGCAAGAGGCACAGTTTGCTTACAAGCTAGCTAATAAAACGCTTCCATTTAGCCAAAAAGTCCAAGATGAAGTGCAATCCATGCTATTCATAGAAGAAAAGAATGGAAACAAAATATACGCAAAAAGTGGTTGGGGATGGGATGTAAACCCACAAGTAGGCTGGTTAACTGGATGGGTTGTTCAGCCTCAAGGGAATATTGTAGCGTTCTCCCTTAACTTAGAAATGAAAAAAGGAATACCTAG
gb|AY589494|+|193-1054|ARO:3000976|TEM-113 [Proteus mirabilis] 	0	806	46	852	861	3478183-	806	ATGAGTATTCAACATTTCCGTGTCGCCCTTATTCCCTTTTTTGCGGCATTTTGCCTTCCTGTTTTTGCTCACCCAGAAACGCTGGTGAAAGTAAAAGATGCTGAAGATCAGTTGGGTGCACGAGTGGGTTACATCGAGCTGGATCTCAACAGCGGTAAGATCCTTGAGAGTTTTCGCCCCGAAGAACGTTTTCCAATGATGAGCACTTTTAAAGTTCTGCTATGTGGTGCGGTATTATCCCGTGTTGACGCCGGGCAAGAGCAACTCGGTCGCCGCATACACTATTCTCAGAATGACTTGGTTGAGTACTCACCAGTCACAGAAAAGCATCTTACGGATGGCATGACAGTAAGAGAATTATGCAGTGCTGCCATAACCATGAGTGATAACACTGCGGCCAACTTACTTCTGACAACGATCGGAGGACCGAAGGAGCTAACCGCTTTTTTGCACAACATGGGGGATCATGTAACCCGCCTTGATCGTTGGGAACCGGAGCTGAATGAAGCCATACCAAACGACGAGCGTGACACCACGATGCCTGCAGCAATGGCAACAACGTTGCGCAAACTATTAACTGGCGAACTACTTACTCTAGCTTCCCGGCAACAATTAATAGACTGGATGGAGGCGGATAAAGTTGCAGGACCACTTCTGCGCTCGGCCCTTCCGGCTGGCTGGTTTATTGCTGATAAATCTGGAGCCGGTGAGCGTGGATCTCGCGGTATCATTGCAGCACTGGGGCCAGATGGTAAGCCCTCCCGTATCGTAGTTATCTACACGACGGGGAGTCAGGCAACTATGGA
gb|AY628175|+|210-1071|ARO:3000972|TEM-109 [Escherichia coli] 	0	806	46	852	861	3478183-	806	ATGAGTATTCAACATTTCCGTGTCGCCCTTATTCCCTTTTTTGCGGCATTTTGCCTTCCTGTTTTTGCTCACCCAGAAACGCTGGTGAAAGTAAAAGATGCTGAAGATCAGTTGGGTGCACGAGTGGGTTACATCGAGCTGGATCTCAACAGCGGTAAGATCCTTGAGAGTTTTCGCCCCGAAGAACGTTTTCCAATGATGAGCACTTTTAAAGTTCTGCTATGTGGTGCGGTATTATCCCGTGTTGACGCCGGGCAAGAGCAACTCGGTCGCCGCATACACTATTCTCAGAATGACTTGGTTGAGTACTCACCAGTCACAGAAAAGCATCTTACGGATGGCATGACAGTAAGAGAATTATGCAGTGCTGCCATAACCATGAGTGATAACACTGCGGCCAACTTACTTCTGACAACGATCGGAGGACCGAAGGAGCTAACCGCTTTTTTGCACAACATGGGGGATCATGTAACCCGCCTTGATCGTTGGGAACCGGAGCTGAATGAAGCCATACCAAACGACGAGCGTGACACCACGATGCCTGCAGCAATGGCAACAACGTTGCGCAAACTATTAACTGGCGAACTACTTACTCTAGCTTCCCGGCAACAATTAATAGACTGGATGGAGGCGGATAAAGTTGCAGGACCACTTCTGCGCTCGGCCCTTCCGGCTGGCTGGTTTATTGCTGATAAATCTGGAGCCGGTGAGCGTGGATCTCGCGGTATCATTGCAGCACTGGGGCCAGATGGTAAGCCCTCCCGTATCGTAGTTATCTACACGACGGGGAGTCAGGCAACTATGGA
gb|AY589495|+|181-1042|ARO:3000977|TEM-114 [Klebsiella aerogenes] 	0	806	46	852	861	3478183-	806	ATGAGTATTCAACATTTCCGTGTCGCCCTTATTCCCTTTTTTGCGGCATTTTGCCTTCCTGTTTTTGCTCACCCAGAAACGCTGGTGAAAGTAAAAGATGCTGAAGATCAGTTGGGTGCACGAGTGGGTTACATCGAGCTGGATCTCAACAGCGGTAAGATCCTTGAGAGTTTTCGCCCCGAAGAACGTTTTCCAATGATGAGCACTTTTAAAGTTCTGCTATGTGGTGCGGTATTATCCCGTGTTGACGCCGGGCAAGAGCAACTCGGTCGCCGCATACACTATTCTCAGAATGACTTGGTTGAGTACTCACCAGTCACAGAAAAGCATCTTACGGATGGCATGACAGTAAGAGAATTATGCAGTGCTGCCATAACCATGAGTGATAACACTGCGGCCAACTTACTTCTGACAACGATCGGAGGACCGAAGGAGCTAACCGCTTTTTTGCACAACATGGGGGATCATGTAACCCGCCTTGATCGTTGGGAACCGGAGCTGAATGAAGCCATACCAAACGACGAGCGTGACACCACGATGCCTGCAGCAATGGCAACAACGTTGCGCAAACTATTAACTGGCGAACTACTTACTCTAGCTTCCCGGCAACAATTAATAGACTGGATGGAGGCGGATAAAGTTGCAGGACCACTTCTGCGCTCGGCCCTTCCGGCTGGCTGGTTTATTGCTGATAAATCTGGAGCCGGTGAGCGTGGATCTCGCGGTATCATTGCAGCACTGGGGCCAGATGGTAAGCCCTCCCGTATCGTAGTTATCTACACGACGGGGAGTCAGGCAACTATGGA
gb|EF136376|+|0-861|ARO:3001025|TEM-159 [Proteus mirabilis] 	0	806	46	852	861	3478183-	806	ATGAGTATTCAACATTTCCGTGTCGCCCTTATTCCCTTTTTTGCGGCATTTTGCCTTCCTGTTTTTGCTCACCCAGAAACGCTGGTGAAAGTAAAAGATGCTGAAGATCAGTTGGGTGCACGAGTGGGTTACATCGAGCTGGATCTCAACAGCGGTAAGATCCTTGAGAGTTTTCGCCCCGAAGAACGTTTTCCAATGATGAGCACTTTTAAAGTTCTGCTATGTGGTGCGGTATTATCCCGTGTTGACGCCGGGCAAGAGCAACTCGGTCGCCGCATACACTATTCTCAGAATGACTTGGTTGAGTACTCACCAGTCACAGAAAAGCATCTTACGGATGGCATGACAGTAAGAGAATTATGCAGTGCTGCCATAACCATGAGTGATAACACTGCGGCCAACTTACTTCTGACAACGATCGGAGGACCGAAGGAGCTAACCGCTTTTTTGCACAACATGGGGGATCATGTAACCCGCCTTGATCGTTGGGAACCGGAGCTGAATGAAGCCATACCAAACGACGAGCGTGACACCACGATGCCTGCAGCAATGGCAACAACGTTGCGCAAACTATTAACTGGCGAACTACTTACTCTAGCTTCCCGGCAACAATTAATAGACTGGATGGAGGCGGATAAAGTTGCAGGACCACTTCTGCGCTCGGCCCTTCCGGCTGGCTGGTTTATTGCTGATAAATCTGGAGCCGGTGAGCGTGGATCTCGCGGTATCATTGCAGCACTGGGGCCAGATGGTAAGCCCTCCCGTATCGTAGTTATCTACACGACGGGGAGTCAGGCAACTATGGA
gb|AJ863560|+|0-861|ARO:3001111|SHV-55 [Klebsiella pneumoniae] 	0	806	16	822	861	1612535+	806	ATGCGTTATATTCGCCTGTGTATTATCACCCTGTGAGCCACCCTGCCGCTGGCGGTACACGCCAGCCCGCAGCCGCTTGAGCAAATTAAACAAAGCGAAAGCCAGCTGTCGGGCCGCGTAGGCATGATAGAAATGGATCTGGCCAGCGGCCGCACGCTGACCGCCTGGCGCGCCGATGAACGCTTTCCCATGATGAGCACCTTTAAAGTAGTGCTCTGCGGCGCAGTGCTGGCGCGGGTGGATGCCGGTGACGAACAGCTGGAGCGAAAGATCCACTATCGCCAGCAGGATCTGGTGGACTACTCGCCGGTCAGCGAAAAACACCTTGCCGACGGCATGACGGTCGGCGAACTCTGCGCCGCCGCCATTACCATGAGCGATAACAGCGCCGCCAATCTGCTGCTGGCCACCGTCGGCGGCCCCGCAGGATTGACTGCCTTTTTGCGCCAGATCGGCGACAACGTCACCCGCCTTGACCGCTGGGAAACGGAACTGAATGAGGCGCTTCCCGGCGACGCCCGCGACACCACTACCCCGGCCAGCATGGCCGCGACCCTGCGCAAGCTGCTGACCAGCCAGCGTCTGAGCGCCCGTTCGCAACGGCAGCTGCTGCAGTGGATGGTGGACGATCGGGTCGCCGGACCGTTGATCCGCTCCGTGCTGCCGGCGGGCTGGTTTATCGCCGATAAGACCGGAGCTAGCAAGCGGGGTGCGCGCGGGATTGTCGCCCTGCTTGGCCCGAATAACAAAGCAGAGCGCATTGTGGTGATTTATCTGCGGGATACGCCGGCGAGCATGGCCGAGCG
gb|AF535127|+|208-1069|ARO:3000978|TEM-115 [Klebsiella pneumoniae] 	0	806	46	852	861	3478183-	806	ATGAGTATTCAACATTTCCGTGTCGCCCTTATTCCCTTTTTTGCGGCATTTTGCCTTCCTGTTTTTGCTCACCCAGAAACGCTGGTGAAAGTAAAAGATGCTGAAGATCAGTTGGGTGCACGAGTGGGTTACATCGAGCTGGATCTCAACAGCGGTAAGATCCTTGAGAGTTTTCGCCCCGAAGAACGTTTTCCAATGATGAGCACTTTTAAAGTTCTGCTATGTGGTGCGGTATTATCCCGTGTTGACGCCGGGCAAGAGCAACTCGGTCGCCGCATACACTATTCTCAGAATGACTTGGTTGAGTACTCACCAGTCACAGAAAAGCATCTTACGGATGGCATGACAGTAAGAGAATTATGCAGTGCTGCCATAACCATGAGTGATAACACTGCGGCCAACTTACTTCTGACAACGATCGGAGGACCGAAGGAGCTAACCGCTTTTTTGCACAACATGGGGGATCATGTAACCCGCCTTGATCGTTGGGAACCGGAGCTGAATGAAGCCATACCAAACGACGAGCGTGACACCACGATGCCTGCAGCAATGGCAACAACGTTGCGCAAACTATTAACTGGCGAACTACTTACTCTAGCTTCCCGGCAACAATTAATAGACTGGATGGAGGCGGATAAAGTTGCAGGACCACTTCTGCGCTCGGCCCTTCCGGCTGGCTGGTTTATTGCTGATAAATCTGGAGCCGGTGAGCGTGGATCTCGCGGTATCATTGCAGCACTGGGGCCAGATGGTAAGCCCTCCCGTATCGTAGTTATCTACACGACGGGGAGTCAGGCAACTATGGA
gb|FR865168|+|0-825|ARO:3001488|OXA-216 [Acinetobacter baumannii] 	0	770	54149	54919	825	246080-	770	ATGAACATTAAAGCACTCTTACTTATAACAAGCGCTATTTTTATTTCAGCCTGCTCACCTTATATAGTGACTGCTAATCCAAATCACAGCGCTTCAAAATCTGATGTAAAAGCAGAGAAAATTAAAAATTTATTTAACGAAGCACACACTACGGGTGTTTTAGTTATCCAACAAGGCCAAACTCAACAAAGCTATGGTAATGATCTTGCTCGTGCTTCGACCGAGTATGTACCTGCTTCGACCTTCAAAATGCTTAATGCTTTGATCGGCCTTGAGCACCATAAGGCAACCACCACAGAAGTATTTAAGTGGGATGGTAAAAAAAGGTTATTCCCAGAATGGGAAAAGGACATGACCCTAGGCGATGCCATGAAAGCTTCCGCTATTCCAGTTTATCAAGATTTAGCTCGTCGTATTGGACTTGAGCTCATGTCTAAGGAAGTGAAGCGTGTTGGTTATGGCAATGCAGATATCGGTACCCAAGTCGATAATTTTTGGCTGGTGGGTCCTTTAAAAATTACTCCTCAGCAAGAGGCACAGTTTGCTTACAAGCTAGCTAATAAAACGCTTCCATTTAGCCAAAAAGTCCAAGATGAAGTGCAATCCATGCTATTCATAGAAGAAAAGAATGGAAACAAAATATACGCAAAAAGTGGTTGGGGATGGGATGTAAACCCACAAGTAGGCTGGTTAACTGGATGGGTTGTTCAGCCTCAAGGGAATATTGTAGCGTTCTCCCTTAACTTAGAAATGAAAAAAGGAATACCTAG
gb|KF986261|-|44-869|ARO:3001566|OXA-380 [Acinetobacter baumannii] 	0	770	54149	54919	825	246080-	770	ATGAACATTAAAGCACTCTTACTTATAACAAGCGCTATTTTTATTTCAGCCTGCTCACCTTATATAGTGACTGCTAATCCAAATCACAGCGCTTCAAAATCTGATGTAAAAGCAGAGAAAATTAAAAATTTATTTAACGAAGCACACACTACGGGTGTTTTAGTTATCCAACAAGGCCAAACTCAACAAAGCTATGGTAATGATCTTGCTCGTGCTTCGACCGAGTATGTACCTGCTTCGACCTTCAAAATGCTTAATGCTTTGATCGGCCTTGAGCACCATAAGGCAACCACCACAGAAGTATTTAAGTGGGATGGTAAAAAAAGGTTATTCCCAGAATGGGAAAAGGACATGACCCTAGGCGATGCCATGAAAGCTTCCGCTATTCCAGTTTATCAAGATTTAGCTCGTCGTATTGGACTTGAGCTCATGTCTAAGGAAGTGAAGCGTGTTGGTTATGGCAATGCAGATATCGGTACCCAAGTCGATAATTTTTGGCTGGTGGGTCCTTTAAAAATTACTCCTCAGCAAGAGGCACAGTTTGCTTACAAGCTAGCTAATAAAACGCTTCCATTTAGCCAAAAAGTCCAAGATGAAGTGCAATCCATGCTATTCATAGAAGAAAAGAATGGAAACAAAATATACGCAAAAAGTGGTTGGGGATGGGATGTAAACCCACAAGTAGGCTGGTTAACTGGATGGGTTGTTCAGCCTCAAGGGAATATTGTAGCGTTCTCCCTTAACTTAGAAATGAAAAAAGGAATACCTAG
gb|U36911.1|+|1429-2290|ARO:3000979|TEM-116 [Staphylococcus aureus] 	0	806	46	852	861	3478183-	806	ATGAGTATTCAACATTTCCGTGTCGCCCTTATTCCCTTTTTTGCGGCATTTTGCCTTCCTGTTTTTGCTCACCCAGAAACGCTGGTGAAAGTAAAAGATGCTGAAGATCAGTTGGGTGCACGAGTGGGTTACATCGAGCTGGATCTCAACAGCGGTAAGATCCTTGAGAGTTTTCGCCCCGAAGAACGTTTTCCAATGATGAGCACTTTTAAAGTTCTGCTATGTGGTGCGGTATTATCCCGTGTTGACGCCGGGCAAGAGCAACTCGGTCGCCGCATACACTATTCTCAGAATGACTTGGTTGAGTACTCACCAGTCACAGAAAAGCATCTTACGGATGGCATGACAGTAAGAGAATTATGCAGTGCTGCCATAACCATGAGTGATAACACTGCGGCCAACTTACTTCTGACAACGATCGGAGGACCGAAGGAGCTAACCGCTTTTTTGCACAACATGGGGGATCATGTAACCCGCCTTGATCGTTGGGAACCGGAGCTGAATGAAGCCATACCAAACGACGAGCGTGACACCACGATGCCTGCAGCAATGGCAACAACGTTGCGCAAACTATTAACTGGCGAACTACTTACTCTAGCTTCCCGGCAACAATTAATAGACTGGATGGAGGCGGATAAAGTTGCAGGACCACTTCTGCGCTCGGCCCTTCCGGCTGGCTGGTTTATTGCTGATAAATCTGGAGCCGGTGAGCGTGGATCTCGCGGTATCATTGCAGCACTGGGGCCAGATGGTAAGCCCTCCCGTATCGTAGTTATCTACACGACGGGGAGTCAGGCAACTATGGA
gb|EU586041|+|0-861|ARO:3001112|SHV-56 [Klebsiella pneumoniae] 	0	806	16	822	861	1612535+	806	ATGCGTTATATTCGCCTGTGTATTATCACCCTGTGAGCCACCCTGCCGCTGGCGGTACACGCCAGCCCGCAGCCGCTTGAGCAAATTAAACAAAGCGAAAGCCAGCTGTCGGGCCGCGTAGGCATGATAGAAATGGATCTGGCCAGCGGCCGCACGCTGACCGCCTGGCGCGCCGATGAACGCTTTCCCATGATGAGCACCTTTAAAGTAGTGCTCTGCGGCGCAGTGCTGGCGCGGGTGGATGCCGGTGACGAACAGCTGGAGCGAAAGATCCACTATCGCCAGCAGGATCTGGTGGACTACTCGCCGGTCAGCGAAAAACACCTTGCCGACGGCATGACGGTCGGCGAACTCTGCGCCGCCGCCATTACCATGAGCGATAACAGCGCCGCCAATCTGCTGCTGGCCACCGTCGGCGGCCCCGCAGGATTGACTGCCTTTTTGCGCCAGATCGGCGACAACGTCACCCGCCTTGACCGCTGGGAAACGGAACTGAATGAGGCGCTTCCCGGCGACGCCCGCGACACCACTACCCCGGCCAGCATGGCCGCGACCCTGCGCAAGCTGCTGACCAGCCAGCGTCTGAGCGCCCGTTCGCAACGGCAGCTGCTGCAGTGGATGGTGGACGATCGGGTCGCCGGACCGTTGATCCGCTCCGTGCTGCCGGCGGGCTGGTTTATCGCCGATAAGACCGGAGCTAGCAAGCGGGGTGCGCGCGGGATTGTCGCCCTGCTTGGCCCGAATAACAAAGCAGAGCGCATTGTGGTGATTTATCTGCGGGATACGCCGGCGAGCATGGCCGAGCG
gb|DQ888718|+|0-825|ARO:3001649|OXA-99 [Acinetobacter baumannii] 	0	770	54149	54919	825	246080-	770	ATGAACATTAAAGCACTCTTACTTATAACAAGCGCTATTTTTATTTCAGCCTGCTCACCTTATATAGTGACTGCTAATCCAAATCACAGCGCTTCAAAATCTGATGTAAAAGCAGAGAAAATTAAAAATTTATTTAACGAAGCACACACTACGGGTGTTTTAGTTATCCAACAAGGCCAAACTCAACAAAGCTATGGTAATGATCTTGCTCGTGCTTCGACCGAGTATGTACCTGCTTCGACCTTCAAAATGCTTAATGCTTTGATCGGCCTTGAGCACCATAAGGCAACCACCACAGAAGTATTTAAGTGGGATGGTAAAAAAAGGTTATTCCCAGAATGGGAAAAGGACATGACCCTAGGCGATGCCATGAAAGCTTCCGCTATTCCAGTTTATCAAGATTTAGCTCGTCGTATTGGACTTGAGCTCATGTCTAAGGAAGTGAAGCGTGTTGGTTATGGCAATGCAGATATCGGTACCCAAGTCGATAATTTTTGGCTGGTGGGTCCTTTAAAAATTACTCCTCAGCAAGAGGCACAGTTTGCTTACAAGCTAGCTAATAAAACGCTTCCATTTAGCCAAAAAGTCCAAGATGAAGTGCAATCCATGCTATTCATAGAAGAAAAGAATGGAAACAAAATATACGCAAAAAGTGGTTGGGGATGGGATGTAAACCCACAAGTAGGCTGGTTAACTGGATGGGTTGTTCAGCCTCAAGGGAATATTGTAGCGTTCTCCCTTAACTTAGAAATGAAAAAAGGAATACCTAG
gb|KC866352.1|+|0-1152|ARO:3004493|ADC-68 [Acinetobacter baumannii] 	0	1097	63	1160	1152	126080+	1097	ATGCGATTTAAAAAAATTTCTTGTCTACTTTTATCCCCGCTTTTTATTTTTAGTACCTCAATTTATGCGGGCAATACACCAAAAGACCAAGAAATTAAAAAACTGGTAGATCAAAACTTTAAACCGTTATTAGAAAAATATGATGTGCCAGGTATGGCTGTGGGTGTTATTCAAAATAATAAAAAGTATGAAATGTATTATGGTCTTCAATCTGTTCAAGATAAAAAAGCCGTAAATAGCAGTACTATTTTTGAGCTAGGTTCTGTCAGTAAATTATTTACCGCGACAGCAGGTGGATATGCAAAAAATAAAGGAAAAATCTCTTTTGACGATACGCCTGGTAAGTATTGGAAAGAACTAAAAAATACACCGATTGACCAAGTTAACTTACTTCAACTCGCGACGTATACAAGTGGTAACCTTGCCTTGCAATTTCCAGATGAAGTAAAAACAGATCAGCAAGTTTTAACATTTTTTAAAGACTGGAAACCTAAAAACTCAATCGGTGAATATCGACAATATTCAAACCCAAGCATTGGTTTATTTGGAAAAGTTGTAGCTTTGTCTATGAATAAACCTTTCGACCAAGTCTTAGAAAAAACAATTTTTCCGGCCCTTGGCTTAAAACATAGCTATGTAAATGTACCTAAGACCCAGATGCAAAACTATGCTTTTGGCTATAACCAAGAAAATCAGCCGATTCGAGTTAACCCCGGCCCACTCGATGCCCCAGCATATGGCGTCAAATCGACACTACCCGACATGTTGAGTTTTATTCATGCCAACCTAAATCCACAAAAATATCCAGCAGATATTCAACGGGCAATTAATGAAACACATCAGGGTCGCTATCAAGTAAATACCATGTATCAGGCACTCGGTTGGGAAGAGTTTTCTTATCCGGCAACGTTACAAACTTTATTAGACAGTAATTCAGAACAGATTGTGATGAAACCTAATAAAGTGACTGCTATTTCAAAGGAACCTTCAGTTAAGATGTACCATAAAACTGGCTCAACTACCGGTTTCGGAACATATGTGGTGTTTATTCCTAAAGAAAATATTGGTTTAGTCATGTTAACCAATAAACGTATTCC
gb|X65254|+|175-1036|ARO:3000887|TEM-16 [Klebsiella pneumoniae] 	0	806	46	852	861	3478183-	806	ATGAGTATTCAACATTTCCGTGTCGCCCTTATTCCCTTTTTTGCGGCATTTTGCCTTCCTGTTTTTGCTCACCCAGAAACGCTGGTGAAAGTAAAAGATGCTGAAGATCAGTTGGGTGCACGAGTGGGTTACATCGAGCTGGATCTCAACAGCGGTAAGATCCTTGAGAGTTTTCGCCCCGAAGAACGTTTTCCAATGATGAGCACTTTTAAAGTTCTGCTATGTGGTGCGGTATTATCCCGTGTTGACGCCGGGCAAGAGCAACTCGGTCGCCGCATACACTATTCTCAGAATGACTTGGTTGAGTACTCACCAGTCACAGAAAAGCATCTTACGGATGGCATGACAGTAAGAGAATTATGCAGTGCTGCCATAACCATGAGTGATAACACTGCGGCCAACTTACTTCTGACAACGATCGGAGGACCGAAGGAGCTAACCGCTTTTTTGCACAACATGGGGGATCATGTAACCCGCCTTGATCGTTGGGAACCGGAGCTGAATGAAGCCATACCAAACGACGAGCGTGACACCACGATGCCTGCAGCAATGGCAACAACGTTGCGCAAACTATTAACTGGCGAACTACTTACTCTAGCTTCCCGGCAACAATTAATAGACTGGATGGAGGCGGATAAAGTTGCAGGACCACTTCTGCGCTCGGCCCTTCCGGCTGGCTGGTTTATTGCTGATAAATCTGGAGCCGGTGAGCGTGGATCTCGCGGTATCATTGCAGCACTGGGGCCAGATGGTAAGCCCTCCCGTATCGTAGTTATCTACACGACGGGGAGTCAGGCAACTATGGA
gb|AY130282|+|0-764|ARO:3000980|TEM-117 [Escherichia coli] Partial	0	709	82	791	764	3478183-	709	TTTTTTGCGGCATTTTGCCTTCCTGTTTTTGCTCACCCAGAAACGCTGGTGAAAGTAAAAGATGCTGAAGATCAGTTGGGTGCACGAGTGGGTTACATCGAGCTGGATCTCAACAGCGGTAAGATCCTTGAGAGTTTTCGCCCCGAAGAACGTTTTCCAATGATGAGCACTTTTAAAGTTCTGCTATGTGGTGCGGTATTATCCCGTGTTGACGCCGGGCAAGAGCAACTCGGTCGCCGCATACACTATTCTCAGAATGACTTGGTTGAGTACTCACCAGTCACAGAAAAGCATCTTACGGATGGCATGACAGTAAGAGAATTATGCAGTGCTGCCATAACCATGAGTGATAACACTGCGGCCAACTTACTTCTGACAACGATCGGAGGACCGAAGGAGCTAACCGCTTTTTTGCACAACATGGGGGATCATGTAACCCGCCTTGATCGTTGGGAACCGGAGCTGAATGAAGCCATACCAAACGACGAGCGTGACACCACGATGCCTGCAGCAATGGCAACAACGTTGCGCAAACTATTAACTGGCGAACTACTTACTCTAGCTTCCCGGCAACAATTAATAGACTGGATGGAGGCGGATAAAGTTGCAGGACCACTTCTGCGCTCGGCCCTTCCGGCTGGCTGGTTTATTGCTGATAAATCTGGAGCCGGTGAGCGTGGATCTCGCGGTATCATTGCAGCACTGGGGC
gb|JN603240|+|0-825|ARO:3001489|OXA-217 [Acinetobacter baumannii] 	0	770	54149	54919	825	246080-	770	ATGAACATTAAAGCACTCTTACTTATAACAAGCGCTATTTTTATTTCAGCCTGCTCACCTTATATAGTGACTGCTAATCCAAATCACAGCGCTTCAAAATCTGATGTAAAAGCAGAGAAAATTAAAAATTTATTTAACGAAGCACACACTACGGGTGTTTTAGTTATCCAACAAGGCCAAACTCAACAAAGCTATGGTAATGATCTTGCTCGTGCTTCGACCGAGTATGTACCTGCTTCGACCTTCAAAATGCTTAATGCTTTGATCGGCCTTGAGCACCATAAGGCAACCACCACAGAAGTATTTAAGTGGGATGGTAAAAAAAGGTTATTCCCAGAATGGGAAAAGGACATGACCCTAGGCGATGCCATGAAAGCTTCCGCTATTCCAGTTTATCAAGATTTAGCTCGTCGTATTGGACTTGAGCTCATGTCTAAGGAAGTGAAGCGTGTTGGTTATGGCAATGCAGATATCGGTACCCAAGTCGATAATTTTTGGCTGGTGGGTCCTTTAAAAATTACTCCTCAGCAAGAGGCACAGTTTGCTTACAAGCTAGCTAATAAAACGCTTCCATTTAGCCAAAAAGTCCAAGATGAAGTGCAATCCATGCTATTCATAGAAGAAAAGAATGGAAACAAAATATACGCAAAAAGTGGTTGGGGATGGGATGTAAACCCACAAGTAGGCTGGTTAACTGGATGGGTTGTTCAGCCTCAAGGGAATATTGTAGCGTTCTCCCTTAACTTAGAAATGAAAAAAGGAATACCTAG
gb|AY130285|+|0-785|ARO:3000981|TEM-118 [Klebsiella oxytoca] Partial	0	730	82	812	785	3478183-	730	TTTTTTGCGGCATTTTGCCTTCCTGTTTTTGCTCACCCAGAAACGCTGGTGAAAGTAAAAGATGCTGAAGATCAGTTGGGTGCACGAGTGGGTTACATCGAGCTGGATCTCAACAGCGGTAAGATCCTTGAGAGTTTTCGCCCCGAAGAACGTTTTCCAATGATGAGCACTTTTAAAGTTCTGCTATGTGGTGCGGTATTATCCCGTGTTGACGCCGGGCAAGAGCAACTCGGTCGCCGCATACACTATTCTCAGAATGACTTGGTTGAGTACTCACCAGTCACAGAAAAGCATCTTACGGATGGCATGACAGTAAGAGAATTATGCAGTGCTGCCATAACCATGAGTGATAACACTGCGGCCAACTTACTTCTGACAACGATCGGAGGACCGAAGGAGCTAACCGCTTTTTTGCACAACATGGGGGATCATGTAACCCGCCTTGATCGTTGGGAACCGGAGCTGAATGAAGCCATACCAAACGACGAGCGTGACACCACGATGCCTGCAGCAATGGCAACAACGTTGCGCAAACTATTAACTGGCGAACTACTTACTCTAGCTTCCCGGCAACAATTAATAGACTGGATGGAGGCGGATAAAGTTGCAGGACCACTTCTGCGCTCGGCCCTTCCGGCTGGCTGGTTTATTGCTGATAAATCTGGAGCCGGTGAGCGTGGATCTCGCGGTATCATTGCAGCACTGGGGCCAGATGGTAAGCCCTCCCGTA
gb|M88143|+|367-1228|ARO:3000884|TEM-12 [Klebsiella oxytoca] 	0	806	46	852	861	3478183-	806	ATGAGTATTCAACATTTCCGTGTCGCCCTTATTCCCTTTTTTGCGGCATTTTGCCTTCCTGTTTTTGCTCACCCAGAAACGCTGGTGAAAGTAAAAGATGCTGAAGATCAGTTGGGTGCACGAGTGGGTTACATCGAGCTGGATCTCAACAGCGGTAAGATCCTTGAGAGTTTTCGCCCCGAAGAACGTTTTCCAATGATGAGCACTTTTAAAGTTCTGCTATGTGGTGCGGTATTATCCCGTGTTGACGCCGGGCAAGAGCAACTCGGTCGCCGCATACACTATTCTCAGAATGACTTGGTTGAGTACTCACCAGTCACAGAAAAGCATCTTACGGATGGCATGACAGTAAGAGAATTATGCAGTGCTGCCATAACCATGAGTGATAACACTGCGGCCAACTTACTTCTGACAACGATCGGAGGACCGAAGGAGCTAACCGCTTTTTTGCACAACATGGGGGATCATGTAACCCGCCTTGATCGTTGGGAACCGGAGCTGAATGAAGCCATACCAAACGACGAGCGTGACACCACGATGCCTGCAGCAATGGCAACAACGTTGCGCAAACTATTAACTGGCGAACTACTTACTCTAGCTTCCCGGCAACAATTAATAGACTGGATGGAGGCGGATAAAGTTGCAGGACCACTTCTGCGCTCGGCCCTTCCGGCTGGCTGGTTTATTGCTGATAAATCTGGAGCCGGTGAGCGTGGATCTCGCGGTATCATTGCAGCACTGGGGCCAGATGGTAAGCCCTCCCGTATCGTAGTTATCTACACGACGGGGAGTCAGGCAACTATGGA
gb|EF136377|+|0-861|ARO:3001026|TEM-160 [Proteus mirabilis] 	0	806	46	852	861	3478183-	806	ATGAGTATTCAACATTTCCGTGTCGCCCTTATTCCCTTTTTTGCGGCATTTTGCCTTCCTGTTTTTGCTCACCCAGAAACGCTGGTGAAAGTAAAAGATGCTGAAGATCAGTTGGGTGCACGAGTGGGTTACATCGAGCTGGATCTCAACAGCGGTAAGATCCTTGAGAGTTTTCGCCCCGAAGAACGTTTTCCAATGATGAGCACTTTTAAAGTTCTGCTATGTGGTGCGGTATTATCCCGTGTTGACGCCGGGCAAGAGCAACTCGGTCGCCGCATACACTATTCTCAGAATGACTTGGTTGAGTACTCACCAGTCACAGAAAAGCATCTTACGGATGGCATGACAGTAAGAGAATTATGCAGTGCTGCCATAACCATGAGTGATAACACTGCGGCCAACTTACTTCTGACAACGATCGGAGGACCGAAGGAGCTAACCGCTTTTTTGCACAACATGGGGGATCATGTAACCCGCCTTGATCGTTGGGAACCGGAGCTGAATGAAGCCATACCAAACGACGAGCGTGACACCACGATGCCTGCAGCAATGGCAACAACGTTGCGCAAACTATTAACTGGCGAACTACTTACTCTAGCTTCCCGGCAACAATTAATAGACTGGATGGAGGCGGATAAAGTTGCAGGACCACTTCTGCGCTCGGCCCTTCCGGCTGGCTGGTTTATTGCTGATAAATCTGGAGCCGGTGAGCGTGGATCTCGCGGTATCATTGCAGCACTGGGGCCAGATGGTAAGCCCTCCCGTATCGTAGTTATCTACACGACGGGGAGTCAGGCAACTATGGA
gb|AY223863|+|170-1031|ARO:3001113|SHV-57 [Escherichia coli] 	0	806	16	822	861	1612535+	806	ATGCGTTATATTCGCCTGTGTATTATCACCCTGTGAGCCACCCTGCCGCTGGCGGTACACGCCAGCCCGCAGCCGCTTGAGCAAATTAAACAAAGCGAAAGCCAGCTGTCGGGCCGCGTAGGCATGATAGAAATGGATCTGGCCAGCGGCCGCACGCTGACCGCCTGGCGCGCCGATGAACGCTTTCCCATGATGAGCACCTTTAAAGTAGTGCTCTGCGGCGCAGTGCTGGCGCGGGTGGATGCCGGTGACGAACAGCTGGAGCGAAAGATCCACTATCGCCAGCAGGATCTGGTGGACTACTCGCCGGTCAGCGAAAAACACCTTGCCGACGGCATGACGGTCGGCGAACTCTGCGCCGCCGCCATTACCATGAGCGATAACAGCGCCGCCAATCTGCTGCTGGCCACCGTCGGCGGCCCCGCAGGATTGACTGCCTTTTTGCGCCAGATCGGCGACAACGTCACCCGCCTTGACCGCTGGGAAACGGAACTGAATGAGGCGCTTCCCGGCGACGCCCGCGACACCACTACCCCGGCCAGCATGGCCGCGACCCTGCGCAAGCTGCTGACCAGCCAGCGTCTGAGCGCCCGTTCGCAACGGCAGCTGCTGCAGTGGATGGTGGACGATCGGGTCGCCGGACCGTTGATCCGCTCCGTGCTGCCGGCGGGCTGGTTTATCGCCGATAAGACCGGAGCTAGCAAGCGGGGTGCGCGCGGGATTGTCGCCCTGCTTGGCCCGAATAACAAAGCAGAGCGCATTGTGGTGATTTATCTGCGGGATACGCCGGCGAGCATGGCCGAGCG
gb|JN215211|+|0-825|ARO:3001668|OXA-219 [Acinetobacter baumannii] 	0	770	54149	54919	825	246080-	770	ATGAACATTAAAGCACTCTTACTTATAACAAGCGCTATTTTTATTTCAGCCTGCTCACCTTATATAGTGACTGCTAATCCAAATCACAGCGCTTCAAAATCTGATGTAAAAGCAGAGAAAATTAAAAATTTATTTAACGAAGCACACACTACGGGTGTTTTAGTTATCCAACAAGGCCAAACTCAACAAAGCTATGGTAATGATCTTGCTCGTGCTTCGACCGAGTATGTACCTGCTTCGACCTTCAAAATGCTTAATGCTTTGATCGGCCTTGAGCACCATAAGGCAACCACCACAGAAGTATTTAAGTGGGATGGTAAAAAAAGGTTATTCCCAGAATGGGAAAAGGACATGACCCTAGGCGATGCCATGAAAGCTTCCGCTATTCCAGTTTATCAAGATTTAGCTCGTCGTATTGGACTTGAGCTCATGTCTAAGGAAGTGAAGCGTGTTGGTTATGGCAATGCAGATATCGGTACCCAAGTCGATAATTTTTGGCTGGTGGGTCCTTTAAAAATTACTCCTCAGCAAGAGGCACAGTTTGCTTACAAGCTAGCTAATAAAACGCTTCCATTTAGCCAAAAAGTCCAAGATGAAGTGCAATCCATGCTATTCATAGAAGAAAAGAATGGAAACAAAATATACGCAAAAAGTGGTTGGGGATGGGATGTAAACCCACAAGTAGGCTGGTTAACTGGATGGGTTGTTCAGCCTCAAGGGAATATTGTAGCGTTCTCCCTTAACTTAGAAATGAAAAAAGGAATACCTAG
gb|AY243512|+|208-1069|ARO:3000982|TEM-120 [Klebsiella oxytoca] 	0	806	46	852	861	3478183-	806	ATGAGTATTCAACATTTCCGTGTCGCCCTTATTCCCTTTTTTGCGGCATTTTGCCTTCCTGTTTTTGCTCACCCAGAAACGCTGGTGAAAGTAAAAGATGCTGAAGATCAGTTGGGTGCACGAGTGGGTTACATCGAGCTGGATCTCAACAGCGGTAAGATCCTTGAGAGTTTTCGCCCCGAAGAACGTTTTCCAATGATGAGCACTTTTAAAGTTCTGCTATGTGGTGCGGTATTATCCCGTGTTGACGCCGGGCAAGAGCAACTCGGTCGCCGCATACACTATTCTCAGAATGACTTGGTTGAGTACTCACCAGTCACAGAAAAGCATCTTACGGATGGCATGACAGTAAGAGAATTATGCAGTGCTGCCATAACCATGAGTGATAACACTGCGGCCAACTTACTTCTGACAACGATCGGAGGACCGAAGGAGCTAACCGCTTTTTTGCACAACATGGGGGATCATGTAACCCGCCTTGATCGTTGGGAACCGGAGCTGAATGAAGCCATACCAAACGACGAGCGTGACACCACGATGCCTGCAGCAATGGCAACAACGTTGCGCAAACTATTAACTGGCGAACTACTTACTCTAGCTTCCCGGCAACAATTAATAGACTGGATGGAGGCGGATAAAGTTGCAGGACCACTTCTGCGCTCGGCCCTTCCGGCTGGCTGGTTTATTGCTGATAAATCTGGAGCCGGTGAGCGTGGATCTCGCGGTATCATTGCAGCACTGGGGCCAGATGGTAAGCCCTCCCGTATCGTAGTTATCTACACGACGGGGAGTCAGGCAACTATGGA
gb|KR057753.1|+|0-1116|ARO:3004347|PDC-84 [Pseudomonas aeruginosa] 	3	1061	35594	36652	1116	232416+	1058	GAGGCCCCGGCGGATCGCCTGAAGGCACTGGTCGACGCCGCCGTACAACCGGTGATGAAGGCCAATGACATTCCGGGCCTGGCCGTAGCCATCAGCCTGAAAGGAGAACCGCATTACTTCAGCTATGGGCTGGCCTCGAAAGAGGACGGCCGCCGGGTGACGCCGGAGACCCTGTTCGAGATCGGCTCGGTGAGCAAGACCTTCACCGTCACCCTCGCCGGCTATGCCCTGGCCCAGGACAAGATGCGCCTCGACGACCGCGCCAGCCAGCACTGGCCGGCACTGCAGGGCAGCCGCTTCGACGGCATCAGCCTGCTCGACCTCGCGACCTATACCGCCGGCGGCTTGCCGCTGCAGTTCCCCGACTCGGTGCAGAAGGACCAGGCACAGATCCGCGACTACTACCGCCAGTGGCAGCCGACCTACGCGCCGGGCAGCCAGCGCCTCTATTCCAACCCGAGCATCGGCCTGTTCGGCTATCTCGCCGCGCGCAGCCTGGGCCAGCCGTTCGAACGGCTCATGGAGCAGCAATTGTTCCCGGCACTGGGCCTCGAACAGACCCACCTCGACGTGCCCGAGGCGGCGCTGGCGCAGTACGCCCAGGGCTACGGCAAGGACGACCGCCCGCTACGGGTCGGTCCCGGCCCGCTGGATGCCGAAGGCTACGGGGTGAAGACCAGCGCGGCCGACCTGCTGCGCTTCGTCGATGCCAACCTGCATCCGGAGCGCCTGGACAGGCCCTGGGCGCAGGCGCTCGATGCCACCCATCGCGGTTACTACAAGGTCGGCGACATGACCCAGGGCCTGGGCTGGGAAGCCTACGACTGGCCGATCTCCCTGAAGCGCCTGCAGGCCGGCAACTCGACGCCGATGGCGCTGCAACCACACAGGATCGCCAGGCTGCCCGCGCCACAGGCGCTGGAGGGCCAGCGCCTGCTGAACAAGACCGGCTCCACCAACGGCTTCGGCGCCTACGTGGCGTTCGTCCCGGGCCGCGACCTGGGCCTGGTGATCCTGGCCAACCGCAACTATCCCAATGCCGAGCGGGTGAAGATCGC
gb|KJ135344|+|14-839|ARO:3001567|OXA-381 [Acinetobacter baumannii] 	0	770	54149	54919	825	246080-	770	ATGAACATTAAAGCACTCTTACTTATAACAAGCGCTATTTTTATTTCAGCCTGCTCACCTTATATAGTGACTGCTAATCCAAATCACAGCGCTTCAAAATCTGATGTAAAAGCAGAGAAAATTAAAAATTTATTTAACGAAGCACACACTACGGGTGTTTTAGTTATCCAACAAGGCCAAACTCAACAAAGCTATGGTAATGATCTTGCTCGTGCTTCGACCGAGTATGTACCTGCTTCGACCTTCAAAATGCTTAATGCTTTGATCGGCCTTGAGCACCATAAGGCAACCACCACAGAAGTATTTAAGTGGGATGGTAAAAAAAGGTTATTCCCAGAATGGGAAAAGGACATGACCCTAGGCGATGCCATGAAAGCTTCCGCTATTCCAGTTTATCAAGATTTAGCTCGTCGTATTGGACTTGAGCTCATGTCTAAGGAAGTGAAGCGTGTTGGTTATGGCAATGCAGATATCGGTACCCAAGTCGATAATTTTTGGCTGGTGGGTCCTTTAAAAATTACTCCTCAGCAAGAGGCACAGTTTGCTTACAAGCTAGCTAATAAAACGCTTCCATTTAGCCAAAAAGTCCAAGATGAAGTGCAATCCATGCTATTCATAGAAGAAAAGAATGGAAACAAAATATACGCAAAAAGTGGTTGGGGATGGGATGTAAACCCACAAGTAGGCTGGTTAACTGGATGGGTTGTTCAGCCTCAAGGGAATATTGTAGCGTTCTCCCTTAACTTAGAAATGAAAAAAGGAATACCTAG
gb|AY271267|+|0-861|ARO:3000983|TEM-121 [Escherichia coli] 	0	806	46	852	861	3478183-	806	ATGAGTATTCAACATTTCCGTGTCGCCCTTATTCCCTTTTTTGCGGCATTTTGCCTTCCTGTTTTTGCTCACCCAGAAACGCTGGTGAAAGTAAAAGATGCTGAAGATCAGTTGGGTGCACGAGTGGGTTACATCGAGCTGGATCTCAACAGCGGTAAGATCCTTGAGAGTTTTCGCCCCGAAGAACGTTTTCCAATGATGAGCACTTTTAAAGTTCTGCTATGTGGTGCGGTATTATCCCGTGTTGACGCCGGGCAAGAGCAACTCGGTCGCCGCATACACTATTCTCAGAATGACTTGGTTGAGTACTCACCAGTCACAGAAAAGCATCTTACGGATGGCATGACAGTAAGAGAATTATGCAGTGCTGCCATAACCATGAGTGATAACACTGCGGCCAACTTACTTCTGACAACGATCGGAGGACCGAAGGAGCTAACCGCTTTTTTGCACAACATGGGGGATCATGTAACCCGCCTTGATCGTTGGGAACCGGAGCTGAATGAAGCCATACCAAACGACGAGCGTGACACCACGATGCCTGCAGCAATGGCAACAACGTTGCGCAAACTATTAACTGGCGAACTACTTACTCTAGCTTCCCGGCAACAATTAATAGACTGGATGGAGGCGGATAAAGTTGCAGGACCACTTCTGCGCTCGGCCCTTCCGGCTGGCTGGTTTATTGCTGATAAATCTGGAGCCGGTGAGCGTGGATCTCGCGGTATCATTGCAGCACTGGGGCCAGATGGTAAGCCCTCCCGTATCGTAGTTATCTACACGACGGGGAGTCAGGCAACTATGGA
gb|JN248564|+|0-825|ARO:3001669|OXA-223 [Acinetobacter baumannii] 	0	770	54149	54919	825	246080-	770	ATGAACATTAAAGCACTCTTACTTATAACAAGCGCTATTTTTATTTCAGCCTGCTCACCTTATATAGTGACTGCTAATCCAAATCACAGCGCTTCAAAATCTGATGTAAAAGCAGAGAAAATTAAAAATTTATTTAACGAAGCACACACTACGGGTGTTTTAGTTATCCAACAAGGCCAAACTCAACAAAGCTATGGTAATGATCTTGCTCGTGCTTCGACCGAGTATGTACCTGCTTCGACCTTCAAAATGCTTAATGCTTTGATCGGCCTTGAGCACCATAAGGCAACCACCACAGAAGTATTTAAGTGGGATGGTAAAAAAAGGTTATTCCCAGAATGGGAAAAGGACATGACCCTAGGCGATGCCATGAAAGCTTCCGCTATTCCAGTTTATCAAGATTTAGCTCGTCGTATTGGACTTGAGCTCATGTCTAAGGAAGTGAAGCGTGTTGGTTATGGCAATGCAGATATCGGTACCCAAGTCGATAATTTTTGGCTGGTGGGTCCTTTAAAAATTACTCCTCAGCAAGAGGCACAGTTTGCTTACAAGCTAGCTAATAAAACGCTTCCATTTAGCCAAAAAGTCCAAGATGAAGTGCAATCCATGCTATTCATAGAAGAAAAGAATGGAAACAAAATATACGCAAAAAGTGGTTGGGGATGGGATGTAAACCCACAAGTAGGCTGGTTAACTGGATGGGTTGTTCAGCCTCAAGGGAATATTGTAGCGTTCTCCCTTAACTTAGAAATGAAAAAAGGAATACCTAG
gb|AY790341|+|0-861|ARO:3001114|SHV-59 [Klebsiella pneumoniae] 	0	806	16	822	861	1612535+	806	ATGCGTTATATTCGCCTGTGTATTATCACCCTGTGAGCCACCCTGCCGCTGGCGGTACACGCCAGCCCGCAGCCGCTTGAGCAAATTAAACAAAGCGAAAGCCAGCTGTCGGGCCGCGTAGGCATGATAGAAATGGATCTGGCCAGCGGCCGCACGCTGACCGCCTGGCGCGCCGATGAACGCTTTCCCATGATGAGCACCTTTAAAGTAGTGCTCTGCGGCGCAGTGCTGGCGCGGGTGGATGCCGGTGACGAACAGCTGGAGCGAAAGATCCACTATCGCCAGCAGGATCTGGTGGACTACTCGCCGGTCAGCGAAAAACACCTTGCCGACGGCATGACGGTCGGCGAACTCTGCGCCGCCGCCATTACCATGAGCGATAACAGCGCCGCCAATCTGCTGCTGGCCACCGTCGGCGGCCCCGCAGGATTGACTGCCTTTTTGCGCCAGATCGGCGACAACGTCACCCGCCTTGACCGCTGGGAAACGGAACTGAATGAGGCGCTTCCCGGCGACGCCCGCGACACCACTACCCCGGCCAGCATGGCCGCGACCCTGCGCAAGCTGCTGACCAGCCAGCGTCTGAGCGCCCGTTCGCAACGGCAGCTGCTGCAGTGGATGGTGGACGATCGGGTCGCCGGACCGTTGATCCGCTCCGTGCTGCCGGCGGGCTGGTTTATCGCCGATAAGACCGGAGCTAGCAAGCGGGGTGCGCGCGGGATTGTCGCCCTGCTTGGCCCGAATAACAAAGCAGAGCGCATTGTGGTGATTTATCTGCGGGATACGCCGGCGAGCATGGCCGAGCG
gb|AY307100|+|0-861|ARO:3000984|TEM-122 [Escherichia coli] 	0	806	46	852	861	3478183-	806	ATGAGTATTCAACATTTCCGTGTCGCCCTTATTCCCTTTTTTGCGGCATTTTGCCTTCCTGTTTTTGCTCACCCAGAAACGCTGGTGAAAGTAAAAGATGCTGAAGATCAGTTGGGTGCACGAGTGGGTTACATCGAGCTGGATCTCAACAGCGGTAAGATCCTTGAGAGTTTTCGCCCCGAAGAACGTTTTCCAATGATGAGCACTTTTAAAGTTCTGCTATGTGGTGCGGTATTATCCCGTGTTGACGCCGGGCAAGAGCAACTCGGTCGCCGCATACACTATTCTCAGAATGACTTGGTTGAGTACTCACCAGTCACAGAAAAGCATCTTACGGATGGCATGACAGTAAGAGAATTATGCAGTGCTGCCATAACCATGAGTGATAACACTGCGGCCAACTTACTTCTGACAACGATCGGAGGACCGAAGGAGCTAACCGCTTTTTTGCACAACATGGGGGATCATGTAACCCGCCTTGATCGTTGGGAACCGGAGCTGAATGAAGCCATACCAAACGACGAGCGTGACACCACGATGCCTGCAGCAATGGCAACAACGTTGCGCAAACTATTAACTGGCGAACTACTTACTCTAGCTTCCCGGCAACAATTAATAGACTGGATGGAGGCGGATAAAGTTGCAGGACCACTTCTGCGCTCGGCCCTTCCGGCTGGCTGGTTTATTGCTGATAAATCTGGAGCCGGTGAGCGTGGATCTCGCGGTATCATTGCAGCACTGGGGCCAGATGGTAAGCCCTCCCGTATCGTAGTTATCTACACGACGGGGAGTCAGGCAACTATGGA
gb|JN638887|+|0-822|ARO:3001493|OXA-225 [Acinetobacter baumannii] 	0	767	80	847	822	254088-	767	ATGAATAAATATTTTACTTGCTATGTGGTTGCTTCTCTTTTTCTTTCTGGTTGTACGGTTCAGCATAATTTAATAAATGAAACCCCGAGTCAGATTGTTCAAGGACATAATCAGGTGATTCATCAATACTTTGATGAAAAAAACACCTCAGGTGTGCTGGTTATTCAAACAGATAAAAAAATTAATCTATATGGTAATGCTCTAAGCCGCGCAAATACAGAATATGTGCCAGCCTCTACATTTAAAATGTTGAATGCCCTGATCGGATTGGAGAACCAGAAAACGGATATTAATGAAATATTTAAATGGAAGGGCGAGAAAAGGTCATTTACCGCTTGGGAAAAAGACATGACACTAGGAGAAGCCATGAAGCTTTCTGCAGTCCCAGTCTATCAGGAACTTGCGCGACGTATCGGTCTTGATCTCATGCAAAAAGAAGTAAAACGTATTGGTTTCGGTAATGCTGAAATTGGACAGCAGGTTGATAATTTCTGGTTGGTAGGACCATTAAAGGTTACGCCTATTCAAGAGGTAGAGTTTGTTTCCCAATTAGCACATACACAGCTTCCATTTAGTGAAAAAGTGCAGGCTAATGTAAAAAATATGCTTCTTTTAGAAGAGAGTAATGGCTACAAAATTTTTGGAAAGACTGGTTGGGCAATGGATATAAAACCACAAGTGGGCTGGTTGACCGGCTGGGTTGAGCAGCCAGATGGAAAAATTGTCGCTTTTGCATTAAATATGGAAATGCGGTCAGAAATGCCGGC
gb|KM114268|+|0-861|ARO:3003157|TEM-219 [Escherichia coli] 	0	806	46	852	861	3478183-	806	ATGAGTATTCAACATTTCCGTGTCGCCCTTATTCCCTTTTTTGCGGCATTTTGCCTTCCTGTTTTTGCTCACCCAGAAACGCTGGTGAAAGTAAAAGATGCTGAAGATCAGTTGGGTGCACGAGTGGGTTACATCGAGCTGGATCTCAACAGCGGTAAGATCCTTGAGAGTTTTCGCCCCGAAGAACGTTTTCCAATGATGAGCACTTTTAAAGTTCTGCTATGTGGTGCGGTATTATCCCGTGTTGACGCCGGGCAAGAGCAACTCGGTCGCCGCATACACTATTCTCAGAATGACTTGGTTGAGTACTCACCAGTCACAGAAAAGCATCTTACGGATGGCATGACAGTAAGAGAATTATGCAGTGCTGCCATAACCATGAGTGATAACACTGCGGCCAACTTACTTCTGACAACGATCGGAGGACCGAAGGAGCTAACCGCTTTTTTGCACAACATGGGGGATCATGTAACCCGCCTTGATCGTTGGGAACCGGAGCTGAATGAAGCCATACCAAACGACGAGCGTGACACCACGATGCCTGCAGCAATGGCAACAACGTTGCGCAAACTATTAACTGGCGAACTACTTACTCTAGCTTCCCGGCAACAATTAATAGACTGGATGGAGGCGGATAAAGTTGCAGGACCACTTCTGCGCTCGGCCCTTCCGGCTGGCTGGTTTATTGCTGATAAATCTGGAGCCGGTGAGCGTGGATCTCGCGGTATCATTGCAGCACTGGGGCCAGATGGTAAGCCCTCCCGTATCGTAGTTATCTACACGACGGGGAGTCAGGCAACTATGGA
gb|EF468463|+|66-927|ARO:3001028|TEM-162 [Acinetobacter haemolyticus] 	0	806	46	852	861	3478183-	806	ATGAGTATTCAACATTTCCGTGTCGCCCTTATTCCCTTTTTTGCGGCATTTTGCCTTCCTGTTTTTGCTCACCCAGAAACGCTGGTGAAAGTAAAAGATGCTGAAGATCAGTTGGGTGCACGAGTGGGTTACATCGAGCTGGATCTCAACAGCGGTAAGATCCTTGAGAGTTTTCGCCCCGAAGAACGTTTTCCAATGATGAGCACTTTTAAAGTTCTGCTATGTGGTGCGGTATTATCCCGTGTTGACGCCGGGCAAGAGCAACTCGGTCGCCGCATACACTATTCTCAGAATGACTTGGTTGAGTACTCACCAGTCACAGAAAAGCATCTTACGGATGGCATGACAGTAAGAGAATTATGCAGTGCTGCCATAACCATGAGTGATAACACTGCGGCCAACTTACTTCTGACAACGATCGGAGGACCGAAGGAGCTAACCGCTTTTTTGCACAACATGGGGGATCATGTAACCCGCCTTGATCGTTGGGAACCGGAGCTGAATGAAGCCATACCAAACGACGAGCGTGACACCACGATGCCTGCAGCAATGGCAACAACGTTGCGCAAACTATTAACTGGCGAACTACTTACTCTAGCTTCCCGGCAACAATTAATAGACTGGATGGAGGCGGATAAAGTTGCAGGACCACTTCTGCGCTCGGCCCTTCCGGCTGGCTGGTTTATTGCTGATAAATCTGGAGCCGGTGAGCGTGGATCTCGCGGTATCATTGCAGCACTGGGGCCAGATGGTAAGCCCTCCCGTATCGTAGTTATCTACACGACGGGGAGTCAGGCAACTATGGA
gb|AY795964|+|0-822|ARO:3001418|OXA-23 [Acinetobacter baumannii] 	0	767	80	847	822	254088-	767	ATGAATAAATATTTTACTTGCTATGTGGTTGCTTCTCTTTTTCTTTCTGGTTGTACGGTTCAGCATAATTTAATAAATGAAACCCCGAGTCAGATTGTTCAAGGACATAATCAGGTGATTCATCAATACTTTGATGAAAAAAACACCTCAGGTGTGCTGGTTATTCAAACAGATAAAAAAATTAATCTATATGGTAATGCTCTAAGCCGCGCAAATACAGAATATGTGCCAGCCTCTACATTTAAAATGTTGAATGCCCTGATCGGATTGGAGAACCAGAAAACGGATATTAATGAAATATTTAAATGGAAGGGCGAGAAAAGGTCATTTACCGCTTGGGAAAAAGACATGACACTAGGAGAAGCCATGAAGCTTTCTGCAGTCCCAGTCTATCAGGAACTTGCGCGACGTATCGGTCTTGATCTCATGCAAAAAGAAGTAAAACGTATTGGTTTCGGTAATGCTGAAATTGGACAGCAGGTTGATAATTTCTGGTTGGTAGGACCATTAAAGGTTACGCCTATTCAAGAGGTAGAGTTTGTTTCCCAATTAGCACATACACAGCTTCCATTTAGTGAAAAAGTGCAGGCTAATGTAAAAAATATGCTTCTTTTAGAAGAGAGTAATGGCTACAAAATTTTTGGAAAGACTGGTTGGGCAATGGATATAAAACCACAAGTGGGCTGGTTGACCGGCTGGGTTGAGCAGCCAGATGGAAAAATTGTCGCTTTTGCATTAAATATGGAAATGCGGTCAGAAATGCCGGC
gb|KJ135345|+|14-839|ARO:3001568|OXA-382 [Acinetobacter baumannii] 	0	770	54149	54919	825	246080-	770	ATGAACATTAAAGCACTCTTACTTATAACAAGCGCTATTTTTATTTCAGCCTGCTCACCTTATATAGTGACTGCTAATCCAAATCACAGCGCTTCAAAATCTGATGTAAAAGCAGAGAAAATTAAAAATTTATTTAACGAAGCACACACTACGGGTGTTTTAGTTATCCAACAAGGCCAAACTCAACAAAGCTATGGTAATGATCTTGCTCGTGCTTCGACCGAGTATGTACCTGCTTCGACCTTCAAAATGCTTAATGCTTTGATCGGCCTTGAGCACCATAAGGCAACCACCACAGAAGTATTTAAGTGGGATGGTAAAAAAAGGTTATTCCCAGAATGGGAAAAGGACATGACCCTAGGCGATGCCATGAAAGCTTCCGCTATTCCAGTTTATCAAGATTTAGCTCGTCGTATTGGACTTGAGCTCATGTCTAAGGAAGTGAAGCGTGTTGGTTATGGCAATGCAGATATCGGTACCCAAGTCGATAATTTTTGGCTGGTGGGTCCTTTAAAAATTACTCCTCAGCAAGAGGCACAGTTTGCTTACAAGCTAGCTAATAAAACGCTTCCATTTAGCCAAAAAGTCCAAGATGAAGTGCAATCCATGCTATTCATAGAAGAAAAGAATGGAAACAAAATATACGCAAAAAGTGGTTGGGGATGGGATGTAAACCCACAAGTAGGCTGGTTAACTGGATGGGTTGTTCAGCCTCAAGGGAATATTGTAGCGTTCTCCCTTAACTTAGAAATGAAAAAAGGAATACCTAG
gb|Y17583|+|213-1071|ARO:3000893|TEM-22 [Klebsiella pneumoniae] 	0	803	46	849	858	3478183-	803	ATGAGTATTCAACATTTCCGTGTCGCCCTTATTCCCTTTTTTGCGGCATTTTGCCTTCCTGTTTTTGCTCACCCAGAAACGCTGGTGAAAGTAAAAGATGCTGAAGATCAGTTGGGTGCACGAGTGGGTTACATCGAGCTGGATCTCAACAGCGGTAAGATCCTTGAGAGTTTTCGCCCCGAAGAACGTTTTCCAATGATGAGCACTTTTAAAGTTCTGCTATGTGGTGCGGTATTATCCCGTGTTGACGCCGGGCAAGAGCAACTCGGTCGCCGCATACACTATTCTCAGAATGACTTGGTTGAGTACTCACCAGTCACAGAAAAGCATCTTACGGATGGCATGACAGTAAGAGAATTATGCAGTGCTGCCATAACCATGAGTGATAACACTGCGGCCAACTTACTTCTGACAACGATCGGAGGACCGAAGGAGCTAACCGCTTTTTTGCACAACATGGGGGATCATGTAACCCGCCTTGATCGTTGGGAACCGGAGCTGAATGAAGCCATACCAAACGACGAGCGTGACACCACGATGCCTGCAGCAATGGCAACAACGTTGCGCAAACTATTAACTGGCGAACTACTTACTCTAGCTTCCCGGCAACAATTAATAGACTGGATGGAGGCGGATAAAGTTGCAGGACCACTTCTGCGCTCGGCCCTTCCGGCTGGCTGGTTTATTGCTGATAAATCTGGAGCCGGTGAGCGTGGATCTCGCGGTATCATTGCAGCACTGGGGCCAGATGGTAAGCCCTCCCGTATCGTAGTTATCTACACGACGGGGAGTCAGGCAACTAT
gb|KR057754.1|+|0-1116|ARO:3004348|PDC-85 [Pseudomonas aeruginosa] 	3	1061	35594	36652	1116	232416+	1058	GAGGCCCCGGCGGATCGCCTGAAGGCACTGGTCGACGCCGCCGTACAACCGGTGATGAAGGCCAATGACATTCCGGGCCTGGCCGTAGCCATCAGCCTGAAAGGAGAACCGCATTACTTCAGCTATGGGCTGGCCTCGAAAGAGGACGGCCGCCGGGTGACGCCGGAGACCCTGTTCGAGATCGGCTCGGTGAGCAAGACCTTCACCGTCACCCTCGCCGGCTATGCCCTGGCCCAGGACAAGATGCGCCTCGACGACCGCGCCAGCCAGCACTGGCCGGCACTGCAGGGCAGCCGCTTCGACGGCATCAGCCTGCTCGACCTCGCGACCTATACCGCCGGCGGCTTGCCGCTGCAGTTCCCCGACTCGGTGCAGAAGGACCAGGCACAGATCCGCGACTACTACCGCCAGTGGCAGCCGACCTACGCGCCGGGCAGCCAGCGCCTCTATTCCAACCCGAGCATCGGCCTGTTCGGCTATCTCGCCGCGCGCAGCCTGGGCCAGCCGTTCGAACGGCTCATGGAGCAGCAATTGTTCCCGGCACTGGGCCTCGAACAGACCCACCTCGACGTGCCCGAGGCGGCGCTGGCGCAGTACGCCCAGGGCTACGGCAAGGACGACCGCCCGCTACGGGTCGGTCCCGGCCCGCTGGATGCCGAAGGCTACGGGGTGAAGACCAGCGCGGCCGACCTGCTGCGCTTCGTCGATGCCAACCTGCATCCGGAGCGCCTGGACAGGCCCTGGGCGCAGGCGCTCGATGCCACCCATCGCGGTTACTACAAGGTCGGCGACATGACCCAGGGCCTGGGCTGGGAAGCCTACGACTGGCCGATCTCCCTGAAGCGCCTGCAGGCCGGCAACTCGACGCCGATGGCGCTGCAACCACACAGGATCGCCAGGCTGCCCGCGCCACAGGCGCTGGAGGGCCAGCGCCTGCTGAACAAGACCGGCTCCACCAACGGCTTCGGCGCCTACGTGGCGTTCGTCCCGGGCCGCGACCTGGGCCTGGTGATCCTGGCCAACCGCAACTATCCCAATGCCGAGCGGGTGAAGATCGC
gb|KJ657570|+|0-801|ARO:3001495|OXA-233 [Citrobacter freundii] 	0	746	659	1405	801	104604+	746	ATGAAAACATTTGCCGCATATGTAATTATCGCGTGTCTTTCGAGTACGGCATTAGCTGGTTCAATTACAGAAAATACGTCTTGGAACAAAGAGTTCTCTGCCGAAGCCGTCAATGGTGTCTTCGTGCTTTGTAAAAGTAGCAGTAAATCCTGCGCTACCAATGACTTAGCTCGTGCATCAAAGGAATATCTTCCAGCATCAACATTTAAGATCCCCAACGCAATTATCGGCCTAGAAACTGGTGTCATAAAGAATGAGCATCAGGTTTTCAAATGGGACGGAAAGCCAAGAGCCATGAAGCAATGGGAAAGAGACTTGACCTTAAGAGGGGCAATACAAGTTTCAGCTGTTCCCGTATTTCAACAAATCGCCAGAGAAGTTGGCGAAGTAAGAATGCAGAAATACCTTAAAAAATTTTCCTATGGCAACCAGAATATCAGTGGTGGCATTGACAAATTCTGGTTGGAAGGCCAGCTTAGAATTTCCGCAGTTAATCAAGTGGAGTTTCTAGAGTCTCTATATTTAAATAAATTGTCAGCATCTAAAGAAAACCAGCTAATAGTAAAAGAGGCTTTGGTAACGGAGGCGGCACCTGAATATCTAGTGCATTCAAAAACTGGTTTTTCTGGTGTGGGAACTGAGTCAAATCCTGGTGTCGCATGGTGGGTTGGGTGGGTTGAGAAGGAGACAGAGGTTTACTTTTTCGCCTTTAACATGGATATAGACAACGAAAGTAAGTTGCCGCT
gb|AY327539|+|0-858|ARO:3000985|TEM-123 [Proteus mirabilis] 	0	803	46	852	858	3478183-	806	ATGAGTATTCAACATTTCCGTGTCGCCCTTATTCCCTTTTTTGCGGCATTTTGCCTTCCTGTTTTTGCTCACCCAGAAACGCTGGTGAAAGTAAAAGATGCTGAAGATCAGTTGGGTGCACGAGTGGGTTACATCGAGCTGGATCTCAACAGCGGTAAGATCCTTGAGAGTTTTCGCCCCGAAGAACGTTTTCCAATGATGAGCACTTTTAAAGTTCTGCTATGTGGTGCGGTATTATCCCGTGTTGACGCCGGGCAAGAGCAACTCGGTCGCCGCATACACTATTCTCAGAATGACTTGGTTGAGTACTCACCAGTCACAGAAAAGCATCTTACGGATGGCATGACAGTAAGAGAATTATGCAGTGCTGCCATAACCATGAGTGATAACACTGCGGCCAACTTACTTCTGACAACGATCGGAGGACCGAAGGAGCTAACCGCTTTTTTGCACAACATGGGGGATCATGTAACCCGCCTTGATCGTTGGGAACCGGAGCTGAATGAAGCCATACCAAACGACGAGCGTGACACCACGATGCCTGCAGCAATGGCAACAACGTTGCGCAAACTATTAACTGGCGAACTACTTACTCTAGCTTCCCGGCAACAATTAATAGACTGGATGGAGGCGGATAAAGTTGCAGGACCACTTCTGCGCTCGGCCCTTCCGGCTGGCTGGTTTATTGCTGATAAATCTGGAGCCGGTGAGCGTGGATCTCGCGGTATCATTGCAGCACTGGGGCCAGATGGTAAGCCCTCCCGTATCGTAGTTATCTACACGACGGGGAGTCAGGCAACTATGGA
gb|KM998962.1|+|0-861|ARO:3003158|TEM-220 [Neisseria gonorrhoeae] 	0	806	46	852	861	3478183-	806	ATGAGTATTCAACATTTCCGTGTCGCCCTTATTCCCTTTTTTGCGGCATTTTGCCTTCCTGTTTTTGCTCACCCAGAAACGCTGGTGAAAGTAAAAGATGCTGAAGATCAGTTGGGTGCACGAGTGGGTTACATCGAGCTGGATCTCAACAGCGGTAAGATCCTTGAGAGTTTTCGCCCCGAAGAACGTTTTCCAATGATGAGCACTTTTAAAGTTCTGCTATGTGGTGCGGTATTATCCCGTGTTGACGCCGGGCAAGAGCAACTCGGTCGCCGCATACACTATTCTCAGAATGACTTGGTTGAGTACTCACCAGTCACAGAAAAGCATCTTACGGATGGCATGACAGTAAGAGAATTATGCAGTGCTGCCATAACCATGAGTGATAACACTGCGGCCAACTTACTTCTGACAACGATCGGAGGACCGAAGGAGCTAACCGCTTTTTTGCACAACATGGGGGATCATGTAACCCGCCTTGATCGTTGGGAACCGGAGCTGAATGAAGCCATACCAAACGACGAGCGTGACACCACGATGCCTGCAGCAATGGCAACAACGTTGCGCAAACTATTAACTGGCGAACTACTTACTCTAGCTTCCCGGCAACAATTAATAGACTGGATGGAGGCGGATAAAGTTGCAGGACCACTTCTGCGCTCGGCCCTTCCGGCTGGCTGGTTTATTGCTGATAAATCTGGAGCCGGTGAGCGTGGATCTCGCGGTATCATTGCAGCACTGGGGCCAGATGGTAAGCCCTCCCGTATCGTAGTTATCTACACGACGGGGAGTCAGGCAACTATGGA
gb|FJ666065|+|0-1194|ARO:3002497|PDC-1 [Pseudomonas aeruginosa PAO1] 	0	1139	35513	36652	1194	232416+	1139	ATGCGCGATACCAGATTCCCCTGCCTGTGCGGCATCGCCGCTTCCACACTGCTGTTCGCCACCACCCCGGCCATTGCCGATGAGGCCCCGGCGGATCGCCTGAAGGCACTGGTCGACGCCGCCGTACAACCGGTGATGAAGGCCAATGACATTCCGGGCCTGGCCGTAGCCATCAGCCTGAAAGGAGAACCGCATTACTTCAGCTATGGGCTGGCCTCGAAAGAGGACGGCCGCCGGGTGACGCCGGAGACCCTGTTCGAGATCGGCTCGGTGAGCAAGACCTTCACCGTCACCCTCGCCGGCTATGCCCTGGCCCAGGACAAGATGCGCCTCGACGACCGCGCCAGCCAGCACTGGCCGGCACTGCAGGGCAGCCGCTTCGACGGCATCAGCCTGCTCGACCTCGCGACCTATACCGCCGGCGGCTTGCCGCTGCAGTTCCCCGACTCGGTGCAGAAGGACCAGGCACAGATCCGCGACTACTACCGCCAGTGGCAGCCGACCTACGCGCCGGGCAGCCAGCGCCTCTATTCCAACCCGAGCATCGGCCTGTTCGGCTATCTCGCCGCGCGCAGCCTGGGCCAGCCGTTCGAACGGCTCATGGAGCAGCAATTGTTCCCGGCACTGGGCCTCGAACAGACCCACCTCGACGTGCCCGAGGCGGCGCTGGCGCAGTACGCCCAGGGCTACGGCAAGGACGACCGCCCGCTACGGGTCGGTCCCGGCCCGCTGGATGCCGAAGGCTACGGGGTGAAGACCAGCGCGGCCGACCTGCTGCGCTTCGTCGATGCCAACCTGCATCCGGAGCGCCTGGACAGGCCCTGGGCGCAGGCGCTCGATGCCACCCATCGCGGTTACTACAAGGTCGGCGACATGACCCAGGGCCTGGGCTGGGAAGCCTACGACTGGCCGATCTCCCTGAAGCGCCTGCAGGCCGGCAACTCGACGCCGATGGCGCTGCAACCACACAGGATCGCCAGGCTGCCCGCGCCACAGGCGCTGGAGGGCCAGCGCCTGCTGAACAAGACCGGCTCCACCAACGGCTTCGGCGCCTACGTGGCGTTCGTCCCGGGCCGCGACCTGGGCCTGGTGATCCTGGCCAACCGCAACTATCCCAATGCCGAGCGGGTGAAGATCGC
gb|KF986262.1|-|27-852|ARO:3001569|OXA-383 [Acinetobacter baumannii] 	0	770	54149	54919	825	246080-	770	ATGAACATTAAAGCACTCTTACTTATAACAAGCGCTATTTTTATTTCAGCCTGCTCACCTTATATAGTGACTGCTAATCCAAATCACAGCGCTTCAAAATCTGATGTAAAAGCAGAGAAAATTAAAAATTTATTTAACGAAGCACACACTACGGGTGTTTTAGTTATCCAACAAGGCCAAACTCAACAAAGCTATGGTAATGATCTTGCTCGTGCTTCGACCGAGTATGTACCTGCTTCGACCTTCAAAATGCTTAATGCTTTGATCGGCCTTGAGCACCATAAGGCAACCACCACAGAAGTATTTAAGTGGGATGGTAAAAAAAGGTTATTCCCAGAATGGGAAAAGGACATGACCCTAGGCGATGCCATGAAAGCTTCCGCTATTCCAGTTTATCAAGATTTAGCTCGTCGTATTGGACTTGAGCTCATGTCTAAGGAAGTGAAGCGTGTTGGTTATGGCAATGCAGATATCGGTACCCAAGTCGATAATTTTTGGCTGGTGGGTCCTTTAAAAATTACTCCTCAGCAAGAGGCACAGTTTGCTTACAAGCTAGCTAATAAAACGCTTCCATTTAGCCAAAAAGTCCAAGATGAAGTGCAATCCATGCTATTCATAGAAGAAAAGAATGGAAACAAAATATACGCAAAAAGTGGTTGGGGATGGGATGTAAACCCACAAGTAGGCTGGTTAACTGGATGGGTTGTTCAGCCTCAAGGGAATATTGTAGCGTTCTCCCTTAACTTAGAAATGAAAAAAGGAATACCTAG
gb|NG_050607.1|+|100-925|ARO:3001496|OXA-234 [Acinetobacter baumannii] 	0	770	54149	54919	825	246080-	770	ATGAACATTAAAGCACTCTTACTTATAACAAGCGCTATTTTTATTTCAGCCTGCTCACCTTATATAGTGACTGCTAATCCAAATCACAGCGCTTCAAAATCTGATGTAAAAGCAGAGAAAATTAAAAATTTATTTAACGAAGCACACACTACGGGTGTTTTAGTTATCCAACAAGGCCAAACTCAACAAAGCTATGGTAATGATCTTGCTCGTGCTTCGACCGAGTATGTACCTGCTTCGACCTTCAAAATGCTTAATGCTTTGATCGGCCTTGAGCACCATAAGGCAACCACCACAGAAGTATTTAAGTGGGATGGTAAAAAAAGGTTATTCCCAGAATGGGAAAAGGACATGACCCTAGGCGATGCCATGAAAGCTTCCGCTATTCCAGTTTATCAAGATTTAGCTCGTCGTATTGGACTTGAGCTCATGTCTAAGGAAGTGAAGCGTGTTGGTTATGGCAATGCAGATATCGGTACCCAAGTCGATAATTTTTGGCTGGTGGGTCCTTTAAAAATTACTCCTCAGCAAGAGGCACAGTTTGCTTACAAGCTAGCTAATAAAACGCTTCCATTTAGCCAAAAAGTCCAAGATGAAGTGCAATCCATGCTATTCATAGAAGAAAAGAATGGAAACAAAATATACGCAAAAAGTGGTTGGGGATGGGATGTAAACCCACAAGTAGGCTGGTTAACTGGATGGGTTGTTCAGCCTCAAGGGAATATTGTAGCGTTCTCCCTTAACTTAGAAATGAAAAAAGGAATACCTAG
gb|AY648950.1|+|0-1152|ARO:3003853|ADC-7 [Acinetobacter baumannii] 	0	1097	63	1160	1152	126080+	1097	ATGCGATTTAAAAAAATTTCTTGTCTACTTTTATCCCCGCTTTTTATTTTTAGTACCTCAATTTATGCGGGCAATACACCAAAAGACCAAGAAATTAAAAAACTGGTAGATCAAAACTTTAAACCGTTATTAGAAAAATATGATGTGCCAGGTATGGCTGTGGGTGTTATTCAAAATAATAAAAAGTATGAAATGTATTATGGTCTTCAATCTGTTCAAGATAAAAAAGCCGTAAATAGCAGTACTATTTTTGAGCTAGGTTCTGTCAGTAAATTATTTACCGCGACAGCAGGTGGATATGCAAAAAATAAAGGAAAAATCTCTTTTGACGATACGCCTGGTAAGTATTGGAAAGAACTAAAAAATACACCGATTGACCAAGTTAACTTACTTCAACTCGCGACGTATACAAGTGGTAACCTTGCCTTGCAATTTCCAGATGAAGTAAAAACAGATCAGCAAGTTTTAACATTTTTTAAAGACTGGAAACCTAAAAACTCAATCGGTGAATATCGACAATATTCAAACCCAAGCATTGGTTTATTTGGAAAAGTTGTAGCTTTGTCTATGAATAAACCTTTCGACCAAGTCTTAGAAAAAACAATTTTTCCGGCCCTTGGCTTAAAACATAGCTATGTAAATGTACCTAAGACCCAGATGCAAAACTATGCTTTTGGCTATAACCAAGAAAATCAGCCGATTCGAGTTAACCCCGGCCCACTCGATGCCCCAGCATATGGCGTCAAATCGACACTACCCGACATGTTGAGTTTTATTCATGCCAACCTAAATCCACAAAAATATCCAGCAGATATTCAACGGGCAATTAATGAAACACATCAGGGTCGCTATCAAGTAAATACCATGTATCAGGCACTCGGTTGGGAAGAGTTTTCTTATCCGGCAACGTTACAAACTTTATTAGACAGTAATTCAGAACAGATTGTGATGAAACCTAATAAAGTGACTGCTATTTCAAAGGAACCTTCAGTTAAGATGTACCATAAAACTGGCTCAACTACCGGTTTCGGAACATATGTGGTGTTTATTCCTAAAGAAAATATTGGTTTAGTCATGTTAACCAATAAACGTATTCC
gb|X65253|+|175-1036|ARO:3000894|TEM-24 [Klebsiella pneumoniae] 	0	806	46	852	861	3478183-	806	ATGAGTATTCAACATTTCCGTGTCGCCCTTATTCCCTTTTTTGCGGCATTTTGCCTTCCTGTTTTTGCTCACCCAGAAACGCTGGTGAAAGTAAAAGATGCTGAAGATCAGTTGGGTGCACGAGTGGGTTACATCGAGCTGGATCTCAACAGCGGTAAGATCCTTGAGAGTTTTCGCCCCGAAGAACGTTTTCCAATGATGAGCACTTTTAAAGTTCTGCTATGTGGTGCGGTATTATCCCGTGTTGACGCCGGGCAAGAGCAACTCGGTCGCCGCATACACTATTCTCAGAATGACTTGGTTGAGTACTCACCAGTCACAGAAAAGCATCTTACGGATGGCATGACAGTAAGAGAATTATGCAGTGCTGCCATAACCATGAGTGATAACACTGCGGCCAACTTACTTCTGACAACGATCGGAGGACCGAAGGAGCTAACCGCTTTTTTGCACAACATGGGGGATCATGTAACCCGCCTTGATCGTTGGGAACCGGAGCTGAATGAAGCCATACCAAACGACGAGCGTGACACCACGATGCCTGCAGCAATGGCAACAACGTTGCGCAAACTATTAACTGGCGAACTACTTACTCTAGCTTCCCGGCAACAATTAATAGACTGGATGGAGGCGGATAAAGTTGCAGGACCACTTCTGCGCTCGGCCCTTCCGGCTGGCTGGTTTATTGCTGATAAATCTGGAGCCGGTGAGCGTGGATCTCGCGGTATCATTGCAGCACTGGGGCCAGATGGTAAGCCCTCCCGTATCGTAGTTATCTACACGACGGGGAGTCAGGCAACTATGGA
gb|NG_050256.1|+|100-961|ARO:3000896|TEM-26 [Enterobacteriaceae] 	0	806	46	852	861	3478183-	806	ATGAGTATTCAACATTTCCGTGTCGCCCTTATTCCCTTTTTTGCGGCATTTTGCCTTCCTGTTTTTGCTCACCCAGAAACGCTGGTGAAAGTAAAAGATGCTGAAGATCAGTTGGGTGCACGAGTGGGTTACATCGAGCTGGATCTCAACAGCGGTAAGATCCTTGAGAGTTTTCGCCCCGAAGAACGTTTTCCAATGATGAGCACTTTTAAAGTTCTGCTATGTGGTGCGGTATTATCCCGTGTTGACGCCGGGCAAGAGCAACTCGGTCGCCGCATACACTATTCTCAGAATGACTTGGTTGAGTACTCACCAGTCACAGAAAAGCATCTTACGGATGGCATGACAGTAAGAGAATTATGCAGTGCTGCCATAACCATGAGTGATAACACTGCGGCCAACTTACTTCTGACAACGATCGGAGGACCGAAGGAGCTAACCGCTTTTTTGCACAACATGGGGGATCATGTAACCCGCCTTGATCGTTGGGAACCGGAGCTGAATGAAGCCATACCAAACGACGAGCGTGACACCACGATGCCTGCAGCAATGGCAACAACGTTGCGCAAACTATTAACTGGCGAACTACTTACTCTAGCTTCCCGGCAACAATTAATAGACTGGATGGAGGCGGATAAAGTTGCAGGACCACTTCTGCGCTCGGCCCTTCCGGCTGGCTGGTTTATTGCTGATAAATCTGGAGCCGGTGAGCGTGGATCTCGCGGTATCATTGCAGCACTGGGGCCAGATGGTAAGCCCTCCCGTATCGTAGTTATCTACACGACGGGGAGTCAGGCAACTATGGA
gb|JQ837239|+|0-822|ARO:3001498|OXA-239 [Acinetobacter sp. enrichment culture clone 8407] 	0	767	80	847	822	254088-	767	ATGAATAAATATTTTACTTGCTATGTGGTTGCTTCTCTTTTTCTTTCTGGTTGTACGGTTCAGCATAATTTAATAAATGAAACCCCGAGTCAGATTGTTCAAGGACATAATCAGGTGATTCATCAATACTTTGATGAAAAAAACACCTCAGGTGTGCTGGTTATTCAAACAGATAAAAAAATTAATCTATATGGTAATGCTCTAAGCCGCGCAAATACAGAATATGTGCCAGCCTCTACATTTAAAATGTTGAATGCCCTGATCGGATTGGAGAACCAGAAAACGGATATTAATGAAATATTTAAATGGAAGGGCGAGAAAAGGTCATTTACCGCTTGGGAAAAAGACATGACACTAGGAGAAGCCATGAAGCTTTCTGCAGTCCCAGTCTATCAGGAACTTGCGCGACGTATCGGTCTTGATCTCATGCAAAAAGAAGTAAAACGTATTGGTTTCGGTAATGCTGAAATTGGACAGCAGGTTGATAATTTCTGGTTGGTAGGACCATTAAAGGTTACGCCTATTCAAGAGGTAGAGTTTGTTTCCCAATTAGCACATACACAGCTTCCATTTAGTGAAAAAGTGCAGGCTAATGTAAAAAATATGCTTCTTTTAGAAGAGAGTAATGGCTACAAAATTTTTGGAAAGACTGGTTGGGCAATGGATATAAAACCACAAGTGGGCTGGTTGACCGGCTGGGTTGAGCAGCCAGATGGAAAAATTGTCGCTTTTGCATTAAATATGGAAATGCGGTCAGAAATGCCGGC
gb|LLSH01000109.1|+|88827-90021|ARO:3004349|PDC-86 [Pseudomonas aeruginosa] 	0	1139	35513	36652	1194	232416+	1139	ATGCGCGATACCAGATTCCCCTGCCTGTGCGGCATCGCCGCTTCCACACTGCTGTTCGCCACCACCCCGGCCATTGCCGATGAGGCCCCGGCGGATCGCCTGAAGGCACTGGTCGACGCCGCCGTACAACCGGTGATGAAGGCCAATGACATTCCGGGCCTGGCCGTAGCCATCAGCCTGAAAGGAGAACCGCATTACTTCAGCTATGGGCTGGCCTCGAAAGAGGACGGCCGCCGGGTGACGCCGGAGACCCTGTTCGAGATCGGCTCGGTGAGCAAGACCTTCACCGTCACCCTCGCCGGCTATGCCCTGGCCCAGGACAAGATGCGCCTCGACGACCGCGCCAGCCAGCACTGGCCGGCACTGCAGGGCAGCCGCTTCGACGGCATCAGCCTGCTCGACCTCGCGACCTATACCGCCGGCGGCTTGCCGCTGCAGTTCCCCGACTCGGTGCAGAAGGACCAGGCACAGATCCGCGACTACTACCGCCAGTGGCAGCCGACCTACGCGCCGGGCAGCCAGCGCCTCTATTCCAACCCGAGCATCGGCCTGTTCGGCTATCTCGCCGCGCGCAGCCTGGGCCAGCCGTTCGAACGGCTCATGGAGCAGCAATTGTTCCCGGCACTGGGCCTCGAACAGACCCACCTCGACGTGCCCGAGGCGGCGCTGGCGCAGTACGCCCAGGGCTACGGCAAGGACGACCGCCCGCTACGGGTCGGTCCCGGCCCGCTGGATGCCGAAGGCTACGGGGTGAAGACCAGCGCGGCCGACCTGCTGCGCTTCGTCGATGCCAACCTGCATCCGGAGCGCCTGGACAGGCCCTGGGCGCAGGCGCTCGATGCCACCCATCGCGGTTACTACAAGGTCGGCGACATGACCCAGGGCCTGGGCTGGGAAGCCTACGACTGGCCGATCTCCCTGAAGCGCCTGCAGGCCGGCAACTCGACGCCGATGGCGCTGCAACCACACAGGATCGCCAGGCTGCCCGCGCCACAGGCGCTGGAGGGCCAGCGCCTGCTGAACAAGACCGGCTCCACCAACGGCTTCGGCGCCTACGTGGCGTTCGTCCCGGGCCGCGACCTGGGCCTGGTGATCCTGGCCAACCGCAACTATCCCAATGCCGAGCGGGTGAAGATCGC
gb|AF351241|+|89-950|ARO:3000957|TEM-90 [Escherichia coli] 	0	806	46	852	861	3478183-	806	ATGAGTATTCAACATTTCCGTGTCGCCCTTATTCCCTTTTTTGCGGCATTTTGCCTTCCTGTTTTTGCTCACCCAGAAACGCTGGTGAAAGTAAAAGATGCTGAAGATCAGTTGGGTGCACGAGTGGGTTACATCGAGCTGGATCTCAACAGCGGTAAGATCCTTGAGAGTTTTCGCCCCGAAGAACGTTTTCCAATGATGAGCACTTTTAAAGTTCTGCTATGTGGTGCGGTATTATCCCGTGTTGACGCCGGGCAAGAGCAACTCGGTCGCCGCATACACTATTCTCAGAATGACTTGGTTGAGTACTCACCAGTCACAGAAAAGCATCTTACGGATGGCATGACAGTAAGAGAATTATGCAGTGCTGCCATAACCATGAGTGATAACACTGCGGCCAACTTACTTCTGACAACGATCGGAGGACCGAAGGAGCTAACCGCTTTTTTGCACAACATGGGGGATCATGTAACCCGCCTTGATCGTTGGGAACCGGAGCTGAATGAAGCCATACCAAACGACGAGCGTGACACCACGATGCCTGCAGCAATGGCAACAACGTTGCGCAAACTATTAACTGGCGAACTACTTACTCTAGCTTCCCGGCAACAATTAATAGACTGGATGGAGGCGGATAAAGTTGCAGGACCACTTCTGCGCTCGGCCCTTCCGGCTGGCTGGTTTATTGCTGATAAATCTGGAGCCGGTGAGCGTGGATCTCGCGGTATCATTGCAGCACTGGGGCCAGATGGTAAGCCCTCCCGTATCGTAGTTATCTACACGACGGGGAGTCAGGCAACTATGGA
gb|EU815939|+|0-861|ARO:3001029|TEM-163 [Escherichia coli] 	0	806	46	852	861	3478183-	806	ATGAGTATTCAACATTTCCGTGTCGCCCTTATTCCCTTTTTTGCGGCATTTTGCCTTCCTGTTTTTGCTCACCCAGAAACGCTGGTGAAAGTAAAAGATGCTGAAGATCAGTTGGGTGCACGAGTGGGTTACATCGAGCTGGATCTCAACAGCGGTAAGATCCTTGAGAGTTTTCGCCCCGAAGAACGTTTTCCAATGATGAGCACTTTTAAAGTTCTGCTATGTGGTGCGGTATTATCCCGTGTTGACGCCGGGCAAGAGCAACTCGGTCGCCGCATACACTATTCTCAGAATGACTTGGTTGAGTACTCACCAGTCACAGAAAAGCATCTTACGGATGGCATGACAGTAAGAGAATTATGCAGTGCTGCCATAACCATGAGTGATAACACTGCGGCCAACTTACTTCTGACAACGATCGGAGGACCGAAGGAGCTAACCGCTTTTTTGCACAACATGGGGGATCATGTAACCCGCCTTGATCGTTGGGAACCGGAGCTGAATGAAGCCATACCAAACGACGAGCGTGACACCACGATGCCTGCAGCAATGGCAACAACGTTGCGCAAACTATTAACTGGCGAACTACTTACTCTAGCTTCCCGGCAACAATTAATAGACTGGATGGAGGCGGATAAAGTTGCAGGACCACTTCTGCGCTCGGCCCTTCCGGCTGGCTGGTTTATTGCTGATAAATCTGGAGCCGGTGAGCGTGGATCTCGCGGTATCATTGCAGCACTGGGGCCAGATGGTAAGCCCTCCCGTATCGTAGTTATCTACACGACGGGGAGTCAGGCAACTATGGA
gb|KF986263.1|-|90-915|ARO:3001570|OXA-384 [Acinetobacter baumannii] 	0	770	54149	54919	825	246080-	770	ATGAACATTAAAGCACTCTTACTTATAACAAGCGCTATTTTTATTTCAGCCTGCTCACCTTATATAGTGACTGCTAATCCAAATCACAGCGCTTCAAAATCTGATGTAAAAGCAGAGAAAATTAAAAATTTATTTAACGAAGCACACACTACGGGTGTTTTAGTTATCCAACAAGGCCAAACTCAACAAAGCTATGGTAATGATCTTGCTCGTGCTTCGACCGAGTATGTACCTGCTTCGACCTTCAAAATGCTTAATGCTTTGATCGGCCTTGAGCACCATAAGGCAACCACCACAGAAGTATTTAAGTGGGATGGTAAAAAAAGGTTATTCCCAGAATGGGAAAAGGACATGACCCTAGGCGATGCCATGAAAGCTTCCGCTATTCCAGTTTATCAAGATTTAGCTCGTCGTATTGGACTTGAGCTCATGTCTAAGGAAGTGAAGCGTGTTGGTTATGGCAATGCAGATATCGGTACCCAAGTCGATAATTTTTGGCTGGTGGGTCCTTTAAAAATTACTCCTCAGCAAGAGGCACAGTTTGCTTACAAGCTAGCTAATAAAACGCTTCCATTTAGCCAAAAAGTCCAAGATGAAGTGCAATCCATGCTATTCATAGAAGAAAAGAATGGAAACAAAATATACGCAAAAAGTGGTTGGGGATGGGATGTAAACCCACAAGTAGGCTGGTTAACTGGATGGGTTGTTCAGCCTCAAGGGAATATTGTAGCGTTCTCCCTTAACTTAGAAATGAAAAAAGGAATACCTAG
gb|U37195|+|75-936|ARO:3000898|TEM-28 [Escherichia coli] 	0	806	46	852	861	3478183-	806	ATGAGTATTCAACATTTCCGTGTCGCCCTTATTCCCTTTTTTGCGGCATTTTGCCTTCCTGTTTTTGCTCACCCAGAAACGCTGGTGAAAGTAAAAGATGCTGAAGATCAGTTGGGTGCACGAGTGGGTTACATCGAGCTGGATCTCAACAGCGGTAAGATCCTTGAGAGTTTTCGCCCCGAAGAACGTTTTCCAATGATGAGCACTTTTAAAGTTCTGCTATGTGGTGCGGTATTATCCCGTGTTGACGCCGGGCAAGAGCAACTCGGTCGCCGCATACACTATTCTCAGAATGACTTGGTTGAGTACTCACCAGTCACAGAAAAGCATCTTACGGATGGCATGACAGTAAGAGAATTATGCAGTGCTGCCATAACCATGAGTGATAACACTGCGGCCAACTTACTTCTGACAACGATCGGAGGACCGAAGGAGCTAACCGCTTTTTTGCACAACATGGGGGATCATGTAACCCGCCTTGATCGTTGGGAACCGGAGCTGAATGAAGCCATACCAAACGACGAGCGTGACACCACGATGCCTGCAGCAATGGCAACAACGTTGCGCAAACTATTAACTGGCGAACTACTTACTCTAGCTTCCCGGCAACAATTAATAGACTGGATGGAGGCGGATAAAGTTGCAGGACCACTTCTGCGCTCGGCCCTTCCGGCTGGCTGGTTTATTGCTGATAAATCTGGAGCCGGTGAGCGTGGATCTCGCGGTATCATTGCAGCACTGGGGCCAGATGGTAAGCCCTCCCGTATCGTAGTTATCTACACGACGGGGAGTCAGGCAACTATGGA
gb|JX089628|+|0-801|ARO:3001499|OXA-240 [Pseudomonas aeruginosa] 	0	746	659	1405	801	104604+	746	ATGAAAACATTTGCCGCATATGTAATTATCGCGTGTCTTTCGAGTACGGCATTAGCTGGTTCAATTACAGAAAATACGTCTTGGAACAAAGAGTTCTCTGCCGAAGCCGTCAATGGTGTCTTCGTGCTTTGTAAAAGTAGCAGTAAATCCTGCGCTACCAATGACTTAGCTCGTGCATCAAAGGAATATCTTCCAGCATCAACATTTAAGATCCCCAACGCAATTATCGGCCTAGAAACTGGTGTCATAAAGAATGAGCATCAGGTTTTCAAATGGGACGGAAAGCCAAGAGCCATGAAGCAATGGGAAAGAGACTTGACCTTAAGAGGGGCAATACAAGTTTCAGCTGTTCCCGTATTTCAACAAATCGCCAGAGAAGTTGGCGAAGTAAGAATGCAGAAATACCTTAAAAAATTTTCCTATGGCAACCAGAATATCAGTGGTGGCATTGACAAATTCTGGTTGGAAGGCCAGCTTAGAATTTCCGCAGTTAATCAAGTGGAGTTTCTAGAGTCTCTATATTTAAATAAATTGTCAGCATCTAAAGAAAACCAGCTAATAGTAAAAGAGGCTTTGGTAACGGAGGCGGCACCTGAATATCTAGTGCATTCAAAAACTGGTTTTTCTGGTGTGGGAACTGAGTCAAATCCTGGTGTCGCATGGTGGGTTGGGTGGGTTGAGAAGGAGACAGAGGTTTACTTTTTCGCCTTTAACATGGATATAGACAACGAAAGTAAGTTGCCGCT
gb|Y17584|+|0-858|ARO:3000899|TEM-29 [Escherichia coli] 	0	803	46	849	858	3478183-	803	ATGAGTATTCAACATTTCCGTGTCGCCCTTATTCCCTTTTTTGCGGCATTTTGCCTTCCTGTTTTTGCTCACCCAGAAACGCTGGTGAAAGTAAAAGATGCTGAAGATCAGTTGGGTGCACGAGTGGGTTACATCGAGCTGGATCTCAACAGCGGTAAGATCCTTGAGAGTTTTCGCCCCGAAGAACGTTTTCCAATGATGAGCACTTTTAAAGTTCTGCTATGTGGTGCGGTATTATCCCGTGTTGACGCCGGGCAAGAGCAACTCGGTCGCCGCATACACTATTCTCAGAATGACTTGGTTGAGTACTCACCAGTCACAGAAAAGCATCTTACGGATGGCATGACAGTAAGAGAATTATGCAGTGCTGCCATAACCATGAGTGATAACACTGCGGCCAACTTACTTCTGACAACGATCGGAGGACCGAAGGAGCTAACCGCTTTTTTGCACAACATGGGGGATCATGTAACCCGCCTTGATCGTTGGGAACCGGAGCTGAATGAAGCCATACCAAACGACGAGCGTGACACCACGATGCCTGCAGCAATGGCAACAACGTTGCGCAAACTATTAACTGGCGAACTACTTACTCTAGCTTCCCGGCAACAATTAATAGACTGGATGGAGGCGGATAAAGTTGCAGGACCACTTCTGCGCTCGGCCCTTCCGGCTGGCTGGTTTATTGCTGATAAATCTGGAGCCGGTGAGCGTGGATCTCGCGGTATCATTGCAGCACTGGGGCCAGATGGTAAGCCCTCCCGTATCGTAGTTATCTACACGACGGGGAGTCAGGCAACTAT
gb|KP881233.1|+|0-1152|ARO:3004634|ADC-73 [Acinetobacter baumannii] 	0	1097	63	1160	1152	126080+	1097	ATGCGATTTAAAAAAATTTCTTGTCTACTTTTATCCCCGCTTTTTATTTTTAGTACCTCAATTTATGCGGGCAATACACCAAAAGACCAAGAAATTAAAAAACTGGTAGATCAAAACTTTAAACCGTTATTAGAAAAATATGATGTGCCAGGTATGGCTGTGGGTGTTATTCAAAATAATAAAAAGTATGAAATGTATTATGGTCTTCAATCTGTTCAAGATAAAAAAGCCGTAAATAGCAGTACTATTTTTGAGCTAGGTTCTGTCAGTAAATTATTTACCGCGACAGCAGGTGGATATGCAAAAAATAAAGGAAAAATCTCTTTTGACGATACGCCTGGTAAGTATTGGAAAGAACTAAAAAATACACCGATTGACCAAGTTAACTTACTTCAACTCGCGACGTATACAAGTGGTAACCTTGCCTTGCAATTTCCAGATGAAGTAAAAACAGATCAGCAAGTTTTAACATTTTTTAAAGACTGGAAACCTAAAAACTCAATCGGTGAATATCGACAATATTCAAACCCAAGCATTGGTTTATTTGGAAAAGTTGTAGCTTTGTCTATGAATAAACCTTTCGACCAAGTCTTAGAAAAAACAATTTTTCCGGCCCTTGGCTTAAAACATAGCTATGTAAATGTACCTAAGACCCAGATGCAAAACTATGCTTTTGGCTATAACCAAGAAAATCAGCCGATTCGAGTTAACCCCGGCCCACTCGATGCCCCAGCATATGGCGTCAAATCGACACTACCCGACATGTTGAGTTTTATTCATGCCAACCTAAATCCACAAAAATATCCAGCAGATATTCAACGGGCAATTAATGAAACACATCAGGGTCGCTATCAAGTAAATACCATGTATCAGGCACTCGGTTGGGAAGAGTTTTCTTATCCGGCAACGTTACAAACTTTATTAGACAGTAATTCAGAACAGATTGTGATGAAACCTAATAAAGTGACTGCTATTTCAAAGGAACCTTCAGTTAAGATGTACCATAAAACTGGCTCAACTACCGGTTTCGGAACATATGTGGTGTTTATTCCTAAAGAAAATATTGGTTTAGTCATGTTAACCAATAAACGTATTCC
gb|X64523.1|-|476-1337|ARO:3000875|TEM-3 [Klebsiella pneumoniae] 	0	806	46	852	861	3478183-	806	ATGAGTATTCAACATTTCCGTGTCGCCCTTATTCCCTTTTTTGCGGCATTTTGCCTTCCTGTTTTTGCTCACCCAGAAACGCTGGTGAAAGTAAAAGATGCTGAAGATCAGTTGGGTGCACGAGTGGGTTACATCGAGCTGGATCTCAACAGCGGTAAGATCCTTGAGAGTTTTCGCCCCGAAGAACGTTTTCCAATGATGAGCACTTTTAAAGTTCTGCTATGTGGTGCGGTATTATCCCGTGTTGACGCCGGGCAAGAGCAACTCGGTCGCCGCATACACTATTCTCAGAATGACTTGGTTGAGTACTCACCAGTCACAGAAAAGCATCTTACGGATGGCATGACAGTAAGAGAATTATGCAGTGCTGCCATAACCATGAGTGATAACACTGCGGCCAACTTACTTCTGACAACGATCGGAGGACCGAAGGAGCTAACCGCTTTTTTGCACAACATGGGGGATCATGTAACCCGCCTTGATCGTTGGGAACCGGAGCTGAATGAAGCCATACCAAACGACGAGCGTGACACCACGATGCCTGCAGCAATGGCAACAACGTTGCGCAAACTATTAACTGGCGAACTACTTACTCTAGCTTCCCGGCAACAATTAATAGACTGGATGGAGGCGGATAAAGTTGCAGGACCACTTCTGCGCTCGGCCCTTCCGGCTGGCTGGTTTATTGCTGATAAATCTGGAGCCGGTGAGCGTGGATCTCGCGGTATCATTGCAGCACTGGGGCCAGATGGTAAGCCCTCCCGTATCGTAGTTATCTACACGACGGGGAGTCAGGCAACTATGGA
gb|EU274580|+|214-1075|ARO:3001030|TEM-164 [Klebsiella pneumoniae] 	0	806	46	852	861	3478183-	806	ATGAGTATTCAACATTTCCGTGTCGCCCTTATTCCCTTTTTTGCGGCATTTTGCCTTCCTGTTTTTGCTCACCCAGAAACGCTGGTGAAAGTAAAAGATGCTGAAGATCAGTTGGGTGCACGAGTGGGTTACATCGAGCTGGATCTCAACAGCGGTAAGATCCTTGAGAGTTTTCGCCCCGAAGAACGTTTTCCAATGATGAGCACTTTTAAAGTTCTGCTATGTGGTGCGGTATTATCCCGTGTTGACGCCGGGCAAGAGCAACTCGGTCGCCGCATACACTATTCTCAGAATGACTTGGTTGAGTACTCACCAGTCACAGAAAAGCATCTTACGGATGGCATGACAGTAAGAGAATTATGCAGTGCTGCCATAACCATGAGTGATAACACTGCGGCCAACTTACTTCTGACAACGATCGGAGGACCGAAGGAGCTAACCGCTTTTTTGCACAACATGGGGGATCATGTAACCCGCCTTGATCGTTGGGAACCGGAGCTGAATGAAGCCATACCAAACGACGAGCGTGACACCACGATGCCTGCAGCAATGGCAACAACGTTGCGCAAACTATTAACTGGCGAACTACTTACTCTAGCTTCCCGGCAACAATTAATAGACTGGATGGAGGCGGATAAAGTTGCAGGACCACTTCTGCGCTCGGCCCTTCCGGCTGGCTGGTTTATTGCTGATAAATCTGGAGCCGGTGAGCGTGGATCTCGCGGTATCATTGCAGCACTGGGGCCAGATGGTAAGCCCTCCCGTATCGTAGTTATCTACACGACGGGGAGTCAGGCAACTATGGA
gb|AY327540|+|0-858|ARO:3000986|TEM-124 [Morganella morganii] 	0	803	46	852	858	3478183-	806	ATGAGTATTCAACATTTCCGTGTCGCCCTTATTCCCTTTTTTGCGGCATTTTGCCTTCCTGTTTTTGCTCACCCAGAAACGCTGGTGAAAGTAAAAGATGCTGAAGATCAGTTGGGTGCACGAGTGGGTTACATCGAGCTGGATCTCAACAGCGGTAAGATCCTTGAGAGTTTTCGCCCCGAAGAACGTTTTCCAATGATGAGCACTTTTAAAGTTCTGCTATGTGGTGCGGTATTATCCCGTGTTGACGCCGGGCAAGAGCAACTCGGTCGCCGCATACACTATTCTCAGAATGACTTGGTTGAGTACTCACCAGTCACAGAAAAGCATCTTACGGATGGCATGACAGTAAGAGAATTATGCAGTGCTGCCATAACCATGAGTGATAACACTGCGGCCAACTTACTTCTGACAACGATCGGAGGACCGAAGGAGCTAACCGCTTTTTTGCACAACATGGGGGATCATGTAACCCGCCTTGATCGTTGGGAACCGGAGCTGAATGAAGCCATACCAAACGACGAGCGTGACACCACGATGCCTGCAGCAATGGCAACAACGTTGCGCAAACTATTAACTGGCGAACTACTTACTCTAGCTTCCCGGCAACAATTAATAGACTGGATGGAGGCGGATAAAGTTGCAGGACCACTTCTGCGCTCGGCCCTTCCGGCTGGCTGGTTTATTGCTGATAAATCTGGAGCCGGTGAGCGTGGATCTCGCGGTATCATTGCAGCACTGGGGCCAGATGGTAAGCCCTCCCGTATCGTAGTTATCTACACGACGGGGAGTCAGGCAACTATGGA
gb|AB049569|+|0-861|ARO:3000958|TEM-91 [Escherichia coli] 	0	806	46	852	861	3478183-	806	ATGAGTATTCAACATTTCCGTGTCGCCCTTATTCCCTTTTTTGCGGCATTTTGCCTTCCTGTTTTTGCTCACCCAGAAACGCTGGTGAAAGTAAAAGATGCTGAAGATCAGTTGGGTGCACGAGTGGGTTACATCGAGCTGGATCTCAACAGCGGTAAGATCCTTGAGAGTTTTCGCCCCGAAGAACGTTTTCCAATGATGAGCACTTTTAAAGTTCTGCTATGTGGTGCGGTATTATCCCGTGTTGACGCCGGGCAAGAGCAACTCGGTCGCCGCATACACTATTCTCAGAATGACTTGGTTGAGTACTCACCAGTCACAGAAAAGCATCTTACGGATGGCATGACAGTAAGAGAATTATGCAGTGCTGCCATAACCATGAGTGATAACACTGCGGCCAACTTACTTCTGACAACGATCGGAGGACCGAAGGAGCTAACCGCTTTTTTGCACAACATGGGGGATCATGTAACCCGCCTTGATCGTTGGGAACCGGAGCTGAATGAAGCCATACCAAACGACGAGCGTGACACCACGATGCCTGCAGCAATGGCAACAACGTTGCGCAAACTATTAACTGGCGAACTACTTACTCTAGCTTCCCGGCAACAATTAATAGACTGGATGGAGGCGGATAAAGTTGCAGGACCACTTCTGCGCTCGGCCCTTCCGGCTGGCTGGTTTATTGCTGATAAATCTGGAGCCGGTGAGCGTGGATCTCGCGGTATCATTGCAGCACTGGGGCCAGATGGTAAGCCCTCCCGTATCGTAGTTATCTACACGACGGGGAGTCAGGCAACTATGGA
gb|JX025021|+|0-825|ARO:3001679|OXA-241 [Acinetobacter baumannii] 	0	770	54149	54919	825	246080-	770	ATGAACATTAAAGCACTCTTACTTATAACAAGCGCTATTTTTATTTCAGCCTGCTCACCTTATATAGTGACTGCTAATCCAAATCACAGCGCTTCAAAATCTGATGTAAAAGCAGAGAAAATTAAAAATTTATTTAACGAAGCACACACTACGGGTGTTTTAGTTATCCAACAAGGCCAAACTCAACAAAGCTATGGTAATGATCTTGCTCGTGCTTCGACCGAGTATGTACCTGCTTCGACCTTCAAAATGCTTAATGCTTTGATCGGCCTTGAGCACCATAAGGCAACCACCACAGAAGTATTTAAGTGGGATGGTAAAAAAAGGTTATTCCCAGAATGGGAAAAGGACATGACCCTAGGCGATGCCATGAAAGCTTCCGCTATTCCAGTTTATCAAGATTTAGCTCGTCGTATTGGACTTGAGCTCATGTCTAAGGAAGTGAAGCGTGTTGGTTATGGCAATGCAGATATCGGTACCCAAGTCGATAATTTTTGGCTGGTGGGTCCTTTAAAAATTACTCCTCAGCAAGAGGCACAGTTTGCTTACAAGCTAGCTAATAAAACGCTTCCATTTAGCCAAAAAGTCCAAGATGAAGTGCAATCCATGCTATTCATAGAAGAAAAGAATGGAAACAAAATATACGCAAAAAGTGGTTGGGGATGGGATGTAAACCCACAAGTAGGCTGGTTAACTGGATGGGTTGTTCAGCCTCAAGGGAATATTGTAGCGTTCTCCCTTAACTTAGAAATGAAAAAAGGAATACCTAG
gb|AJ437107|+|208-1069|ARO:3000900|TEM-30 [Escherichia coli] 	0	806	46	852	861	3478183-	806	ATGAGTATTCAACATTTCCGTGTCGCCCTTATTCCCTTTTTTGCGGCATTTTGCCTTCCTGTTTTTGCTCACCCAGAAACGCTGGTGAAAGTAAAAGATGCTGAAGATCAGTTGGGTGCACGAGTGGGTTACATCGAGCTGGATCTCAACAGCGGTAAGATCCTTGAGAGTTTTCGCCCCGAAGAACGTTTTCCAATGATGAGCACTTTTAAAGTTCTGCTATGTGGTGCGGTATTATCCCGTGTTGACGCCGGGCAAGAGCAACTCGGTCGCCGCATACACTATTCTCAGAATGACTTGGTTGAGTACTCACCAGTCACAGAAAAGCATCTTACGGATGGCATGACAGTAAGAGAATTATGCAGTGCTGCCATAACCATGAGTGATAACACTGCGGCCAACTTACTTCTGACAACGATCGGAGGACCGAAGGAGCTAACCGCTTTTTTGCACAACATGGGGGATCATGTAACCCGCCTTGATCGTTGGGAACCGGAGCTGAATGAAGCCATACCAAACGACGAGCGTGACACCACGATGCCTGCAGCAATGGCAACAACGTTGCGCAAACTATTAACTGGCGAACTACTTACTCTAGCTTCCCGGCAACAATTAATAGACTGGATGGAGGCGGATAAAGTTGCAGGACCACTTCTGCGCTCGGCCCTTCCGGCTGGCTGGTTTATTGCTGATAAATCTGGAGCCGGTGAGCGTGGATCTCGCGGTATCATTGCAGCACTGGGGCCAGATGGTAAGCCCTCCCGTATCGTAGTTATCTACACGACGGGGAGTCAGGCAACTATGGA
gb|FJ197316|+|0-861|ARO:3001032|TEM-166 [Escherichia coli] 	0	806	46	852	861	3478183-	806	ATGAGTATTCAACATTTCCGTGTCGCCCTTATTCCCTTTTTTGCGGCATTTTGCCTTCCTGTTTTTGCTCACCCAGAAACGCTGGTGAAAGTAAAAGATGCTGAAGATCAGTTGGGTGCACGAGTGGGTTACATCGAGCTGGATCTCAACAGCGGTAAGATCCTTGAGAGTTTTCGCCCCGAAGAACGTTTTCCAATGATGAGCACTTTTAAAGTTCTGCTATGTGGTGCGGTATTATCCCGTGTTGACGCCGGGCAAGAGCAACTCGGTCGCCGCATACACTATTCTCAGAATGACTTGGTTGAGTACTCACCAGTCACAGAAAAGCATCTTACGGATGGCATGACAGTAAGAGAATTATGCAGTGCTGCCATAACCATGAGTGATAACACTGCGGCCAACTTACTTCTGACAACGATCGGAGGACCGAAGGAGCTAACCGCTTTTTTGCACAACATGGGGGATCATGTAACCCGCCTTGATCGTTGGGAACCGGAGCTGAATGAAGCCATACCAAACGACGAGCGTGACACCACGATGCCTGCAGCAATGGCAACAACGTTGCGCAAACTATTAACTGGCGAACTACTTACTCTAGCTTCCCGGCAACAATTAATAGACTGGATGGAGGCGGATAAAGTTGCAGGACCACTTCTGCGCTCGGCCCTTCCGGCTGGCTGGTTTATTGCTGATAAATCTGGAGCCGGTGAGCGTGGATCTCGCGGTATCATTGCAGCACTGGGGCCAGATGGTAAGCCCTCCCGTATCGTAGTTATCTACACGACGGGGAGTCAGGCAACTATGGA
gb|KF986253|-|15-840|ARO:3001571|OXA-385 [Acinetobacter baumannii] 	0	770	54149	54919	825	246080-	770	ATGAACATTAAAGCACTCTTACTTATAACAAGCGCTATTTTTATTTCAGCCTGCTCACCTTATATAGTGACTGCTAATCCAAATCACAGCGCTTCAAAATCTGATGTAAAAGCAGAGAAAATTAAAAATTTATTTAACGAAGCACACACTACGGGTGTTTTAGTTATCCAACAAGGCCAAACTCAACAAAGCTATGGTAATGATCTTGCTCGTGCTTCGACCGAGTATGTACCTGCTTCGACCTTCAAAATGCTTAATGCTTTGATCGGCCTTGAGCACCATAAGGCAACCACCACAGAAGTATTTAAGTGGGATGGTAAAAAAAGGTTATTCCCAGAATGGGAAAAGGACATGACCCTAGGCGATGCCATGAAAGCTTCCGCTATTCCAGTTTATCAAGATTTAGCTCGTCGTATTGGACTTGAGCTCATGTCTAAGGAAGTGAAGCGTGTTGGTTATGGCAATGCAGATATCGGTACCCAAGTCGATAATTTTTGGCTGGTGGGTCCTTTAAAAATTACTCCTCAGCAAGAGGCACAGTTTGCTTACAAGCTAGCTAATAAAACGCTTCCATTTAGCCAAAAAGTCCAAGATGAAGTGCAATCCATGCTATTCATAGAAGAAAAGAATGGAAACAAAATATACGCAAAAAGTGGTTGGGGATGGGATGTAAACCCACAAGTAGGCTGGTTAACTGGATGGGTTGTTCAGCCTCAAGGGAATATTGTAGCGTTCTCCCTTAACTTAGAAATGAAAAAAGGAATACCTAG
gb|GU371926|-|50304-51165|ARO:3000903|TEM-33 [Escherichia coli] 	0	806	46	852	861	3478183-	806	ATGAGTATTCAACATTTCCGTGTCGCCCTTATTCCCTTTTTTGCGGCATTTTGCCTTCCTGTTTTTGCTCACCCAGAAACGCTGGTGAAAGTAAAAGATGCTGAAGATCAGTTGGGTGCACGAGTGGGTTACATCGAGCTGGATCTCAACAGCGGTAAGATCCTTGAGAGTTTTCGCCCCGAAGAACGTTTTCCAATGATGAGCACTTTTAAAGTTCTGCTATGTGGTGCGGTATTATCCCGTGTTGACGCCGGGCAAGAGCAACTCGGTCGCCGCATACACTATTCTCAGAATGACTTGGTTGAGTACTCACCAGTCACAGAAAAGCATCTTACGGATGGCATGACAGTAAGAGAATTATGCAGTGCTGCCATAACCATGAGTGATAACACTGCGGCCAACTTACTTCTGACAACGATCGGAGGACCGAAGGAGCTAACCGCTTTTTTGCACAACATGGGGGATCATGTAACCCGCCTTGATCGTTGGGAACCGGAGCTGAATGAAGCCATACCAAACGACGAGCGTGACACCACGATGCCTGCAGCAATGGCAACAACGTTGCGCAAACTATTAACTGGCGAACTACTTACTCTAGCTTCCCGGCAACAATTAATAGACTGGATGGAGGCGGATAAAGTTGCAGGACCACTTCTGCGCTCGGCCCTTCCGGCTGGCTGGTTTATTGCTGATAAATCTGGAGCCGGTGAGCGTGGATCTCGCGGTATCATTGCAGCACTGGGGCCAGATGGTAAGCCCTCCCGTATCGTAGTTATCTACACGACGGGGAGTCAGGCAACTATGGA
gb|FJ360884|+|213-1074|ARO:3001033|TEM-167 [Escherichia coli] 	0	806	46	852	861	3478183-	806	ATGAGTATTCAACATTTCCGTGTCGCCCTTATTCCCTTTTTTGCGGCATTTTGCCTTCCTGTTTTTGCTCACCCAGAAACGCTGGTGAAAGTAAAAGATGCTGAAGATCAGTTGGGTGCACGAGTGGGTTACATCGAGCTGGATCTCAACAGCGGTAAGATCCTTGAGAGTTTTCGCCCCGAAGAACGTTTTCCAATGATGAGCACTTTTAAAGTTCTGCTATGTGGTGCGGTATTATCCCGTGTTGACGCCGGGCAAGAGCAACTCGGTCGCCGCATACACTATTCTCAGAATGACTTGGTTGAGTACTCACCAGTCACAGAAAAGCATCTTACGGATGGCATGACAGTAAGAGAATTATGCAGTGCTGCCATAACCATGAGTGATAACACTGCGGCCAACTTACTTCTGACAACGATCGGAGGACCGAAGGAGCTAACCGCTTTTTTGCACAACATGGGGGATCATGTAACCCGCCTTGATCGTTGGGAACCGGAGCTGAATGAAGCCATACCAAACGACGAGCGTGACACCACGATGCCTGCAGCAATGGCAACAACGTTGCGCAAACTATTAACTGGCGAACTACTTACTCTAGCTTCCCGGCAACAATTAATAGACTGGATGGAGGCGGATAAAGTTGCAGGACCACTTCTGCGCTCGGCCCTTCCGGCTGGCTGGTTTATTGCTGATAAATCTGGAGCCGGTGAGCGTGGATCTCGCGGTATCATTGCAGCACTGGGGCCAGATGGTAAGCCCTCCCGTATCGTAGTTATCTACACGACGGGGAGTCAGGCAACTATGGA
gb|JX025022|+|0-825|ARO:3001680|OXA-242 [Acinetobacter baumannii] 	0	770	54149	54919	825	246080-	770	ATGAACATTAAAGCACTCTTACTTATAACAAGCGCTATTTTTATTTCAGCCTGCTCACCTTATATAGTGACTGCTAATCCAAATCACAGCGCTTCAAAATCTGATGTAAAAGCAGAGAAAATTAAAAATTTATTTAACGAAGCACACACTACGGGTGTTTTAGTTATCCAACAAGGCCAAACTCAACAAAGCTATGGTAATGATCTTGCTCGTGCTTCGACCGAGTATGTACCTGCTTCGACCTTCAAAATGCTTAATGCTTTGATCGGCCTTGAGCACCATAAGGCAACCACCACAGAAGTATTTAAGTGGGATGGTAAAAAAAGGTTATTCCCAGAATGGGAAAAGGACATGACCCTAGGCGATGCCATGAAAGCTTCCGCTATTCCAGTTTATCAAGATTTAGCTCGTCGTATTGGACTTGAGCTCATGTCTAAGGAAGTGAAGCGTGTTGGTTATGGCAATGCAGATATCGGTACCCAAGTCGATAATTTTTGGCTGGTGGGTCCTTTAAAAATTACTCCTCAGCAAGAGGCACAGTTTGCTTACAAGCTAGCTAATAAAACGCTTCCATTTAGCCAAAAAGTCCAAGATGAAGTGCAATCCATGCTATTCATAGAAGAAAAGAATGGAAACAAAATATACGCAAAAAGTGGTTGGGGATGGGATGTAAACCCACAAGTAGGCTGGTTAACTGGATGGGTTGTTCAGCCTCAAGGGAATATTGTAGCGTTCTCCCTTAACTTAGAAATGAAAAAAGGAATACCTAG
gb|AY628176|+|75-936|ARO:3000987|TEM-125 [Escherichia coli] 	0	806	46	852	861	3478183-	806	ATGAGTATTCAACATTTCCGTGTCGCCCTTATTCCCTTTTTTGCGGCATTTTGCCTTCCTGTTTTTGCTCACCCAGAAACGCTGGTGAAAGTAAAAGATGCTGAAGATCAGTTGGGTGCACGAGTGGGTTACATCGAGCTGGATCTCAACAGCGGTAAGATCCTTGAGAGTTTTCGCCCCGAAGAACGTTTTCCAATGATGAGCACTTTTAAAGTTCTGCTATGTGGTGCGGTATTATCCCGTGTTGACGCCGGGCAAGAGCAACTCGGTCGCCGCATACACTATTCTCAGAATGACTTGGTTGAGTACTCACCAGTCACAGAAAAGCATCTTACGGATGGCATGACAGTAAGAGAATTATGCAGTGCTGCCATAACCATGAGTGATAACACTGCGGCCAACTTACTTCTGACAACGATCGGAGGACCGAAGGAGCTAACCGCTTTTTTGCACAACATGGGGGATCATGTAACCCGCCTTGATCGTTGGGAACCGGAGCTGAATGAAGCCATACCAAACGACGAGCGTGACACCACGATGCCTGCAGCAATGGCAACAACGTTGCGCAAACTATTAACTGGCGAACTACTTACTCTAGCTTCCCGGCAACAATTAATAGACTGGATGGAGGCGGATAAAGTTGCAGGACCACTTCTGCGCTCGGCCCTTCCGGCTGGCTGGTTTATTGCTGATAAATCTGGAGCCGGTGAGCGTGGATCTCGCGGTATCATTGCAGCACTGGGGCCAGATGGTAAGCCCTCCCGTATCGTAGTTATCTACACGACGGGGAGTCAGGCAACTATGGA
gb|KP881234.1|+|0-1152|ARO:3003880|ADC-74 [Acinetobacter baumannii] 	0	1097	63	1160	1152	126080+	1097	ATGCGATTTAAAAAAATTTCTTGTCTACTTTTATCCCCGCTTTTTATTTTTAGTACCTCAATTTATGCGGGCAATACACCAAAAGACCAAGAAATTAAAAAACTGGTAGATCAAAACTTTAAACCGTTATTAGAAAAATATGATGTGCCAGGTATGGCTGTGGGTGTTATTCAAAATAATAAAAAGTATGAAATGTATTATGGTCTTCAATCTGTTCAAGATAAAAAAGCCGTAAATAGCAGTACTATTTTTGAGCTAGGTTCTGTCAGTAAATTATTTACCGCGACAGCAGGTGGATATGCAAAAAATAAAGGAAAAATCTCTTTTGACGATACGCCTGGTAAGTATTGGAAAGAACTAAAAAATACACCGATTGACCAAGTTAACTTACTTCAACTCGCGACGTATACAAGTGGTAACCTTGCCTTGCAATTTCCAGATGAAGTAAAAACAGATCAGCAAGTTTTAACATTTTTTAAAGACTGGAAACCTAAAAACTCAATCGGTGAATATCGACAATATTCAAACCCAAGCATTGGTTTATTTGGAAAAGTTGTAGCTTTGTCTATGAATAAACCTTTCGACCAAGTCTTAGAAAAAACAATTTTTCCGGCCCTTGGCTTAAAACATAGCTATGTAAATGTACCTAAGACCCAGATGCAAAACTATGCTTTTGGCTATAACCAAGAAAATCAGCCGATTCGAGTTAACCCCGGCCCACTCGATGCCCCAGCATATGGCGTCAAATCGACACTACCCGACATGTTGAGTTTTATTCATGCCAACCTAAATCCACAAAAATATCCAGCAGATATTCAACGGGCAATTAATGAAACACATCAGGGTCGCTATCAAGTAAATACCATGTATCAGGCACTCGGTTGGGAAGAGTTTTCTTATCCGGCAACGTTACAAACTTTATTAGACAGTAATTCAGAACAGATTGTGATGAAACCTAATAAAGTGACTGCTATTTCAAAGGAACCTTCAGTTAAGATGTACCATAAAACTGGCTCAACTACCGGTTTCGGAACATATGTGGTGTTTATTCCTAAAGAAAATATTGGTTTAGTCATGTTAACCAATAAACGTATTCC
gb|KC292503|+|4334-5195|ARO:3000904|TEM-34 [Haemophilus parainfluenzae] 	0	806	46	852	861	3478183-	806	ATGAGTATTCAACATTTCCGTGTCGCCCTTATTCCCTTTTTTGCGGCATTTTGCCTTCCTGTTTTTGCTCACCCAGAAACGCTGGTGAAAGTAAAAGATGCTGAAGATCAGTTGGGTGCACGAGTGGGTTACATCGAGCTGGATCTCAACAGCGGTAAGATCCTTGAGAGTTTTCGCCCCGAAGAACGTTTTCCAATGATGAGCACTTTTAAAGTTCTGCTATGTGGTGCGGTATTATCCCGTGTTGACGCCGGGCAAGAGCAACTCGGTCGCCGCATACACTATTCTCAGAATGACTTGGTTGAGTACTCACCAGTCACAGAAAAGCATCTTACGGATGGCATGACAGTAAGAGAATTATGCAGTGCTGCCATAACCATGAGTGATAACACTGCGGCCAACTTACTTCTGACAACGATCGGAGGACCGAAGGAGCTAACCGCTTTTTTGCACAACATGGGGGATCATGTAACCCGCCTTGATCGTTGGGAACCGGAGCTGAATGAAGCCATACCAAACGACGAGCGTGACACCACGATGCCTGCAGCAATGGCAACAACGTTGCGCAAACTATTAACTGGCGAACTACTTACTCTAGCTTCCCGGCAACAATTAATAGACTGGATGGAGGCGGATAAAGTTGCAGGACCACTTCTGCGCTCGGCCCTTCCGGCTGGCTGGTTTATTGCTGATAAATCTGGAGCCGGTGAGCGTGGATCTCGCGGTATCATTGCAGCACTGGGGCCAGATGGTAAGCCCTCCCGTATCGTAGTTATCTACACGACGGGGAGTCAGGCAACTATGGA
gb|FJ919776|+|208-1069|ARO:3001034|TEM-168 [Escherichia coli] 	0	806	46	852	861	3478183-	806	ATGAGTATTCAACATTTCCGTGTCGCCCTTATTCCCTTTTTTGCGGCATTTTGCCTTCCTGTTTTTGCTCACCCAGAAACGCTGGTGAAAGTAAAAGATGCTGAAGATCAGTTGGGTGCACGAGTGGGTTACATCGAGCTGGATCTCAACAGCGGTAAGATCCTTGAGAGTTTTCGCCCCGAAGAACGTTTTCCAATGATGAGCACTTTTAAAGTTCTGCTATGTGGTGCGGTATTATCCCGTGTTGACGCCGGGCAAGAGCAACTCGGTCGCCGCATACACTATTCTCAGAATGACTTGGTTGAGTACTCACCAGTCACAGAAAAGCATCTTACGGATGGCATGACAGTAAGAGAATTATGCAGTGCTGCCATAACCATGAGTGATAACACTGCGGCCAACTTACTTCTGACAACGATCGGAGGACCGAAGGAGCTAACCGCTTTTTTGCACAACATGGGGGATCATGTAACCCGCCTTGATCGTTGGGAACCGGAGCTGAATGAAGCCATACCAAACGACGAGCGTGACACCACGATGCCTGCAGCAATGGCAACAACGTTGCGCAAACTATTAACTGGCGAACTACTTACTCTAGCTTCCCGGCAACAATTAATAGACTGGATGGAGGCGGATAAAGTTGCAGGACCACTTCTGCGCTCGGCCCTTCCGGCTGGCTGGTTTATTGCTGATAAATCTGGAGCCGGTGAGCGTGGATCTCGCGGTATCATTGCAGCACTGGGGCCAGATGGTAAGCCCTCCCGTATCGTAGTTATCTACACGACGGGGAGTCAGGCAACTATGGA
gb|KR057756.1|+|0-1116|ARO:3004350|PDC-87 [Pseudomonas aeruginosa] 	0	1061	35591	36652	1116	232416+	1061	GATGAGGCCCCGGCGGATCGCCTGAAGGCACTGGTCGACGCCGCCGTACAACCGGTGATGAAGGCCAATGACATTCCGGGCCTGGCCGTAGCCATCAGCCTGAAAGGAGAACCGCATTACTTCAGCTATGGGCTGGCCTCGAAAGAGGACGGCCGCCGGGTGACGCCGGAGACCCTGTTCGAGATCGGCTCGGTGAGCAAGACCTTCACCGTCACCCTCGCCGGCTATGCCCTGGCCCAGGACAAGATGCGCCTCGACGACCGCGCCAGCCAGCACTGGCCGGCACTGCAGGGCAGCCGCTTCGACGGCATCAGCCTGCTCGACCTCGCGACCTATACCGCCGGCGGCTTGCCGCTGCAGTTCCCCGACTCGGTGCAGAAGGACCAGGCACAGATCCGCGACTACTACCGCCAGTGGCAGCCGACCTACGCGCCGGGCAGCCAGCGCCTCTATTCCAACCCGAGCATCGGCCTGTTCGGCTATCTCGCCGCGCGCAGCCTGGGCCAGCCGTTCGAACGGCTCATGGAGCAGCAATTGTTCCCGGCACTGGGCCTCGAACAGACCCACCTCGACGTGCCCGAGGCGGCGCTGGCGCAGTACGCCCAGGGCTACGGCAAGGACGACCGCCCGCTACGGGTCGGTCCCGGCCCGCTGGATGCCGAAGGCTACGGGGTGAAGACCAGCGCGGCCGACCTGCTGCGCTTCGTCGATGCCAACCTGCATCCGGAGCGCCTGGACAGGCCCTGGGCGCAGGCGCTCGATGCCACCCATCGCGGTTACTACAAGGTCGGCGACATGACCCAGGGCCTGGGCTGGGAAGCCTACGACTGGCCGATCTCCCTGAAGCGCCTGCAGGCCGGCAACTCGACGCCGATGGCGCTGCAACCACACAGGATCGCCAGGCTGCCCGCGCCACAGGCGCTGGAGGGCCAGCGCCTGCTGAACAAGACCGGCTCCACCAACGGCTTCGGCGCCTACGTGGCGTTCGTCCCGGGCCGCGACCTGGGCCTGGTGATCCTGGCCAACCGCAACTATCCCAATGCCGAGCGGGTGAAGATCGC
gb|KF711993|+|0-801|ARO:3001807|OXA-246 [Pseudomonas aeruginosa] 	0	746	659	1405	801	104604+	746	ATGAAAACATTTGCCGCATATGTAATTATCGCGTGTCTTTCGAGTACGGCATTAGCTGGTTCAATTACAGAAAATACGTCTTGGAACAAAGAGTTCTCTGCCGAAGCCGTCAATGGTGTCTTCGTGCTTTGTAAAAGTAGCAGTAAATCCTGCGCTACCAATGACTTAGCTCGTGCATCAAAGGAATATCTTCCAGCATCAACATTTAAGATCCCCAACGCAATTATCGGCCTAGAAACTGGTGTCATAAAGAATGAGCATCAGGTTTTCAAATGGGACGGAAAGCCAAGAGCCATGAAGCAATGGGAAAGAGACTTGACCTTAAGAGGGGCAATACAAGTTTCAGCTGTTCCCGTATTTCAACAAATCGCCAGAGAAGTTGGCGAAGTAAGAATGCAGAAATACCTTAAAAAATTTTCCTATGGCAACCAGAATATCAGTGGTGGCATTGACAAATTCTGGTTGGAAGGCCAGCTTAGAATTTCCGCAGTTAATCAAGTGGAGTTTCTAGAGTCTCTATATTTAAATAAATTGTCAGCATCTAAAGAAAACCAGCTAATAGTAAAAGAGGCTTTGGTAACGGAGGCGGCACCTGAATATCTAGTGCATTCAAAAACTGGTTTTTCTGGTGTGGGAACTGAGTCAAATCCTGGTGTCGCATGGTGGGTTGGGTGGGTTGAGAAGGAGACAGAGGTTTACTTTTTCGCCTTTAACATGGATATAGACAACGAAAGTAAGTTGCCGCT
gb|FJ873740|+|0-858|ARO:3001035|TEM-169 [Salmonella enterica subsp. enterica serovar Infantis] 	0	803	46	849	858	3478183-	803	ATGAGTATTCAACATTTCCGTGTCGCCCTTATTCCCTTTTTTGCGGCATTTTGCCTTCCTGTTTTTGCTCACCCAGAAACGCTGGTGAAAGTAAAAGATGCTGAAGATCAGTTGGGTGCACGAGTGGGTTACATCGAGCTGGATCTCAACAGCGGTAAGATCCTTGAGAGTTTTCGCCCCGAAGAACGTTTTCCAATGATGAGCACTTTTAAAGTTCTGCTATGTGGTGCGGTATTATCCCGTGTTGACGCCGGGCAAGAGCAACTCGGTCGCCGCATACACTATTCTCAGAATGACTTGGTTGAGTACTCACCAGTCACAGAAAAGCATCTTACGGATGGCATGACAGTAAGAGAATTATGCAGTGCTGCCATAACCATGAGTGATAACACTGCGGCCAACTTACTTCTGACAACGATCGGAGGACCGAAGGAGCTAACCGCTTTTTTGCACAACATGGGGGATCATGTAACCCGCCTTGATCGTTGGGAACCGGAGCTGAATGAAGCCATACCAAACGACGAGCGTGACACCACGATGCCTGCAGCAATGGCAACAACGTTGCGCAAACTATTAACTGGCGAACTACTTACTCTAGCTTCCCGGCAACAATTAATAGACTGGATGGAGGCGGATAAAGTTGCAGGACCACTTCTGCGCTCGGCCCTTCCGGCTGGCTGGTTTATTGCTGATAAATCTGGAGCCGGTGAGCGTGGATCTCGCGGTATCATTGCAGCACTGGGGCCAGATGGTAAGCCCTCCCGTATCGTAGTTATCTACACGACGGGGAGTCAGGCAACTAT
gb|AY628199|+|203-1064|ARO:3000988|TEM-126 [Escherichia coli] 	0	806	46	852	861	3478183-	806	ATGAGTATTCAACATTTCCGTGTCGCCCTTATTCCCTTTTTTGCGGCATTTTGCCTTCCTGTTTTTGCTCACCCAGAAACGCTGGTGAAAGTAAAAGATGCTGAAGATCAGTTGGGTGCACGAGTGGGTTACATCGAGCTGGATCTCAACAGCGGTAAGATCCTTGAGAGTTTTCGCCCCGAAGAACGTTTTCCAATGATGAGCACTTTTAAAGTTCTGCTATGTGGTGCGGTATTATCCCGTGTTGACGCCGGGCAAGAGCAACTCGGTCGCCGCATACACTATTCTCAGAATGACTTGGTTGAGTACTCACCAGTCACAGAAAAGCATCTTACGGATGGCATGACAGTAAGAGAATTATGCAGTGCTGCCATAACCATGAGTGATAACACTGCGGCCAACTTACTTCTGACAACGATCGGAGGACCGAAGGAGCTAACCGCTTTTTTGCACAACATGGGGGATCATGTAACCCGCCTTGATCGTTGGGAACCGGAGCTGAATGAAGCCATACCAAACGACGAGCGTGACACCACGATGCCTGCAGCAATGGCAACAACGTTGCGCAAACTATTAACTGGCGAACTACTTACTCTAGCTTCCCGGCAACAATTAATAGACTGGATGGAGGCGGATAAAGTTGCAGGACCACTTCTGCGCTCGGCCCTTCCGGCTGGCTGGTTTATTGCTGATAAATCTGGAGCCGGTGAGCGTGGATCTCGCGGTATCATTGCAGCACTGGGGCCAGATGGTAAGCCCTCCCGTATCGTAGTTATCTACACGACGGGGAGTCAGGCAACTATGGA
gb|AF143804|+|0-861|ARO:3000959|TEM-92 [Proteus mirabilis] 	0	806	46	852	861	3478183-	806	ATGAGTATTCAACATTTCCGTGTCGCCCTTATTCCCTTTTTTGCGGCATTTTGCCTTCCTGTTTTTGCTCACCCAGAAACGCTGGTGAAAGTAAAAGATGCTGAAGATCAGTTGGGTGCACGAGTGGGTTACATCGAGCTGGATCTCAACAGCGGTAAGATCCTTGAGAGTTTTCGCCCCGAAGAACGTTTTCCAATGATGAGCACTTTTAAAGTTCTGCTATGTGGTGCGGTATTATCCCGTGTTGACGCCGGGCAAGAGCAACTCGGTCGCCGCATACACTATTCTCAGAATGACTTGGTTGAGTACTCACCAGTCACAGAAAAGCATCTTACGGATGGCATGACAGTAAGAGAATTATGCAGTGCTGCCATAACCATGAGTGATAACACTGCGGCCAACTTACTTCTGACAACGATCGGAGGACCGAAGGAGCTAACCGCTTTTTTGCACAACATGGGGGATCATGTAACCCGCCTTGATCGTTGGGAACCGGAGCTGAATGAAGCCATACCAAACGACGAGCGTGACACCACGATGCCTGCAGCAATGGCAACAACGTTGCGCAAACTATTAACTGGCGAACTACTTACTCTAGCTTCCCGGCAACAATTAATAGACTGGATGGAGGCGGATAAAGTTGCAGGACCACTTCTGCGCTCGGCCCTTCCGGCTGGCTGGTTTATTGCTGATAAATCTGGAGCCGGTGAGCGTGGATCTCGCGGTATCATTGCAGCACTGGGGCCAGATGGTAAGCCCTCCCGTATCGTAGTTATCTACACGACGGGGAGTCAGGCAACTATGGA
gb|LK391770.1|+|19707-20568|ARO:3000876|TEM-4 [Klebsiella pneumoniae] 	0	806	46	852	861	3478183-	806	ATGAGTATTCAACATTTCCGTGTCGCCCTTATTCCCTTTTTTGCGGCATTTTGCCTTCCTGTTTTTGCTCACCCAGAAACGCTGGTGAAAGTAAAAGATGCTGAAGATCAGTTGGGTGCACGAGTGGGTTACATCGAGCTGGATCTCAACAGCGGTAAGATCCTTGAGAGTTTTCGCCCCGAAGAACGTTTTCCAATGATGAGCACTTTTAAAGTTCTGCTATGTGGTGCGGTATTATCCCGTGTTGACGCCGGGCAAGAGCAACTCGGTCGCCGCATACACTATTCTCAGAATGACTTGGTTGAGTACTCACCAGTCACAGAAAAGCATCTTACGGATGGCATGACAGTAAGAGAATTATGCAGTGCTGCCATAACCATGAGTGATAACACTGCGGCCAACTTACTTCTGACAACGATCGGAGGACCGAAGGAGCTAACCGCTTTTTTGCACAACATGGGGGATCATGTAACCCGCCTTGATCGTTGGGAACCGGAGCTGAATGAAGCCATACCAAACGACGAGCGTGACACCACGATGCCTGCAGCAATGGCAACAACGTTGCGCAAACTATTAACTGGCGAACTACTTACTCTAGCTTCCCGGCAACAATTAATAGACTGGATGGAGGCGGATAAAGTTGCAGGACCACTTCTGCGCTCGGCCCTTCCGGCTGGCTGGTTTATTGCTGATAAATCTGGAGCCGGTGAGCGTGGATCTCGCGGTATCATTGCAGCACTGGGGCCAGATGGTAAGCCCTCCCGTATCGTAGTTATCTACACGACGGGGAGTCAGGCAACTATGGA
gb|AJ318093|+|0-861|ARO:3000960|TEM-93 [Escherichia coli] 	0	806	46	852	861	3478183-	806	ATGAGTATTCAACATTTCCGTGTCGCCCTTATTCCCTTTTTTGCGGCATTTTGCCTTCCTGTTTTTGCTCACCCAGAAACGCTGGTGAAAGTAAAAGATGCTGAAGATCAGTTGGGTGCACGAGTGGGTTACATCGAGCTGGATCTCAACAGCGGTAAGATCCTTGAGAGTTTTCGCCCCGAAGAACGTTTTCCAATGATGAGCACTTTTAAAGTTCTGCTATGTGGTGCGGTATTATCCCGTGTTGACGCCGGGCAAGAGCAACTCGGTCGCCGCATACACTATTCTCAGAATGACTTGGTTGAGTACTCACCAGTCACAGAAAAGCATCTTACGGATGGCATGACAGTAAGAGAATTATGCAGTGCTGCCATAACCATGAGTGATAACACTGCGGCCAACTTACTTCTGACAACGATCGGAGGACCGAAGGAGCTAACCGCTTTTTTGCACAACATGGGGGATCATGTAACCCGCCTTGATCGTTGGGAACCGGAGCTGAATGAAGCCATACCAAACGACGAGCGTGACACCACGATGCCTGCAGCAATGGCAACAACGTTGCGCAAACTATTAACTGGCGAACTACTTACTCTAGCTTCCCGGCAACAATTAATAGACTGGATGGAGGCGGATAAAGTTGCAGGACCACTTCTGCGCTCGGCCCTTCCGGCTGGCTGGTTTATTGCTGATAAATCTGGAGCCGGTGAGCGTGGATCTCGCGGTATCATTGCAGCACTGGGGCCAGATGGTAAGCCCTCCCGTATCGTAGTTATCTACACGACGGGGAGTCAGGCAACTATGGA
gb|Y14574|+|0-861|ARO:3000888|TEM-17 [Capnocytophaga ochracea] 	0	806	46	852	861	3478183-	806	ATGAGTATTCAACATTTCCGTGTCGCCCTTATTCCCTTTTTTGCGGCATTTTGCCTTCCTGTTTTTGCTCACCCAGAAACGCTGGTGAAAGTAAAAGATGCTGAAGATCAGTTGGGTGCACGAGTGGGTTACATCGAGCTGGATCTCAACAGCGGTAAGATCCTTGAGAGTTTTCGCCCCGAAGAACGTTTTCCAATGATGAGCACTTTTAAAGTTCTGCTATGTGGTGCGGTATTATCCCGTGTTGACGCCGGGCAAGAGCAACTCGGTCGCCGCATACACTATTCTCAGAATGACTTGGTTGAGTACTCACCAGTCACAGAAAAGCATCTTACGGATGGCATGACAGTAAGAGAATTATGCAGTGCTGCCATAACCATGAGTGATAACACTGCGGCCAACTTACTTCTGACAACGATCGGAGGACCGAAGGAGCTAACCGCTTTTTTGCACAACATGGGGGATCATGTAACCCGCCTTGATCGTTGGGAACCGGAGCTGAATGAAGCCATACCAAACGACGAGCGTGACACCACGATGCCTGCAGCAATGGCAACAACGTTGCGCAAACTATTAACTGGCGAACTACTTACTCTAGCTTCCCGGCAACAATTAATAGACTGGATGGAGGCGGATAAAGTTGCAGGACCACTTCTGCGCTCGGCCCTTCCGGCTGGCTGGTTTATTGCTGATAAATCTGGAGCCGGTGAGCGTGGATCTCGCGGTATCATTGCAGCACTGGGGCCAGATGGTAAGCCCTCCCGTATCGTAGTTATCTACACGACGGGGAGTCAGGCAACTATGGA
gb|KF986254|-|34-859|ARO:3001572|OXA-386 [Acinetobacter baumannii] 	0	770	54149	54919	825	246080-	770	ATGAACATTAAAGCACTCTTACTTATAACAAGCGCTATTTTTATTTCAGCCTGCTCACCTTATATAGTGACTGCTAATCCAAATCACAGCGCTTCAAAATCTGATGTAAAAGCAGAGAAAATTAAAAATTTATTTAACGAAGCACACACTACGGGTGTTTTAGTTATCCAACAAGGCCAAACTCAACAAAGCTATGGTAATGATCTTGCTCGTGCTTCGACCGAGTATGTACCTGCTTCGACCTTCAAAATGCTTAATGCTTTGATCGGCCTTGAGCACCATAAGGCAACCACCACAGAAGTATTTAAGTGGGATGGTAAAAAAAGGTTATTCCCAGAATGGGAAAAGGACATGACCCTAGGCGATGCCATGAAAGCTTCCGCTATTCCAGTTTATCAAGATTTAGCTCGTCGTATTGGACTTGAGCTCATGTCTAAGGAAGTGAAGCGTGTTGGTTATGGCAATGCAGATATCGGTACCCAAGTCGATAATTTTTGGCTGGTGGGTCCTTTAAAAATTACTCCTCAGCAAGAGGCACAGTTTGCTTACAAGCTAGCTAATAAAACGCTTCCATTTAGCCAAAAAGTCCAAGATGAAGTGCAATCCATGCTATTCATAGAAGAAAAGAATGGAAACAAAATATACGCAAAAAGTGGTTGGGGATGGGATGTAAACCCACAAGTAGGCTGGTTAACTGGATGGGTTGTTCAGCCTCAAGGGAATATTGTAGCGTTCTCCCTTAACTTAGAAATGAAAAAAGGAATACCTAG
gb|KP881235.1|+|0-1152|ARO:3003881|ADC-75 [Acinetobacter baumannii] 	0	1097	63	1160	1152	126080+	1097	ATGCGATTTAAAAAAATTTCTTGTCTACTTTTATCCCCGCTTTTTATTTTTAGTACCTCAATTTATGCGGGCAATACACCAAAAGACCAAGAAATTAAAAAACTGGTAGATCAAAACTTTAAACCGTTATTAGAAAAATATGATGTGCCAGGTATGGCTGTGGGTGTTATTCAAAATAATAAAAAGTATGAAATGTATTATGGTCTTCAATCTGTTCAAGATAAAAAAGCCGTAAATAGCAGTACTATTTTTGAGCTAGGTTCTGTCAGTAAATTATTTACCGCGACAGCAGGTGGATATGCAAAAAATAAAGGAAAAATCTCTTTTGACGATACGCCTGGTAAGTATTGGAAAGAACTAAAAAATACACCGATTGACCAAGTTAACTTACTTCAACTCGCGACGTATACAAGTGGTAACCTTGCCTTGCAATTTCCAGATGAAGTAAAAACAGATCAGCAAGTTTTAACATTTTTTAAAGACTGGAAACCTAAAAACTCAATCGGTGAATATCGACAATATTCAAACCCAAGCATTGGTTTATTTGGAAAAGTTGTAGCTTTGTCTATGAATAAACCTTTCGACCAAGTCTTAGAAAAAACAATTTTTCCGGCCCTTGGCTTAAAACATAGCTATGTAAATGTACCTAAGACCCAGATGCAAAACTATGCTTTTGGCTATAACCAAGAAAATCAGCCGATTCGAGTTAACCCCGGCCCACTCGATGCCCCAGCATATGGCGTCAAATCGACACTACCCGACATGTTGAGTTTTATTCATGCCAACCTAAATCCACAAAAATATCCAGCAGATATTCAACGGGCAATTAATGAAACACATCAGGGTCGCTATCAAGTAAATACCATGTATCAGGCACTCGGTTGGGAAGAGTTTTCTTATCCGGCAACGTTACAAACTTTATTAGACAGTAATTCAGAACAGATTGTGATGAAACCTAATAAAGTGACTGCTATTTCAAAGGAACCTTCAGTTAAGATGTACCATAAAACTGGCTCAACTACCGGTTTCGGAACATATGTGGTGTTTATTCCTAAAGAAAATATTGGTTTAGTCATGTTAACCAATAAACGTATTCC
gb|HE963769|+|0-825|ARO:3001673|OXA-248 [Acinetobacter baumannii] 	0	770	54149	54919	825	246080-	770	ATGAACATTAAAGCACTCTTACTTATAACAAGCGCTATTTTTATTTCAGCCTGCTCACCTTATATAGTGACTGCTAATCCAAATCACAGCGCTTCAAAATCTGATGTAAAAGCAGAGAAAATTAAAAATTTATTTAACGAAGCACACACTACGGGTGTTTTAGTTATCCAACAAGGCCAAACTCAACAAAGCTATGGTAATGATCTTGCTCGTGCTTCGACCGAGTATGTACCTGCTTCGACCTTCAAAATGCTTAATGCTTTGATCGGCCTTGAGCACCATAAGGCAACCACCACAGAAGTATTTAAGTGGGATGGTAAAAAAAGGTTATTCCCAGAATGGGAAAAGGACATGACCCTAGGCGATGCCATGAAAGCTTCCGCTATTCCAGTTTATCAAGATTTAGCTCGTCGTATTGGACTTGAGCTCATGTCTAAGGAAGTGAAGCGTGTTGGTTATGGCAATGCAGATATCGGTACCCAAGTCGATAATTTTTGGCTGGTGGGTCCTTTAAAAATTACTCCTCAGCAAGAGGCACAGTTTGCTTACAAGCTAGCTAATAAAACGCTTCCATTTAGCCAAAAAGTCCAAGATGAAGTGCAATCCATGCTATTCATAGAAGAAAAGAATGGAAACAAAATATACGCAAAAAGTGGTTGGGGATGGGATGTAAACCCACAAGTAGGCTGGTTAACTGGATGGGTTGTTCAGCCTCAAGGGAATATTGTAGCGTTCTCCCTTAACTTAGAAATGAAAAAAGGAATACCTAG
gb|AJ318094|+|0-861|ARO:3000961|TEM-94 [Escherichia coli] 	0	806	46	852	861	3478183-	806	ATGAGTATTCAACATTTCCGTGTCGCCCTTATTCCCTTTTTTGCGGCATTTTGCCTTCCTGTTTTTGCTCACCCAGAAACGCTGGTGAAAGTAAAAGATGCTGAAGATCAGTTGGGTGCACGAGTGGGTTACATCGAGCTGGATCTCAACAGCGGTAAGATCCTTGAGAGTTTTCGCCCCGAAGAACGTTTTCCAATGATGAGCACTTTTAAAGTTCTGCTATGTGGTGCGGTATTATCCCGTGTTGACGCCGGGCAAGAGCAACTCGGTCGCCGCATACACTATTCTCAGAATGACTTGGTTGAGTACTCACCAGTCACAGAAAAGCATCTTACGGATGGCATGACAGTAAGAGAATTATGCAGTGCTGCCATAACCATGAGTGATAACACTGCGGCCAACTTACTTCTGACAACGATCGGAGGACCGAAGGAGCTAACCGCTTTTTTGCACAACATGGGGGATCATGTAACCCGCCTTGATCGTTGGGAACCGGAGCTGAATGAAGCCATACCAAACGACGAGCGTGACACCACGATGCCTGCAGCAATGGCAACAACGTTGCGCAAACTATTAACTGGCGAACTACTTACTCTAGCTTCCCGGCAACAATTAATAGACTGGATGGAGGCGGATAAAGTTGCAGGACCACTTCTGCGCTCGGCCCTTCCGGCTGGCTGGTTTATTGCTGATAAATCTGGAGCCGGTGAGCGTGGATCTCGCGGTATCATTGCAGCACTGGGGCCAGATGGTAAGCCCTCCCGTATCGTAGTTATCTACACGACGGGGAGTCAGGCAACTATGGA
gb|GQ149347|+|5269-6130|ARO:3001037|TEM-171 [Escherichia coli] 	0	806	46	852	861	3478183-	806	ATGAGTATTCAACATTTCCGTGTCGCCCTTATTCCCTTTTTTGCGGCATTTTGCCTTCCTGTTTTTGCTCACCCAGAAACGCTGGTGAAAGTAAAAGATGCTGAAGATCAGTTGGGTGCACGAGTGGGTTACATCGAGCTGGATCTCAACAGCGGTAAGATCCTTGAGAGTTTTCGCCCCGAAGAACGTTTTCCAATGATGAGCACTTTTAAAGTTCTGCTATGTGGTGCGGTATTATCCCGTGTTGACGCCGGGCAAGAGCAACTCGGTCGCCGCATACACTATTCTCAGAATGACTTGGTTGAGTACTCACCAGTCACAGAAAAGCATCTTACGGATGGCATGACAGTAAGAGAATTATGCAGTGCTGCCATAACCATGAGTGATAACACTGCGGCCAACTTACTTCTGACAACGATCGGAGGACCGAAGGAGCTAACCGCTTTTTTGCACAACATGGGGGATCATGTAACCCGCCTTGATCGTTGGGAACCGGAGCTGAATGAAGCCATACCAAACGACGAGCGTGACACCACGATGCCTGCAGCAATGGCAACAACGTTGCGCAAACTATTAACTGGCGAACTACTTACTCTAGCTTCCCGGCAACAATTAATAGACTGGATGGAGGCGGATAAAGTTGCAGGACCACTTCTGCGCTCGGCCCTTCCGGCTGGCTGGTTTATTGCTGATAAATCTGGAGCCGGTGAGCGTGGATCTCGCGGTATCATTGCAGCACTGGGGCCAGATGGTAAGCCCTCCCGTATCGTAGTTATCTACACGACGGGGAGTCAGGCAACTATGGA
gb|FR717535|+|0-861|ARO:3000910|TEM-40 [Escherichia coli] 	0	806	46	852	861	3478183-	806	ATGAGTATTCAACATTTCCGTGTCGCCCTTATTCCCTTTTTTGCGGCATTTTGCCTTCCTGTTTTTGCTCACCCAGAAACGCTGGTGAAAGTAAAAGATGCTGAAGATCAGTTGGGTGCACGAGTGGGTTACATCGAGCTGGATCTCAACAGCGGTAAGATCCTTGAGAGTTTTCGCCCCGAAGAACGTTTTCCAATGATGAGCACTTTTAAAGTTCTGCTATGTGGTGCGGTATTATCCCGTGTTGACGCCGGGCAAGAGCAACTCGGTCGCCGCATACACTATTCTCAGAATGACTTGGTTGAGTACTCACCAGTCACAGAAAAGCATCTTACGGATGGCATGACAGTAAGAGAATTATGCAGTGCTGCCATAACCATGAGTGATAACACTGCGGCCAACTTACTTCTGACAACGATCGGAGGACCGAAGGAGCTAACCGCTTTTTTGCACAACATGGGGGATCATGTAACCCGCCTTGATCGTTGGGAACCGGAGCTGAATGAAGCCATACCAAACGACGAGCGTGACACCACGATGCCTGCAGCAATGGCAACAACGTTGCGCAAACTATTAACTGGCGAACTACTTACTCTAGCTTCCCGGCAACAATTAATAGACTGGATGGAGGCGGATAAAGTTGCAGGACCACTTCTGCGCTCGGCCCTTCCGGCTGGCTGGTTTATTGCTGATAAATCTGGAGCCGGTGAGCGTGGATCTCGCGGTATCATTGCAGCACTGGGGCCAGATGGTAAGCCCTCCCGTATCGTAGTTATCTACACGACGGGGAGTCAGGCAACTATGGA
gb|AY368236|+|0-861|ARO:3000989|TEM-127 [Escherichia coli] 	0	806	46	852	861	3478183-	806	ATGAGTATTCAACATTTCCGTGTCGCCCTTATTCCCTTTTTTGCGGCATTTTGCCTTCCTGTTTTTGCTCACCCAGAAACGCTGGTGAAAGTAAAAGATGCTGAAGATCAGTTGGGTGCACGAGTGGGTTACATCGAGCTGGATCTCAACAGCGGTAAGATCCTTGAGAGTTTTCGCCCCGAAGAACGTTTTCCAATGATGAGCACTTTTAAAGTTCTGCTATGTGGTGCGGTATTATCCCGTGTTGACGCCGGGCAAGAGCAACTCGGTCGCCGCATACACTATTCTCAGAATGACTTGGTTGAGTACTCACCAGTCACAGAAAAGCATCTTACGGATGGCATGACAGTAAGAGAATTATGCAGTGCTGCCATAACCATGAGTGATAACACTGCGGCCAACTTACTTCTGACAACGATCGGAGGACCGAAGGAGCTAACCGCTTTTTTGCACAACATGGGGGATCATGTAACCCGCCTTGATCGTTGGGAACCGGAGCTGAATGAAGCCATACCAAACGACGAGCGTGACACCACGATGCCTGCAGCAATGGCAACAACGTTGCGCAAACTATTAACTGGCGAACTACTTACTCTAGCTTCCCGGCAACAATTAATAGACTGGATGGAGGCGGATAAAGTTGCAGGACCACTTCTGCGCTCGGCCCTTCCGGCTGGCTGGTTTATTGCTGATAAATCTGGAGCCGGTGAGCGTGGATCTCGCGGTATCATTGCAGCACTGGGGCCAGATGGTAAGCCCTCCCGTATCGTAGTTATCTACACGACGGGGAGTCAGGCAACTATGGA
gb|AJ308558|+|181-1042|ARO:3000962|TEM-95 [Escherichia coli] 	0	806	46	852	861	3478183-	806	ATGAGTATTCAACATTTCCGTGTCGCCCTTATTCCCTTTTTTGCGGCATTTTGCCTTCCTGTTTTTGCTCACCCAGAAACGCTGGTGAAAGTAAAAGATGCTGAAGATCAGTTGGGTGCACGAGTGGGTTACATCGAGCTGGATCTCAACAGCGGTAAGATCCTTGAGAGTTTTCGCCCCGAAGAACGTTTTCCAATGATGAGCACTTTTAAAGTTCTGCTATGTGGTGCGGTATTATCCCGTGTTGACGCCGGGCAAGAGCAACTCGGTCGCCGCATACACTATTCTCAGAATGACTTGGTTGAGTACTCACCAGTCACAGAAAAGCATCTTACGGATGGCATGACAGTAAGAGAATTATGCAGTGCTGCCATAACCATGAGTGATAACACTGCGGCCAACTTACTTCTGACAACGATCGGAGGACCGAAGGAGCTAACCGCTTTTTTGCACAACATGGGGGATCATGTAACCCGCCTTGATCGTTGGGAACCGGAGCTGAATGAAGCCATACCAAACGACGAGCGTGACACCACGATGCCTGCAGCAATGGCAACAACGTTGCGCAAACTATTAACTGGCGAACTACTTACTCTAGCTTCCCGGCAACAATTAATAGACTGGATGGAGGCGGATAAAGTTGCAGGACCACTTCTGCGCTCGGCCCTTCCGGCTGGCTGGTTTATTGCTGATAAATCTGGAGCCGGTGAGCGTGGATCTCGCGGTATCATTGCAGCACTGGGGCCAGATGGTAAGCCCTCCCGTATCGTAGTTATCTACACGACGGGGAGTCAGGCAACTATGGA
gb|X98047|+|0-844|ARO:3000911|TEM-42 [Pseudomonas aeruginosa] 	0	788	55	843	843	3478183-	788	CAACATTTCCGTGTCGCCCTTATTCCCTTTTTTGCGGCATTTTGCCTTCCTGTTTTTGCTCACCCAGAAACGCTGGTGAAAGTAAAAGATGCTGAAGATCAGTTGGGTGCACGAGTGGGTTACATCGAGCTGGATCTCAACAGCGGTAAGATCCTTGAGAGTTTTCGCCCCGAAGAACGTTTTCCAATGATGAGCACTTTTAAAGTTCTGCTATGTGGTGCGGTATTATCCCGTGTTGACGCCGGGCAAGAGCAACTCGGTCGCCGCATACACTATTCTCAGAATGACTTGGTTGAGTACTCACCAGTCACAGAAAAGCATCTTACGGATGGCATGACAGTAAGAGAATTATGCAGTGCTGCCATAACCATGAGTGATAACACTGCGGCCAACTTACTTCTGACAACGATCGGAGGACCGAAGGAGCTAACCGCTTTTTTGCACAACATGGGGGATCATGTAACCCGCCTTGATCGTTGGGAACCGGAGCTGAATGAAGCCATACCAAACGACGAGCGTGACACCACGATGCCTGCAGCAATGGCAACAACGTTGCGCAAACTATTAACTGGCGAACTACTTACTCTAGCTTCCCGGCAACAATTAATAGACTGGATGGAGGCGGATAAAGTTGCAGGACCACTTCTGCGCTCGGCCCTTCCGGCTGGCTGGTTTATTGCTGATAAATCTGGAGCCGGTGAGCGTGGATCTCGCGGTATCATTGCAGCACTGGGGCCAGATGGTAAGCCCTCCCGTATCGTAGTTATCTACACGACGGGGAGTCAGGC
gb|HE963770|+|0-825|ARO:3001674|OXA-249 [Acinetobacter baumannii] 	0	770	54149	54919	825	246080-	770	ATGAACATTAAAGCACTCTTACTTATAACAAGCGCTATTTTTATTTCAGCCTGCTCACCTTATATAGTGACTGCTAATCCAAATCACAGCGCTTCAAAATCTGATGTAAAAGCAGAGAAAATTAAAAATTTATTTAACGAAGCACACACTACGGGTGTTTTAGTTATCCAACAAGGCCAAACTCAACAAAGCTATGGTAATGATCTTGCTCGTGCTTCGACCGAGTATGTACCTGCTTCGACCTTCAAAATGCTTAATGCTTTGATCGGCCTTGAGCACCATAAGGCAACCACCACAGAAGTATTTAAGTGGGATGGTAAAAAAAGGTTATTCCCAGAATGGGAAAAGGACATGACCCTAGGCGATGCCATGAAAGCTTCCGCTATTCCAGTTTATCAAGATTTAGCTCGTCGTATTGGACTTGAGCTCATGTCTAAGGAAGTGAAGCGTGTTGGTTATGGCAATGCAGATATCGGTACCCAAGTCGATAATTTTTGGCTGGTGGGTCCTTTAAAAATTACTCCTCAGCAAGAGGCACAGTTTGCTTACAAGCTAGCTAATAAAACGCTTCCATTTAGCCAAAAAGTCCAAGATGAAGTGCAATCCATGCTATTCATAGAAGAAAAGAATGGAAACAAAATATACGCAAAAAGTGGTTGGGGATGGGATGTAAACCCACAAGTAGGCTGGTTAACTGGATGGGTTGTTCAGCCTCAAGGGAATATTGTAGCGTTCTCCCTTAACTTAGAAATGAAAAAAGGAATACCTAG
gb|AY368237|+|0-861|ARO:3000990|TEM-128 [Escherichia coli] 	0	806	46	852	861	3478183-	806	ATGAGTATTCAACATTTCCGTGTCGCCCTTATTCCCTTTTTTGCGGCATTTTGCCTTCCTGTTTTTGCTCACCCAGAAACGCTGGTGAAAGTAAAAGATGCTGAAGATCAGTTGGGTGCACGAGTGGGTTACATCGAGCTGGATCTCAACAGCGGTAAGATCCTTGAGAGTTTTCGCCCCGAAGAACGTTTTCCAATGATGAGCACTTTTAAAGTTCTGCTATGTGGTGCGGTATTATCCCGTGTTGACGCCGGGCAAGAGCAACTCGGTCGCCGCATACACTATTCTCAGAATGACTTGGTTGAGTACTCACCAGTCACAGAAAAGCATCTTACGGATGGCATGACAGTAAGAGAATTATGCAGTGCTGCCATAACCATGAGTGATAACACTGCGGCCAACTTACTTCTGACAACGATCGGAGGACCGAAGGAGCTAACCGCTTTTTTGCACAACATGGGGGATCATGTAACCCGCCTTGATCGTTGGGAACCGGAGCTGAATGAAGCCATACCAAACGACGAGCGTGACACCACGATGCCTGCAGCAATGGCAACAACGTTGCGCAAACTATTAACTGGCGAACTACTTACTCTAGCTTCCCGGCAACAATTAATAGACTGGATGGAGGCGGATAAAGTTGCAGGACCACTTCTGCGCTCGGCCCTTCCGGCTGGCTGGTTTATTGCTGATAAATCTGGAGCCGGTGAGCGTGGATCTCGCGGTATCATTGCAGCACTGGGGCCAGATGGTAAGCCCTCCCGTATCGTAGTTATCTACACGACGGGGAGTCAGGCAACTATGGA
gb|AY092401|+|0-861|ARO:3000963|TEM-96 [Escherichia coli] 	0	806	46	852	861	3478183-	806	ATGAGTATTCAACATTTCCGTGTCGCCCTTATTCCCTTTTTTGCGGCATTTTGCCTTCCTGTTTTTGCTCACCCAGAAACGCTGGTGAAAGTAAAAGATGCTGAAGATCAGTTGGGTGCACGAGTGGGTTACATCGAGCTGGATCTCAACAGCGGTAAGATCCTTGAGAGTTTTCGCCCCGAAGAACGTTTTCCAATGATGAGCACTTTTAAAGTTCTGCTATGTGGTGCGGTATTATCCCGTGTTGACGCCGGGCAAGAGCAACTCGGTCGCCGCATACACTATTCTCAGAATGACTTGGTTGAGTACTCACCAGTCACAGAAAAGCATCTTACGGATGGCATGACAGTAAGAGAATTATGCAGTGCTGCCATAACCATGAGTGATAACACTGCGGCCAACTTACTTCTGACAACGATCGGAGGACCGAAGGAGCTAACCGCTTTTTTGCACAACATGGGGGATCATGTAACCCGCCTTGATCGTTGGGAACCGGAGCTGAATGAAGCCATACCAAACGACGAGCGTGACACCACGATGCCTGCAGCAATGGCAACAACGTTGCGCAAACTATTAACTGGCGAACTACTTACTCTAGCTTCCCGGCAACAATTAATAGACTGGATGGAGGCGGATAAAGTTGCAGGACCACTTCTGCGCTCGGCCCTTCCGGCTGGCTGGTTTATTGCTGATAAATCTGGAGCCGGTGAGCGTGGATCTCGCGGTATCATTGCAGCACTGGGGCCAGATGGTAAGCCCTCCCGTATCGTAGTTATCTACACGACGGGGAGTCAGGCAACTATGGA
gb|KJ173478|+|0-825|ARO:3001573|OXA-387 [Acinetobacter baumannii] 	0	770	54149	54919	825	246080-	770	ATGAACATTAAAGCACTCTTACTTATAACAAGCGCTATTTTTATTTCAGCCTGCTCACCTTATATAGTGACTGCTAATCCAAATCACAGCGCTTCAAAATCTGATGTAAAAGCAGAGAAAATTAAAAATTTATTTAACGAAGCACACACTACGGGTGTTTTAGTTATCCAACAAGGCCAAACTCAACAAAGCTATGGTAATGATCTTGCTCGTGCTTCGACCGAGTATGTACCTGCTTCGACCTTCAAAATGCTTAATGCTTTGATCGGCCTTGAGCACCATAAGGCAACCACCACAGAAGTATTTAAGTGGGATGGTAAAAAAAGGTTATTCCCAGAATGGGAAAAGGACATGACCCTAGGCGATGCCATGAAAGCTTCCGCTATTCCAGTTTATCAAGATTTAGCTCGTCGTATTGGACTTGAGCTCATGTCTAAGGAAGTGAAGCGTGTTGGTTATGGCAATGCAGATATCGGTACCCAAGTCGATAATTTTTGGCTGGTGGGTCCTTTAAAAATTACTCCTCAGCAAGAGGCACAGTTTGCTTACAAGCTAGCTAATAAAACGCTTCCATTTAGCCAAAAAGTCCAAGATGAAGTGCAATCCATGCTATTCATAGAAGAAAAGAATGGAAACAAAATATACGCAAAAAGTGGTTGGGGATGGGATGTAAACCCACAAGTAGGCTGGTTAACTGGATGGGTTGTTCAGCCTCAAGGGAATATTGTAGCGTTCTCCCTTAACTTAGAAATGAAAAAAGGAATACCTAG
gb|AJ746225|+|0-861|ARO:3000993|TEM-129 [Klebsiella oxytoca] 	0	806	46	852	861	3478183-	806	ATGAGTATTCAACATTTCCGTGTCGCCCTTATTCCCTTTTTTGCGGCATTTTGCCTTCCTGTTTTTGCTCACCCAGAAACGCTGGTGAAAGTAAAAGATGCTGAAGATCAGTTGGGTGCACGAGTGGGTTACATCGAGCTGGATCTCAACAGCGGTAAGATCCTTGAGAGTTTTCGCCCCGAAGAACGTTTTCCAATGATGAGCACTTTTAAAGTTCTGCTATGTGGTGCGGTATTATCCCGTGTTGACGCCGGGCAAGAGCAACTCGGTCGCCGCATACACTATTCTCAGAATGACTTGGTTGAGTACTCACCAGTCACAGAAAAGCATCTTACGGATGGCATGACAGTAAGAGAATTATGCAGTGCTGCCATAACCATGAGTGATAACACTGCGGCCAACTTACTTCTGACAACGATCGGAGGACCGAAGGAGCTAACCGCTTTTTTGCACAACATGGGGGATCATGTAACCCGCCTTGATCGTTGGGAACCGGAGCTGAATGAAGCCATACCAAACGACGAGCGTGACACCACGATGCCTGCAGCAATGGCAACAACGTTGCGCAAACTATTAACTGGCGAACTACTTACTCTAGCTTCCCGGCAACAATTAATAGACTGGATGGAGGCGGATAAAGTTGCAGGACCACTTCTGCGCTCGGCCCTTCCGGCTGGCTGGTTTATTGCTGATAAATCTGGAGCCGGTGAGCGTGGATCTCGCGGTATCATTGCAGCACTGGGGCCAGATGGTAAGCCCTCCCGTATCGTAGTTATCTACACGACGGGGAGTCAGGCAACTATGGA
gb|U95363|+|0-861|ARO:3000912|TEM-43 [Klebsiella pneumoniae] 	0	806	46	852	861	3478183-	806	ATGAGTATTCAACATTTCCGTGTCGCCCTTATTCCCTTTTTTGCGGCATTTTGCCTTCCTGTTTTTGCTCACCCAGAAACGCTGGTGAAAGTAAAAGATGCTGAAGATCAGTTGGGTGCACGAGTGGGTTACATCGAGCTGGATCTCAACAGCGGTAAGATCCTTGAGAGTTTTCGCCCCGAAGAACGTTTTCCAATGATGAGCACTTTTAAAGTTCTGCTATGTGGTGCGGTATTATCCCGTGTTGACGCCGGGCAAGAGCAACTCGGTCGCCGCATACACTATTCTCAGAATGACTTGGTTGAGTACTCACCAGTCACAGAAAAGCATCTTACGGATGGCATGACAGTAAGAGAATTATGCAGTGCTGCCATAACCATGAGTGATAACACTGCGGCCAACTTACTTCTGACAACGATCGGAGGACCGAAGGAGCTAACCGCTTTTTTGCACAACATGGGGGATCATGTAACCCGCCTTGATCGTTGGGAACCGGAGCTGAATGAAGCCATACCAAACGACGAGCGTGACACCACGATGCCTGCAGCAATGGCAACAACGTTGCGCAAACTATTAACTGGCGAACTACTTACTCTAGCTTCCCGGCAACAATTAATAGACTGGATGGAGGCGGATAAAGTTGCAGGACCACTTCTGCGCTCGGCCCTTCCGGCTGGCTGGTTTATTGCTGATAAATCTGGAGCCGGTGAGCGTGGATCTCGCGGTATCATTGCAGCACTGGGGCCAGATGGTAAGCCCTCCCGTATCGTAGTTATCTACACGACGGGGAGTCAGGCAACTATGGA
gb|GU550123|+|144-1005|ARO:3001041|TEM-176 [Escherichia coli] 	0	806	46	852	861	3478183-	806	ATGAGTATTCAACATTTCCGTGTCGCCCTTATTCCCTTTTTTGCGGCATTTTGCCTTCCTGTTTTTGCTCACCCAGAAACGCTGGTGAAAGTAAAAGATGCTGAAGATCAGTTGGGTGCACGAGTGGGTTACATCGAGCTGGATCTCAACAGCGGTAAGATCCTTGAGAGTTTTCGCCCCGAAGAACGTTTTCCAATGATGAGCACTTTTAAAGTTCTGCTATGTGGTGCGGTATTATCCCGTGTTGACGCCGGGCAAGAGCAACTCGGTCGCCGCATACACTATTCTCAGAATGACTTGGTTGAGTACTCACCAGTCACAGAAAAGCATCTTACGGATGGCATGACAGTAAGAGAATTATGCAGTGCTGCCATAACCATGAGTGATAACACTGCGGCCAACTTACTTCTGACAACGATCGGAGGACCGAAGGAGCTAACCGCTTTTTTGCACAACATGGGGGATCATGTAACCCGCCTTGATCGTTGGGAACCGGAGCTGAATGAAGCCATACCAAACGACGAGCGTGACACCACGATGCCTGCAGCAATGGCAACAACGTTGCGCAAACTATTAACTGGCGAACTACTTACTCTAGCTTCCCGGCAACAATTAATAGACTGGATGGAGGCGGATAAAGTTGCAGGACCACTTCTGCGCTCGGCCCTTCCGGCTGGCTGGTTTATTGCTGATAAATCTGGAGCCGGTGAGCGTGGATCTCGCGGTATCATTGCAGCACTGGGGCCAGATGGTAAGCCCTCCCGTATCGTAGTTATCTACACGACGGGGAGTCAGGCAACTATGGA
gb|X95401|+|208-1069|ARO:3000914|TEM-45 [Escherichia coli] 	0	806	46	852	861	3478183-	806	ATGAGTATTCAACATTTCCGTGTCGCCCTTATTCCCTTTTTTGCGGCATTTTGCCTTCCTGTTTTTGCTCACCCAGAAACGCTGGTGAAAGTAAAAGATGCTGAAGATCAGTTGGGTGCACGAGTGGGTTACATCGAGCTGGATCTCAACAGCGGTAAGATCCTTGAGAGTTTTCGCCCCGAAGAACGTTTTCCAATGATGAGCACTTTTAAAGTTCTGCTATGTGGTGCGGTATTATCCCGTGTTGACGCCGGGCAAGAGCAACTCGGTCGCCGCATACACTATTCTCAGAATGACTTGGTTGAGTACTCACCAGTCACAGAAAAGCATCTTACGGATGGCATGACAGTAAGAGAATTATGCAGTGCTGCCATAACCATGAGTGATAACACTGCGGCCAACTTACTTCTGACAACGATCGGAGGACCGAAGGAGCTAACCGCTTTTTTGCACAACATGGGGGATCATGTAACCCGCCTTGATCGTTGGGAACCGGAGCTGAATGAAGCCATACCAAACGACGAGCGTGACACCACGATGCCTGCAGCAATGGCAACAACGTTGCGCAAACTATTAACTGGCGAACTACTTACTCTAGCTTCCCGGCAACAATTAATAGACTGGATGGAGGCGGATAAAGTTGCAGGACCACTTCTGCGCTCGGCCCTTCCGGCTGGCTGGTTTATTGCTGATAAATCTGGAGCCGGTGAGCGTGGATCTCGCGGTATCATTGCAGCACTGGGGCCAGATGGTAAGCCCTCCCGTATCGTAGTTATCTACACGACGGGGAGTCAGGCAACTATGGA
gb|AF441287|+|260-1007|ARO:3000844|TUS-1_beta-lactamase [Myroides odoratus DSM 2801] 	0	692	12189	12881	747	1531004-	692	ATGTACCACTACTTTAGCAGTTTATTTGTACTGATTTTTTCTACTTTGGTCTATCCTCAATCGGATAAATTAAAAATTGAGCCGTTGAACGATCATATGTATGTCTATACGACCTACCAAGTATTTCAAGGCGTCGAATATTCTTCCAATGCTTTATATGTAGTGACGGATGAAGGAGTAATTCTCATTGATACCCCTTGGGATAAAGATCAGTACGCCCCTTTAGTAGAACACATCAGACGTGAACATAACAAAGAAATAAAATGGGTCATTACCACTCACTTCCACGAAGATCGTTCGGGTGGACTTGATTACTTCAATAAAGCTGGAGCAGAAACCTATACTTATGCTTTGACCAACGAAATCTTAAAACAGCGCAATGAACCACAAGCGACTTTTACTTTTGGTTCAACAAAGCAGTTCAACTTGGGCAAAGAAAAAATAGAGGTCTATTTCTTAGGAGAAGGTCATAGTAAAGATAATACGGTGGTTTGGTTTCCAGAAGAAGCGATTTTATACGGTGGTTGTTTGATTAAAAGTGCAGAGGCAACGACTATCGGCAATATCGTCGATGGCAATGTAGAGGCTTGGCCTACGACAATCAAAGCCGTAAAGCGCAAATTCAAAAAGGCCAAAGTGATTATTCCAGGGCATGATGCCTGGAATCAATCCGGTCATCTTGAAAATACAGC
gb|AJ866988|+|0-861|ARO:3000994|TEM-130 [Klebsiella pneumoniae] 	0	806	46	852	861	3478183-	806	ATGAGTATTCAACATTTCCGTGTCGCCCTTATTCCCTTTTTTGCGGCATTTTGCCTTCCTGTTTTTGCTCACCCAGAAACGCTGGTGAAAGTAAAAGATGCTGAAGATCAGTTGGGTGCACGAGTGGGTTACATCGAGCTGGATCTCAACAGCGGTAAGATCCTTGAGAGTTTTCGCCCCGAAGAACGTTTTCCAATGATGAGCACTTTTAAAGTTCTGCTATGTGGTGCGGTATTATCCCGTGTTGACGCCGGGCAAGAGCAACTCGGTCGCCGCATACACTATTCTCAGAATGACTTGGTTGAGTACTCACCAGTCACAGAAAAGCATCTTACGGATGGCATGACAGTAAGAGAATTATGCAGTGCTGCCATAACCATGAGTGATAACACTGCGGCCAACTTACTTCTGACAACGATCGGAGGACCGAAGGAGCTAACCGCTTTTTTGCACAACATGGGGGATCATGTAACCCGCCTTGATCGTTGGGAACCGGAGCTGAATGAAGCCATACCAAACGACGAGCGTGACACCACGATGCCTGCAGCAATGGCAACAACGTTGCGCAAACTATTAACTGGCGAACTACTTACTCTAGCTTCCCGGCAACAATTAATAGACTGGATGGAGGCGGATAAAGTTGCAGGACCACTTCTGCGCTCGGCCCTTCCGGCTGGCTGGTTTATTGCTGATAAATCTGGAGCCGGTGAGCGTGGATCTCGCGGTATCATTGCAGCACTGGGGCCAGATGGTAAGCCCTCCCGTATCGTAGTTATCTACACGACGGGGAGTCAGGCAACTATGGA
gb|KR057757.1|+|0-1110|ARO:3004351|PDC-88 [Pseudomonas aeruginosa] 	0	1055	35591	36652	1110	232416+	1061	GATGAGGCCCCGGCGGATCGCCTGAAGGCACTGGTCGACGCCGCCGTACAACCGGTGATGAAGGCCAATGACATTCCGGGCCTGGCCGTAGCCATCAGCCTGAAAGGAGAACCGCATTACTTCAGCTATGGGCTGGCCTCGAAAGAGGACGGCCGCCGGGTGACGCCGGAGACCCTGTTCGAGATCGGCTCGGTGAGCAAGACCTTCACCGTCACCCTCGCCGGCTATGCCCTGGCCCAGGACAAGATGCGCCTCGACGACCGCGCCAGCCAGCACTGGCCGGCACTGCAGGGCAGCCGCTTCGACGGCATCAGCCTGCTCGACCTCGCGACCTATACCGCCGGCGGCTTGCCGCTGCAGTTCCCCGACTCGGTGCAGAAGGACCAGGCACAGATCCGCGACTACTACCGCCAGTGGCAGCCGACCTACGCGCCGGGCAGCCAGCGCCTCTATTCCAACCCGAGCATCGGCCTGTTCGGCTATCTCGCCGCGCGCAGCCTGGGCCAGCCGTTCGAACGGCTCATGGAGCAGCAATTGTTCCCGGCACTGGGCCTCGAACAGACCCACCTCGACGTGCCCGAGGCGGCGCTGGCGCAGTACGCCCAGGGCTACGGCAAGGACGACCGCCCGCTACGGGTCGGTCCCGGCCCGCTGGATGCCGAAGGCTACGGGGTGAAGACCAGCGCGGCCGACCTGCTGCGCTTCGTCGATGCCAACCTGCATCCGGAGCGCCTGGACAGGCCCTGGGCGCAGGCGCTCGATGCCACCCATCGCGGTTACTACAAGGTCGGCGACATGACCCAGGGCCTGGGCTGGGAAGCCTACGACTGGCCGATCTCCCTGAAGCGCCTGCAGGCCGGCAACTCGACGCCGATGGCGCTGCAACCACACAGGATCGCCAGGCTGCCCGCGCCACAGGCGCTGGAGGGCCAGCGCCTGCTGAACAAGACCGGCTCCACCAACGGCTTCGGCGCCTACGTGGCGTTCGTCCCGGGCCGCGACCTGGGCCTGGTGATCCTGGCCAACCGCAACTATCCCAATGCCGAGCGGGTGAAGATCGC
gb|AY436361|+|131-992|ARO:3000995|TEM-131 [Salmonella enterica subsp. enterica serovar Typhimurium] 	0	806	46	852	861	3478183-	806	ATGAGTATTCAACATTTCCGTGTCGCCCTTATTCCCTTTTTTGCGGCATTTTGCCTTCCTGTTTTTGCTCACCCAGAAACGCTGGTGAAAGTAAAAGATGCTGAAGATCAGTTGGGTGCACGAGTGGGTTACATCGAGCTGGATCTCAACAGCGGTAAGATCCTTGAGAGTTTTCGCCCCGAAGAACGTTTTCCAATGATGAGCACTTTTAAAGTTCTGCTATGTGGTGCGGTATTATCCCGTGTTGACGCCGGGCAAGAGCAACTCGGTCGCCGCATACACTATTCTCAGAATGACTTGGTTGAGTACTCACCAGTCACAGAAAAGCATCTTACGGATGGCATGACAGTAAGAGAATTATGCAGTGCTGCCATAACCATGAGTGATAACACTGCGGCCAACTTACTTCTGACAACGATCGGAGGACCGAAGGAGCTAACCGCTTTTTTGCACAACATGGGGGATCATGTAACCCGCCTTGATCGTTGGGAACCGGAGCTGAATGAAGCCATACCAAACGACGAGCGTGACACCACGATGCCTGCAGCAATGGCAACAACGTTGCGCAAACTATTAACTGGCGAACTACTTACTCTAGCTTCCCGGCAACAATTAATAGACTGGATGGAGGCGGATAAAGTTGCAGGACCACTTCTGCGCTCGGCCCTTCCGGCTGGCTGGTTTATTGCTGATAAATCTGGAGCCGGTGAGCGTGGATCTCGCGGTATCATTGCAGCACTGGGGCCAGATGGTAAGCCCTCCCGTATCGTAGTTATCTACACGACGGGGAGTCAGGCAACTATGGA
gb|HE963771|+|0-825|ARO:3001675|OXA-250 [Acinetobacter baumannii] 	0	770	54149	54919	825	246080-	770	ATGAACATTAAAGCACTCTTACTTATAACAAGCGCTATTTTTATTTCAGCCTGCTCACCTTATATAGTGACTGCTAATCCAAATCACAGCGCTTCAAAATCTGATGTAAAAGCAGAGAAAATTAAAAATTTATTTAACGAAGCACACACTACGGGTGTTTTAGTTATCCAACAAGGCCAAACTCAACAAAGCTATGGTAATGATCTTGCTCGTGCTTCGACCGAGTATGTACCTGCTTCGACCTTCAAAATGCTTAATGCTTTGATCGGCCTTGAGCACCATAAGGCAACCACCACAGAAGTATTTAAGTGGGATGGTAAAAAAAGGTTATTCCCAGAATGGGAAAAGGACATGACCCTAGGCGATGCCATGAAAGCTTCCGCTATTCCAGTTTATCAAGATTTAGCTCGTCGTATTGGACTTGAGCTCATGTCTAAGGAAGTGAAGCGTGTTGGTTATGGCAATGCAGATATCGGTACCCAAGTCGATAATTTTTGGCTGGTGGGTCCTTTAAAAATTACTCCTCAGCAAGAGGCACAGTTTGCTTACAAGCTAGCTAATAAAACGCTTCCATTTAGCCAAAAAGTCCAAGATGAAGTGCAATCCATGCTATTCATAGAAGAAAAGAATGGAAACAAAATATACGCAAAAAGTGGTTGGGGATGGGATGTAAACCCACAAGTAGGCTGGTTAACTGGATGGGTTGTTCAGCCTCAAGGGAATATTGTAGCGTTCTCCCTTAACTTAGAAATGAAAAAAGGAATACCTAG
gb|AE003852.1|+|1674272-1675445|ARO:3004289|Vibrio_cholerae_varG [Vibrio cholerae O1 biovar El Tor str. N16961] 	0	1118	676	1794	1173	51789923-	1118	ATGTTTGTTTCTCATTTATCTTTTCCCCACCTGATTGAGGAGAGAAAAATGAAACTATCCACCTTAGCTTTAGCCCCTATTACTGCAGCACTACTTACTTTTAATGCAAGTGCTAAAGGCCATGACCACGACAATCAACGCGCGATTTTTTTCCCTGGTGAAACTGTTCAAGACACTGTGAAAGTCGAAGTTGAGCCTTCTGCGACTCAGTCTCTGAAACTGGGACAAAAAATTAATAATCTGTATGAGCGCCAGTTTGATAACAGCCAAGCCACCGTTCAAAAATTGGGCAAGAATACCTACTGGATAGGGGTCAATTATTACAACGCTACCGTTGTGGTTAACGAAGACTCTGTCTTGCTGATTGACCCACTAGGCGATGGTCGTATTGATGCGCTTTTTAAAGGGGTGCAATCCATCACGAATAAACCGATCACTACGATTATGTATTCTCACTACCACTTAGATCATTTAGGTGGTGGCAACCAACTGGTTGACTTAATTAAGAAAAATTATCCAAAAGTAGATAAAATCCGCGTTATTGCTAGCCAAACCGTTGCGGACAAGATCAACCAACACGCCGAAGTAGGCGAAAACGGTGTGAAAACCCCGAAAGTTCCAGCGCCGAATGACATATACGACCTGACGAAGCCTCAAACGGTTCAATTTGGCTCAATGAAAATCAAGATGATGGCACCAAAAGGCTCTGGCCATACACCTGATAACACCATGATTCTGATCCCAAGCGATCGCGTGTTGCATTTCGCGGACATGATTAATCCCGATCAACTACCGTTTTACAATTTCGCGGGAGCAGAACATTTCCACGGTTACGAAGAAGATCTACAAAGCCTTCTGAGCAAACCGCTGAGCAAACAGTGGGACTTTATTAACGGTGGCCATGGCAATATAGGTTCGAAACAGGATGTAAAAGATCTGCTTGAGTATATTGCGGACATCAGAACTGAAGTGGGCAAGCAGCTAGAAGTCGCCCCCTACACTCCAGTGTTGAGTGACGGTAACCACTTTGTTTGGTTCAAACGCTGGCAAGATGAGATCACTAACAATGTACATACCGCACTGGCAAACAAGTATGGCCACATGTACGGTTTCGATTC
gb|Y10279|+|0-861|ARO:3000916|TEM-47 [Klebsiella pneumoniae] 	0	806	46	852	861	3478183-	806	ATGAGTATTCAACATTTCCGTGTCGCCCTTATTCCCTTTTTTGCGGCATTTTGCCTTCCTGTTTTTGCTCACCCAGAAACGCTGGTGAAAGTAAAAGATGCTGAAGATCAGTTGGGTGCACGAGTGGGTTACATCGAGCTGGATCTCAACAGCGGTAAGATCCTTGAGAGTTTTCGCCCCGAAGAACGTTTTCCAATGATGAGCACTTTTAAAGTTCTGCTATGTGGTGCGGTATTATCCCGTGTTGACGCCGGGCAAGAGCAACTCGGTCGCCGCATACACTATTCTCAGAATGACTTGGTTGAGTACTCACCAGTCACAGAAAAGCATCTTACGGATGGCATGACAGTAAGAGAATTATGCAGTGCTGCCATAACCATGAGTGATAACACTGCGGCCAACTTACTTCTGACAACGATCGGAGGACCGAAGGAGCTAACCGCTTTTTTGCACAACATGGGGGATCATGTAACCCGCCTTGATCGTTGGGAACCGGAGCTGAATGAAGCCATACCAAACGACGAGCGTGACACCACGATGCCTGCAGCAATGGCAACAACGTTGCGCAAACTATTAACTGGCGAACTACTTACTCTAGCTTCCCGGCAACAATTAATAGACTGGATGGAGGCGGATAAAGTTGCAGGACCACTTCTGCGCTCGGCCCTTCCGGCTGGCTGGTTTATTGCTGATAAATCTGGAGCCGGTGAGCGTGGATCTCGCGGTATCATTGCAGCACTGGGGCCAGATGGTAAGCCCTCCCGTATCGTAGTTATCTACACGACGGGGAGTCAGGCAACTATGGA
gb|AY491682|+|0-861|ARO:3000996|TEM-132 [Klebsiella pneumoniae] 	0	806	46	852	861	3478183-	806	ATGAGTATTCAACATTTCCGTGTCGCCCTTATTCCCTTTTTTGCGGCATTTTGCCTTCCTGTTTTTGCTCACCCAGAAACGCTGGTGAAAGTAAAAGATGCTGAAGATCAGTTGGGTGCACGAGTGGGTTACATCGAGCTGGATCTCAACAGCGGTAAGATCCTTGAGAGTTTTCGCCCCGAAGAACGTTTTCCAATGATGAGCACTTTTAAAGTTCTGCTATGTGGTGCGGTATTATCCCGTGTTGACGCCGGGCAAGAGCAACTCGGTCGCCGCATACACTATTCTCAGAATGACTTGGTTGAGTACTCACCAGTCACAGAAAAGCATCTTACGGATGGCATGACAGTAAGAGAATTATGCAGTGCTGCCATAACCATGAGTGATAACACTGCGGCCAACTTACTTCTGACAACGATCGGAGGACCGAAGGAGCTAACCGCTTTTTTGCACAACATGGGGGATCATGTAACCCGCCTTGATCGTTGGGAACCGGAGCTGAATGAAGCCATACCAAACGACGAGCGTGACACCACGATGCCTGCAGCAATGGCAACAACGTTGCGCAAACTATTAACTGGCGAACTACTTACTCTAGCTTCCCGGCAACAATTAATAGACTGGATGGAGGCGGATAAAGTTGCAGGACCACTTCTGCGCTCGGCCCTTCCGGCTGGCTGGTTTATTGCTGATAAATCTGGAGCCGGTGAGCGTGGATCTCGCGGTATCATTGCAGCACTGGGGCCAGATGGTAAGCCCTCCCGTATCGTAGTTATCTACACGACGGGGAGTCAGGCAACTATGGA
gb|KJ135343|+|14-839|ARO:3001574|OXA-388 [Acinetobacter baumannii] 	0	770	54149	54919	825	246080-	770	ATGAACATTAAAGCACTCTTACTTATAACAAGCGCTATTTTTATTTCAGCCTGCTCACCTTATATAGTGACTGCTAATCCAAATCACAGCGCTTCAAAATCTGATGTAAAAGCAGAGAAAATTAAAAATTTATTTAACGAAGCACACACTACGGGTGTTTTAGTTATCCAACAAGGCCAAACTCAACAAAGCTATGGTAATGATCTTGCTCGTGCTTCGACCGAGTATGTACCTGCTTCGACCTTCAAAATGCTTAATGCTTTGATCGGCCTTGAGCACCATAAGGCAACCACCACAGAAGTATTTAAGTGGGATGGTAAAAAAAGGTTATTCCCAGAATGGGAAAAGGACATGACCCTAGGCGATGCCATGAAAGCTTCCGCTATTCCAGTTTATCAAGATTTAGCTCGTCGTATTGGACTTGAGCTCATGTCTAAGGAAGTGAAGCGTGTTGGTTATGGCAATGCAGATATCGGTACCCAAGTCGATAATTTTTGGCTGGTGGGTCCTTTAAAAATTACTCCTCAGCAAGAGGCACAGTTTGCTTACAAGCTAGCTAATAAAACGCTTCCATTTAGCCAAAAAGTCCAAGATGAAGTGCAATCCATGCTATTCATAGAAGAAAAGAATGGAAACAAAATATACGCAAAAAGTGGTTGGGGATGGGATGTAAACCCACAAGTAGGCTGGTTAACTGGATGGGTTGTTCAGCCTCAAGGGAATATTGTAGCGTTCTCCCTTAACTTAGAAATGAAAAAAGGAATACCTAG
gb|Y10280|+|0-861|ARO:3000917|TEM-48 [Klebsiella pneumoniae] 	0	806	46	852	861	3478183-	806	ATGAGTATTCAACATTTCCGTGTCGCCCTTATTCCCTTTTTTGCGGCATTTTGCCTTCCTGTTTTTGCTCACCCAGAAACGCTGGTGAAAGTAAAAGATGCTGAAGATCAGTTGGGTGCACGAGTGGGTTACATCGAGCTGGATCTCAACAGCGGTAAGATCCTTGAGAGTTTTCGCCCCGAAGAACGTTTTCCAATGATGAGCACTTTTAAAGTTCTGCTATGTGGTGCGGTATTATCCCGTGTTGACGCCGGGCAAGAGCAACTCGGTCGCCGCATACACTATTCTCAGAATGACTTGGTTGAGTACTCACCAGTCACAGAAAAGCATCTTACGGATGGCATGACAGTAAGAGAATTATGCAGTGCTGCCATAACCATGAGTGATAACACTGCGGCCAACTTACTTCTGACAACGATCGGAGGACCGAAGGAGCTAACCGCTTTTTTGCACAACATGGGGGATCATGTAACCCGCCTTGATCGTTGGGAACCGGAGCTGAATGAAGCCATACCAAACGACGAGCGTGACACCACGATGCCTGCAGCAATGGCAACAACGTTGCGCAAACTATTAACTGGCGAACTACTTACTCTAGCTTCCCGGCAACAATTAATAGACTGGATGGAGGCGGATAAAGTTGCAGGACCACTTCTGCGCTCGGCCCTTCCGGCTGGCTGGTTTATTGCTGATAAATCTGGAGCCGGTGAGCGTGGATCTCGCGGTATCATTGCAGCACTGGGGCCAGATGGTAAGCCCTCCCGTATCGTAGTTATCTACACGACGGGGAGTCAGGCAACTATGGA
gb|FN652295|+|0-861|ARO:3001042|TEM-177 [Proteus mirabilis] 	0	806	46	852	861	3478183-	806	ATGAGTATTCAACATTTCCGTGTCGCCCTTATTCCCTTTTTTGCGGCATTTTGCCTTCCTGTTTTTGCTCACCCAGAAACGCTGGTGAAAGTAAAAGATGCTGAAGATCAGTTGGGTGCACGAGTGGGTTACATCGAGCTGGATCTCAACAGCGGTAAGATCCTTGAGAGTTTTCGCCCCGAAGAACGTTTTCCAATGATGAGCACTTTTAAAGTTCTGCTATGTGGTGCGGTATTATCCCGTGTTGACGCCGGGCAAGAGCAACTCGGTCGCCGCATACACTATTCTCAGAATGACTTGGTTGAGTACTCACCAGTCACAGAAAAGCATCTTACGGATGGCATGACAGTAAGAGAATTATGCAGTGCTGCCATAACCATGAGTGATAACACTGCGGCCAACTTACTTCTGACAACGATCGGAGGACCGAAGGAGCTAACCGCTTTTTTGCACAACATGGGGGATCATGTAACCCGCCTTGATCGTTGGGAACCGGAGCTGAATGAAGCCATACCAAACGACGAGCGTGACACCACGATGCCTGCAGCAATGGCAACAACGTTGCGCAAACTATTAACTGGCGAACTACTTACTCTAGCTTCCCGGCAACAATTAATAGACTGGATGGAGGCGGATAAAGTTGCAGGACCACTTCTGCGCTCGGCCCTTCCGGCTGGCTGGTTTATTGCTGATAAATCTGGAGCCGGTGAGCGTGGATCTCGCGGTATCATTGCAGCACTGGGGCCAGATGGTAAGCCCTCCCGTATCGTAGTTATCTACACGACGGGGAGTCAGGCAACTATGGA
gb|JN118546|+|1761-2562|ARO:3001500|OXA-251 [Pseudomonas aeruginosa] 	0	746	659	1405	801	104604+	746	ATGAAAACATTTGCCGCATATGTAATTATCGCGTGTCTTTCGAGTACGGCATTAGCTGGTTCAATTACAGAAAATACGTCTTGGAACAAAGAGTTCTCTGCCGAAGCCGTCAATGGTGTCTTCGTGCTTTGTAAAAGTAGCAGTAAATCCTGCGCTACCAATGACTTAGCTCGTGCATCAAAGGAATATCTTCCAGCATCAACATTTAAGATCCCCAACGCAATTATCGGCCTAGAAACTGGTGTCATAAAGAATGAGCATCAGGTTTTCAAATGGGACGGAAAGCCAAGAGCCATGAAGCAATGGGAAAGAGACTTGACCTTAAGAGGGGCAATACAAGTTTCAGCTGTTCCCGTATTTCAACAAATCGCCAGAGAAGTTGGCGAAGTAAGAATGCAGAAATACCTTAAAAAATTTTCCTATGGCAACCAGAATATCAGTGGTGGCATTGACAAATTCTGGTTGGAAGGCCAGCTTAGAATTTCCGCAGTTAATCAAGTGGAGTTTCTAGAGTCTCTATATTTAAATAAATTGTCAGCATCTAAAGAAAACCAGCTAATAGTAAAAGAGGCTTTGGTAACGGAGGCGGCACCTGAATATCTAGTGCATTCAAAAACTGGTTTTTCTGGTGTGGGAACTGAGTCAAATCCTGGTGTCGCATGGTGGGTTGGGTGGGTTGAGAAGGAGACAGAGGTTTACTTTTTCGCCTTTAACATGGATATAGACAACGAAAGTAAGTTGCCGCT
gb|AF550679.1|-|80976-81768|ARO:3002601|aadA [Escherichia coli] 	0	737	10	747	792	104600-	737	ATGAGGGAAGCGGTGATCGCCGAAGTATCGACTCAACTATCAGAGGTAGTTGGCGTCATCGAGCGCCATCTCGAACCGACGTTGCTGGCCGTACATTTGTACGGCTCCGCAGTGGATGGCGGCCTGAAGCCACACAGTGATATTGATTTGCTGGTTACGGTGACCGTAAGGCTTGATGAAACAACGCGGCGAGCTTTGATCAACGACCTTTTGGAAACTTCGGCTTCCCCTGGAGAGAGCGAGATTCTCCGCGCTGTAGAAGTCACCATTGTTGTGCACGACGACATCATTCCGTGGCGTTATCCAGCTAAGCGCGAACTGCAATTTGGAGAATGGCAGCGCAATGACATTCTTGCAGGTATCTTCGAGCCAGCCACGATCGACATTGATCTGGCTATCTTGCTGACAAAAGCAAGAGAACATAGCGTTGCCTTGGTAGGTCCAGCGGCGGAGGAACTCTTTGATCCGGTTCCTGAACAGGATCTATTTGAGGCGCTAAATGAAACCTTAACGCTATGGAACTCGCCGCCCGACTGGGCTGGCGATGAGCGAAATGTAGTGCTTACGTTGTCCCGCATTTGGTACAGCGCAGTAACCGGCAAAATCGCGCCGAAGGATGTCGCTGCCGACTGGGCAATGGAGCGCCTGCCGGCCCAGTATCAGCCCGTCATACTTGAAGCTAGACAGGCTTATCTTGGACAAGAAGAAGATCGCTTGGCCTCGCGCGCAGATCAGTT
gb|AY528425|+|0-861|ARO:3000997|TEM-133 [Klebsiella pneumoniae] 	0	806	46	852	861	3478183-	806	ATGAGTATTCAACATTTCCGTGTCGCCCTTATTCCCTTTTTTGCGGCATTTTGCCTTCCTGTTTTTGCTCACCCAGAAACGCTGGTGAAAGTAAAAGATGCTGAAGATCAGTTGGGTGCACGAGTGGGTTACATCGAGCTGGATCTCAACAGCGGTAAGATCCTTGAGAGTTTTCGCCCCGAAGAACGTTTTCCAATGATGAGCACTTTTAAAGTTCTGCTATGTGGTGCGGTATTATCCCGTGTTGACGCCGGGCAAGAGCAACTCGGTCGCCGCATACACTATTCTCAGAATGACTTGGTTGAGTACTCACCAGTCACAGAAAAGCATCTTACGGATGGCATGACAGTAAGAGAATTATGCAGTGCTGCCATAACCATGAGTGATAACACTGCGGCCAACTTACTTCTGACAACGATCGGAGGACCGAAGGAGCTAACCGCTTTTTTGCACAACATGGGGGATCATGTAACCCGCCTTGATCGTTGGGAACCGGAGCTGAATGAAGCCATACCAAACGACGAGCGTGACACCACGATGCCTGCAGCAATGGCAACAACGTTGCGCAAACTATTAACTGGCGAACTACTTACTCTAGCTTCCCGGCAACAATTAATAGACTGGATGGAGGCGGATAAAGTTGCAGGACCACTTCTGCGCTCGGCCCTTCCGGCTGGCTGGTTTATTGCTGATAAATCTGGAGCCGGTGAGCGTGGATCTCGCGGTATCATTGCAGCACTGGGGCCAGATGGTAAGCCCTCCCGTATCGTAGTTATCTACACGACGGGGAGTCAGGCAACTATGGA
gb|KP881236.1|+|0-1152|ARO:3003882|ADC-76 [Acinetobacter baumannii] 	0	1097	63	1160	1152	126080+	1097	ATGCGATTTAAAAAAATTTCTTGTCTACTTTTATCCCCGCTTTTTATTTTTAGTACCTCAATTTATGCGGGCAATACACCAAAAGACCAAGAAATTAAAAAACTGGTAGATCAAAACTTTAAACCGTTATTAGAAAAATATGATGTGCCAGGTATGGCTGTGGGTGTTATTCAAAATAATAAAAAGTATGAAATGTATTATGGTCTTCAATCTGTTCAAGATAAAAAAGCCGTAAATAGCAGTACTATTTTTGAGCTAGGTTCTGTCAGTAAATTATTTACCGCGACAGCAGGTGGATATGCAAAAAATAAAGGAAAAATCTCTTTTGACGATACGCCTGGTAAGTATTGGAAAGAACTAAAAAATACACCGATTGACCAAGTTAACTTACTTCAACTCGCGACGTATACAAGTGGTAACCTTGCCTTGCAATTTCCAGATGAAGTAAAAACAGATCAGCAAGTTTTAACATTTTTTAAAGACTGGAAACCTAAAAACTCAATCGGTGAATATCGACAATATTCAAACCCAAGCATTGGTTTATTTGGAAAAGTTGTAGCTTTGTCTATGAATAAACCTTTCGACCAAGTCTTAGAAAAAACAATTTTTCCGGCCCTTGGCTTAAAACATAGCTATGTAAATGTACCTAAGACCCAGATGCAAAACTATGCTTTTGGCTATAACCAAGAAAATCAGCCGATTCGAGTTAACCCCGGCCCACTCGATGCCCCAGCATATGGCGTCAAATCGACACTACCCGACATGTTGAGTTTTATTCATGCCAACCTAAATCCACAAAAATATCCAGCAGATATTCAACGGGCAATTAATGAAACACATCAGGGTCGCTATCAAGTAAATACCATGTATCAGGCACTCGGTTGGGAAGAGTTTTCTTATCCGGCAACGTTACAAACTTTATTAGACAGTAATTCAGAACAGATTGTGATGAAACCTAATAAAGTGACTGCTATTTCAAAGGAACCTTCAGTTAAGATGTACCATAAAACTGGCTCAACTACCGGTTTCGGAACATATGTGGTGTTTATTCCTAAAGAAAATATTGGTTTAGTCATGTTAACCAATAAACGTATTCC
gb|AY574271|+|0-861|ARO:3000998|TEM-134 [Citrobacter koseri] 	0	806	46	852	861	3478183-	806	ATGAGTATTCAACATTTCCGTGTCGCCCTTATTCCCTTTTTTGCGGCATTTTGCCTTCCTGTTTTTGCTCACCCAGAAACGCTGGTGAAAGTAAAAGATGCTGAAGATCAGTTGGGTGCACGAGTGGGTTACATCGAGCTGGATCTCAACAGCGGTAAGATCCTTGAGAGTTTTCGCCCCGAAGAACGTTTTCCAATGATGAGCACTTTTAAAGTTCTGCTATGTGGTGCGGTATTATCCCGTGTTGACGCCGGGCAAGAGCAACTCGGTCGCCGCATACACTATTCTCAGAATGACTTGGTTGAGTACTCACCAGTCACAGAAAAGCATCTTACGGATGGCATGACAGTAAGAGAATTATGCAGTGCTGCCATAACCATGAGTGATAACACTGCGGCCAACTTACTTCTGACAACGATCGGAGGACCGAAGGAGCTAACCGCTTTTTTGCACAACATGGGGGATCATGTAACCCGCCTTGATCGTTGGGAACCGGAGCTGAATGAAGCCATACCAAACGACGAGCGTGACACCACGATGCCTGCAGCAATGGCAACAACGTTGCGCAAACTATTAACTGGCGAACTACTTACTCTAGCTTCCCGGCAACAATTAATAGACTGGATGGAGGCGGATAAAGTTGCAGGACCACTTCTGCGCTCGGCCCTTCCGGCTGGCTGGTTTATTGCTGATAAATCTGGAGCCGGTGAGCGTGGATCTCGCGGTATCATTGCAGCACTGGGGCCAGATGGTAAGCCCTCCCGTATCGTAGTTATCTACACGACGGGGAGTCAGGCAACTATGGA
gb|U37105.2|+|2806-3640|ARO:3004692|aadA10 [Pseudomonas aeruginosa] 	0	779	1476	2255	834	104604+	779	ATGAGAAACACAGTGCCCGCCGAGATTTCGGTACGGTTATCACAGGCACTCAACGTCATCGAGCATCATCTGGGATCGACGTTGCTGGCCATGCATTTGTATGGCTCTGCACTCGACGGTGGCCTGAAGCCATACAGTGACATTGATTTGCTGGTTACTGTGACCGCACGGCTCGATGAGAGTGTGCGGCAAGCTCTGTTCGTCGATCTCTTGGGGGTTTCCGTTTTCCCTGGTCAAAGCAGAGTTCTCCGCGCCTTGGAAGTTACCATTGTCGTGCACAGTGACATCGTTCCTTGGCGCTATCCGGCCAGACGGGAACTGCAATTCGGGGAGTGGCAGCGCAAAGACATTCTTGCGGGCATCTTCGAGCCTGCGACAACCGATGTTGATCTAGCCATTCTGCTAACAAAAGCAAGGCAACATAGCCTTGCCTTGGCCGGTTCGGCTGCGGAAGATTTCTTCAACCCAGTCCCGGAAAGCGATCTGTTCAAGGCACTGGCCGACACCCTGAAACTATGGAACTCACAGCCGGATTGGATAGGTGACGAGCGGAATGTAGTGCTTACTTTGTCTCGTATTTGGTACAGCGCAGCAACCGGCAAGATCGCGCCGAAGGATGTTGCCGCCAACTGGGTAATGGAGCGTTTGCCAGTTCAACATCAGCCCGTGCTGCTTGAAGCCCGGCAGGCTTATCTTGGACAAGGAGAAGATTGCTTGGCTTCGCTCACGGATCAGTTAGAGGCGTTTGTTCACTTCGTGAAGCATGAAGCCACTAAACT
gb|X97254|+|153-1011|ARO:3001043|TEM-178 [Serratia marcescens] 	0	781	46	830	858	3478183-	784	ATGAGTATTCAACATTTCCGTGTCGCCCTTATTCCCTTTTTTGCGGCATTTTGCCTTCCTGTTTTTGCTCACCCAGAAACGCTGGTGAAAGTAAAAGATGCTGAAGATCAGTTGGGTGCACGAGTGGGTTACATCGAGCTGGATCTCAACAGCGGTAAGATCCTTGAGAGTTTTCGCCCCGAAGAACGTTTTCCAATGATGAGCACTTTTAAAGTTCTGCTATGTGGTGCGGTATTATCCCGTGTTGACGCCGGGCAAGAGCAACTCGGTCGCCGCATACACTATTCTCAGAATGACTTGGTTGAGTACTCACCAGTCACAGAAAAGCATCTTACGGATGGCATGACAGTAAGAGAATTATGCAGTGCTGCCATAACCATGAGTGATAACACTGCGGCCAACTTACTTCTGACAACGATCGGAGGACCGAAGGAGCTAACCGCTTTTTTGCACAACATGGGGGATCATGTAACCCGCCTTGATCGTTGGGAACCGGAGCTGAATGAAGCCATACCAAACGACGAGCGTGACACCACGATGCCTGCAGCAATGGCAACAACGTTGCGCAAACTATTAACTGGCGAACTACTTACTCTAGCTTCCCGGCAACAATTAATAGACTGGATGGAGGCGGATAAAGTTGCAGGACCACTTCTGCGCTCGGCCCTTCCGGCTGGCTGGTTTATTGCTGATAAATCTGGAGCCGGTGAGCGTGGATCTCGCGGTATCATTGCAGCACTGGGGCCAGATGGTAAGCCCTCCCGTATCGTAGTTATCTACACGA
gb|Y10281|+|0-861|ARO:3000918|TEM-49 [Escherichia coli] 	0	806	46	852	861	3478183-	806	ATGAGTATTCAACATTTCCGTGTCGCCCTTATTCCCTTTTTTGCGGCATTTTGCCTTCCTGTTTTTGCTCACCCAGAAACGCTGGTGAAAGTAAAAGATGCTGAAGATCAGTTGGGTGCACGAGTGGGTTACATCGAGCTGGATCTCAACAGCGGTAAGATCCTTGAGAGTTTTCGCCCCGAAGAACGTTTTCCAATGATGAGCACTTTTAAAGTTCTGCTATGTGGTGCGGTATTATCCCGTGTTGACGCCGGGCAAGAGCAACTCGGTCGCCGCATACACTATTCTCAGAATGACTTGGTTGAGTACTCACCAGTCACAGAAAAGCATCTTACGGATGGCATGACAGTAAGAGAATTATGCAGTGCTGCCATAACCATGAGTGATAACACTGCGGCCAACTTACTTCTGACAACGATCGGAGGACCGAAGGAGCTAACCGCTTTTTTGCACAACATGGGGGATCATGTAACCCGCCTTGATCGTTGGGAACCGGAGCTGAATGAAGCCATACCAAACGACGAGCGTGACACCACGATGCCTGCAGCAATGGCAACAACGTTGCGCAAACTATTAACTGGCGAACTACTTACTCTAGCTTCCCGGCAACAATTAATAGACTGGATGGAGGCGGATAAAGTTGCAGGACCACTTCTGCGCTCGGCCCTTCCGGCTGGCTGGTTTATTGCTGATAAATCTGGAGCCGGTGAGCGTGGATCTCGCGGTATCATTGCAGCACTGGGGCCAGATGGTAAGCCCTCCCGTATCGTAGTTATCTACACGACGGGGAGTCAGGCAACTATGGA
gb|AJ634602.1|-|7839-8700|ARO:3000999|TEM-135 [Salmonella enterica subsp. enterica serovar Typhimurium] 	0	806	46	852	861	3478183-	806	ATGAGTATTCAACATTTCCGTGTCGCCCTTATTCCCTTTTTTGCGGCATTTTGCCTTCCTGTTTTTGCTCACCCAGAAACGCTGGTGAAAGTAAAAGATGCTGAAGATCAGTTGGGTGCACGAGTGGGTTACATCGAGCTGGATCTCAACAGCGGTAAGATCCTTGAGAGTTTTCGCCCCGAAGAACGTTTTCCAATGATGAGCACTTTTAAAGTTCTGCTATGTGGTGCGGTATTATCCCGTGTTGACGCCGGGCAAGAGCAACTCGGTCGCCGCATACACTATTCTCAGAATGACTTGGTTGAGTACTCACCAGTCACAGAAAAGCATCTTACGGATGGCATGACAGTAAGAGAATTATGCAGTGCTGCCATAACCATGAGTGATAACACTGCGGCCAACTTACTTCTGACAACGATCGGAGGACCGAAGGAGCTAACCGCTTTTTTGCACAACATGGGGGATCATGTAACCCGCCTTGATCGTTGGGAACCGGAGCTGAATGAAGCCATACCAAACGACGAGCGTGACACCACGATGCCTGCAGCAATGGCAACAACGTTGCGCAAACTATTAACTGGCGAACTACTTACTCTAGCTTCCCGGCAACAATTAATAGACTGGATGGAGGCGGATAAAGTTGCAGGACCACTTCTGCGCTCGGCCCTTCCGGCTGGCTGGTTTATTGCTGATAAATCTGGAGCCGGTGAGCGTGGATCTCGCGGTATCATTGCAGCACTGGGGCCAGATGGTAAGCCCTCCCGTATCGTAGTTATCTACACGACGGGGAGTCAGGCAACTATGGA
gb|KJ135346|+|14-839|ARO:3001575|OXA-389 [Acinetobacter baumannii] 	0	770	54149	54919	825	246080-	770	ATGAACATTAAAGCACTCTTACTTATAACAAGCGCTATTTTTATTTCAGCCTGCTCACCTTATATAGTGACTGCTAATCCAAATCACAGCGCTTCAAAATCTGATGTAAAAGCAGAGAAAATTAAAAATTTATTTAACGAAGCACACACTACGGGTGTTTTAGTTATCCAACAAGGCCAAACTCAACAAAGCTATGGTAATGATCTTGCTCGTGCTTCGACCGAGTATGTACCTGCTTCGACCTTCAAAATGCTTAATGCTTTGATCGGCCTTGAGCACCATAAGGCAACCACCACAGAAGTATTTAAGTGGGATGGTAAAAAAAGGTTATTCCCAGAATGGGAAAAGGACATGACCCTAGGCGATGCCATGAAAGCTTCCGCTATTCCAGTTTATCAAGATTTAGCTCGTCGTATTGGACTTGAGCTCATGTCTAAGGAAGTGAAGCGTGTTGGTTATGGCAATGCAGATATCGGTACCCAAGTCGATAATTTTTGGCTGGTGGGTCCTTTAAAAATTACTCCTCAGCAAGAGGCACAGTTTGCTTACAAGCTAGCTAATAAAACGCTTCCATTTAGCCAAAAAGTCCAAGATGAAGTGCAATCCATGCTATTCATAGAAGAAAAGAATGGAAACAAAATATACGCAAAAAGTGGTTGGGGATGGGATGTAAACCCACAAGTAGGCTGGTTAACTGGATGGGTTGTTCAGCCTCAAGGGAATATTGTAGCGTTCTCCCTTAACTTAGAAATGAAAAAAGGAATACCTAG
gb|DQ393783|+|1799-2591|ARO:3002615|aadA15 [Pseudomonas aeruginosa] 	0	717	10	727	792	104600-	717	ATGAGGGAAGCGGTGATCGCCGAAGTATCGACTCAACTATCAGAGGTAGTTGGCGTCATCGAGCGCCATCTCGAACCGACGTTGCTGGCCGTACATTTGTACGGCTCCGCAGTGGATGGCGGCCTGAAGCCACACAGTGATATTGATTTGCTGGTTACGGTGACCGTAAGGCTTGATGAAACAACGCGGCGAGCTTTGATCAACGACCTTTTGGAAACTTCGGCTTCCCCTGGAGAGAGCGAGATTCTCCGCGCTGTAGAAGTCACCATTGTTGTGCACGACGACATCATTCCGTGGCGTTATCCAGCTAAGCGCGAACTGCAATTTGGAGAATGGCAGCGCAATGACATTCTTGCAGGTATCTTCGAGCCAGCCACGATCGACATTGATCTGGCTATCTTGCTGACAAAAGCAAGAGAACATAGCGTTGCCTTGGTAGGTCCAGCGGCGGAGGAACTCTTTGATCCGGTTCCTGAACAGGATCTATTTGAGGCGCTAAATGAAACCTTAACGCTATGGAACTCGCCGCCCGACTGGGCTGGCGATGAGCGAAATGTAGTGCTTACGTTGTCCCGCATTTGGTACAGCGCAGTAACCGGCAAAATCGCGCCGAAGGATGTCGCTGCCGACTGGGCAATGGAGCGCCTGCCGGCCCAGTATCAGCCCGTCATACTTGAAGCTAGACAGGCTTATCTTGGACAAGAAGAAGATCGCTTG
gb|Y13612|+|0-861|ARO:3000921|TEM-52 [Klebsiella pneumoniae] 	0	806	46	852	861	3478183-	806	ATGAGTATTCAACATTTCCGTGTCGCCCTTATTCCCTTTTTTGCGGCATTTTGCCTTCCTGTTTTTGCTCACCCAGAAACGCTGGTGAAAGTAAAAGATGCTGAAGATCAGTTGGGTGCACGAGTGGGTTACATCGAGCTGGATCTCAACAGCGGTAAGATCCTTGAGAGTTTTCGCCCCGAAGAACGTTTTCCAATGATGAGCACTTTTAAAGTTCTGCTATGTGGTGCGGTATTATCCCGTGTTGACGCCGGGCAAGAGCAACTCGGTCGCCGCATACACTATTCTCAGAATGACTTGGTTGAGTACTCACCAGTCACAGAAAAGCATCTTACGGATGGCATGACAGTAAGAGAATTATGCAGTGCTGCCATAACCATGAGTGATAACACTGCGGCCAACTTACTTCTGACAACGATCGGAGGACCGAAGGAGCTAACCGCTTTTTTGCACAACATGGGGGATCATGTAACCCGCCTTGATCGTTGGGAACCGGAGCTGAATGAAGCCATACCAAACGACGAGCGTGACACCACGATGCCTGCAGCAATGGCAACAACGTTGCGCAAACTATTAACTGGCGAACTACTTACTCTAGCTTCCCGGCAACAATTAATAGACTGGATGGAGGCGGATAAAGTTGCAGGACCACTTCTGCGCTCGGCCCTTCCGGCTGGCTGGTTTATTGCTGATAAATCTGGAGCCGGTGAGCGTGGATCTCGCGGTATCATTGCAGCACTGGGGCCAGATGGTAAGCCCTCCCGTATCGTAGTTATCTACACGACGGGGAGTCAGGCAACTATGGA
gb|AB781687|+|0-825|ARO:3001682|OXA-254 [Acinetobacter baumannii] 	0	770	54149	54919	825	246080-	770	ATGAACATTAAAGCACTCTTACTTATAACAAGCGCTATTTTTATTTCAGCCTGCTCACCTTATATAGTGACTGCTAATCCAAATCACAGCGCTTCAAAATCTGATGTAAAAGCAGAGAAAATTAAAAATTTATTTAACGAAGCACACACTACGGGTGTTTTAGTTATCCAACAAGGCCAAACTCAACAAAGCTATGGTAATGATCTTGCTCGTGCTTCGACCGAGTATGTACCTGCTTCGACCTTCAAAATGCTTAATGCTTTGATCGGCCTTGAGCACCATAAGGCAACCACCACAGAAGTATTTAAGTGGGATGGTAAAAAAAGGTTATTCCCAGAATGGGAAAAGGACATGACCCTAGGCGATGCCATGAAAGCTTCCGCTATTCCAGTTTATCAAGATTTAGCTCGTCGTATTGGACTTGAGCTCATGTCTAAGGAAGTGAAGCGTGTTGGTTATGGCAATGCAGATATCGGTACCCAAGTCGATAATTTTTGGCTGGTGGGTCCTTTAAAAATTACTCCTCAGCAAGAGGCACAGTTTGCTTACAAGCTAGCTAATAAAACGCTTCCATTTAGCCAAAAAGTCCAAGATGAAGTGCAATCCATGCTATTCATAGAAGAAAAGAATGGAAACAAAATATACGCAAAAAGTGGTTGGGGATGGGATGTAAACCCACAAGTAGGCTGGTTAACTGGATGGGTTGTTCAGCCTCAAGGGAATATTGTAGCGTTCTCCCTTAACTTAGAAATGAAAAAAGGAATACCTAG
gb|AF104441|+|193-1054|ARO:3000922|TEM-53 [Klebsiella pneumoniae] 	0	806	46	852	861	3478183-	806	ATGAGTATTCAACATTTCCGTGTCGCCCTTATTCCCTTTTTTGCGGCATTTTGCCTTCCTGTTTTTGCTCACCCAGAAACGCTGGTGAAAGTAAAAGATGCTGAAGATCAGTTGGGTGCACGAGTGGGTTACATCGAGCTGGATCTCAACAGCGGTAAGATCCTTGAGAGTTTTCGCCCCGAAGAACGTTTTCCAATGATGAGCACTTTTAAAGTTCTGCTATGTGGTGCGGTATTATCCCGTGTTGACGCCGGGCAAGAGCAACTCGGTCGCCGCATACACTATTCTCAGAATGACTTGGTTGAGTACTCACCAGTCACAGAAAAGCATCTTACGGATGGCATGACAGTAAGAGAATTATGCAGTGCTGCCATAACCATGAGTGATAACACTGCGGCCAACTTACTTCTGACAACGATCGGAGGACCGAAGGAGCTAACCGCTTTTTTGCACAACATGGGGGATCATGTAACCCGCCTTGATCGTTGGGAACCGGAGCTGAATGAAGCCATACCAAACGACGAGCGTGACACCACGATGCCTGCAGCAATGGCAACAACGTTGCGCAAACTATTAACTGGCGAACTACTTACTCTAGCTTCCCGGCAACAATTAATAGACTGGATGGAGGCGGATAAAGTTGCAGGACCACTTCTGCGCTCGGCCCTTCCGGCTGGCTGGTTTATTGCTGATAAATCTGGAGCCGGTGAGCGTGGATCTCGCGGTATCATTGCAGCACTGGGGCCAGATGGTAAGCCCTCCCGTATCGTAGTTATCTACACGACGGGGAGTCAGGCAACTATGGA
gb|KR057758.1|+|0-1107|ARO:3004352|PDC-89 [Pseudomonas aeruginosa] 	0	1052	35591	36652	1107	232416+	1061	GATGAGGCCCCGGCGGATCGCCTGAAGGCACTGGTCGACGCCGCCGTACAACCGGTGATGAAGGCCAATGACATTCCGGGCCTGGCCGTAGCCATCAGCCTGAAAGGAGAACCGCATTACTTCAGCTATGGGCTGGCCTCGAAAGAGGACGGCCGCCGGGTGACGCCGGAGACCCTGTTCGAGATCGGCTCGGTGAGCAAGACCTTCACCGTCACCCTCGCCGGCTATGCCCTGGCCCAGGACAAGATGCGCCTCGACGACCGCGCCAGCCAGCACTGGCCGGCACTGCAGGGCAGCCGCTTCGACGGCATCAGCCTGCTCGACCTCGCGACCTATACCGCCGGCGGCTTGCCGCTGCAGTTCCCCGACTCGGTGCAGAAGGACCAGGCACAGATCCGCGACTACTACCGCCAGTGGCAGCCGACCTACGCGCCGGGCAGCCAGCGCCTCTATTCCAACCCGAGCATCGGCCTGTTCGGCTATCTCGCCGCGCGCAGCCTGGGCCAGCCGTTCGAACGGCTCATGGAGCAGCAATTGTTCCCGGCACTGGGCCTCGAACAGACCCACCTCGACGTGCCCGAGGCGGCGCTGGCGCAGTACGCCCAGGGCTACGGCAAGGACGACCGCCCGCTACGGGTCGGTCCCGGCCCGCTGGATGCCGAAGGCTACGGGGTGAAGACCAGCGCGGCCGACCTGCTGCGCTTCGTCGATGCCAACCTGCATCCGGAGCGCCTGGACAGGCCCTGGGCGCAGGCGCTCGATGCCACCCATCGCGGTTACTACAAGGTCGGCGACATGACCCAGGGCCTGGGCTGGGAAGCCTACGACTGGCCGATCTCCCTGAAGCGCCTGCAGGCCGGCAACTCGACGCCGATGGCGCTGCAACCACACAGGATCGCCAGGCTGCCCGCGCCACAGGCGCTGGAGGGCCAGCGCCTGCTGAACAAGACCGGCTCCACCAACGGCTTCGGCGCCTACGTGGCGTTCGTCCCGGGCCGCGACCTGGGCCTGGTGATCCTGGCCAACCGCAACTATCCCAATGCCGAGCGGGTGAAGATCGC
gb|FJ460181|+|1790-2582|ARO:3002617|aadA17 [Aeromonas media] 	0	717	10	727	792	104600-	717	ATGAGGGAAGCGGTGATCGCCGAAGTATCGACTCAACTATCAGAGGTAGTTGGCGTCATCGAGCGCCATCTCGAACCGACGTTGCTGGCCGTACATTTGTACGGCTCCGCAGTGGATGGCGGCCTGAAGCCACACAGTGATATTGATTTGCTGGTTACGGTGACCGTAAGGCTTGATGAAACAACGCGGCGAGCTTTGATCAACGACCTTTTGGAAACTTCGGCTTCCCCTGGAGAGAGCGAGATTCTCCGCGCTGTAGAAGTCACCATTGTTGTGCACGACGACATCATTCCGTGGCGTTATCCAGCTAAGCGCGAACTGCAATTTGGAGAATGGCAGCGCAATGACATTCTTGCAGGTATCTTCGAGCCAGCCACGATCGACATTGATCTGGCTATCTTGCTGACAAAAGCAAGAGAACATAGCGTTGCCTTGGTAGGTCCAGCGGCGGAGGAACTCTTTGATCCGGTTCCTGAACAGGATCTATTTGAGGCGCTAAATGAAACCTTAACGCTATGGAACTCGCCGCCCGACTGGGCTGGCGATGAGCGAAATGTAGTGCTTACGTTGTCCCGCATTTGGTACAGCGCAGTAACCGGCAAAATCGCGCCGAAGGATGTCGCTGCCGACTGGGCAATGGAGCGCCTGCCGGCCCAGTATCAGCCCGTCATACTTGAAGCTAGACAGGCTTATCTTGGACAAGAAGAAGATCGCTTG
gb|KJ135342.1|-|48-873|ARO:3001576|OXA-390 [Acinetobacter baumannii] 	0	770	54149	54919	825	246080-	770	ATGAACATTAAAGCACTCTTACTTATAACAAGCGCTATTTTTATTTCAGCCTGCTCACCTTATATAGTGACTGCTAATCCAAATCACAGCGCTTCAAAATCTGATGTAAAAGCAGAGAAAATTAAAAATTTATTTAACGAAGCACACACTACGGGTGTTTTAGTTATCCAACAAGGCCAAACTCAACAAAGCTATGGTAATGATCTTGCTCGTGCTTCGACCGAGTATGTACCTGCTTCGACCTTCAAAATGCTTAATGCTTTGATCGGCCTTGAGCACCATAAGGCAACCACCACAGAAGTATTTAAGTGGGATGGTAAAAAAAGGTTATTCCCAGAATGGGAAAAGGACATGACCCTAGGCGATGCCATGAAAGCTTCCGCTATTCCAGTTTATCAAGATTTAGCTCGTCGTATTGGACTTGAGCTCATGTCTAAGGAAGTGAAGCGTGTTGGTTATGGCAATGCAGATATCGGTACCCAAGTCGATAATTTTTGGCTGGTGGGTCCTTTAAAAATTACTCCTCAGCAAGAGGCACAGTTTGCTTACAAGCTAGCTAATAAAACGCTTCCATTTAGCCAAAAAGTCCAAGATGAAGTGCAATCCATGCTATTCATAGAAGAAAAGAATGGAAACAAAATATACGCAAAAAGTGGTTGGGGATGGGATGTAAACCCACAAGTAGGCTGGTTAACTGGATGGGTTGTTCAGCCTCAAGGGAATATTGTAGCGTTCTCCCTTAACTTAGAAATGAAAAAAGGAATACCTAG
gb|AY826417|+|0-861|ARO:3001000|TEM-136 [Klebsiella pneumoniae] 	0	806	46	852	861	3478183-	806	ATGAGTATTCAACATTTCCGTGTCGCCCTTATTCCCTTTTTTGCGGCATTTTGCCTTCCTGTTTTTGCTCACCCAGAAACGCTGGTGAAAGTAAAAGATGCTGAAGATCAGTTGGGTGCACGAGTGGGTTACATCGAGCTGGATCTCAACAGCGGTAAGATCCTTGAGAGTTTTCGCCCCGAAGAACGTTTTCCAATGATGAGCACTTTTAAAGTTCTGCTATGTGGTGCGGTATTATCCCGTGTTGACGCCGGGCAAGAGCAACTCGGTCGCCGCATACACTATTCTCAGAATGACTTGGTTGAGTACTCACCAGTCACAGAAAAGCATCTTACGGATGGCATGACAGTAAGAGAATTATGCAGTGCTGCCATAACCATGAGTGATAACACTGCGGCCAACTTACTTCTGACAACGATCGGAGGACCGAAGGAGCTAACCGCTTTTTTGCACAACATGGGGGATCATGTAACCCGCCTTGATCGTTGGGAACCGGAGCTGAATGAAGCCATACCAAACGACGAGCGTGACACCACGATGCCTGCAGCAATGGCAACAACGTTGCGCAAACTATTAACTGGCGAACTACTTACTCTAGCTTCCCGGCAACAATTAATAGACTGGATGGAGGCGGATAAAGTTGCAGGACCACTTCTGCGCTCGGCCCTTCCGGCTGGCTGGTTTATTGCTGATAAATCTGGAGCCGGTGAGCGTGGATCTCGCGGTATCATTGCAGCACTGGGGCCAGATGGTAAGCCCTCCCGTATCGTAGTTATCTACACGACGGGGAGTCAGGCAACTATGGA
gb|NG_050218.1|+|0-1061|ARO:3001044|TEM-181 [Bacteria] Partial	54	924	0	870	1061	3478183-	870	ACAATAACCCTGATAAATGCTTCAATAATATTGAAAAAGGAAGAGTATGAGTATTCAACATTTCCGTGTCGCCCTTATTCCCTTTTTTGCGGCATTTTGCCTTCCTGTTTTTGCTCACCCAGAAACGCTGGTGAAAGTAAAAGATGCTGAAGATCAGTTGGGTGCACGAGTGGGTTACATCGAGCTGGATCTCAACAGCGGTAAGATCCTTGAGAGTTTTCGCCCCGAAGAACGTTTTCCAATGATGAGCACTTTTAAAGTTCTGCTATGTGGTGCGGTATTATCCCGTGTTGACGCCGGGCAAGAGCAACTCGGTCGCCGCATACACTATTCTCAGAATGACTTGGTTGAGTACTCACCAGTCACAGAAAAGCATCTTACGGATGGCATGACAGTAAGAGAATTATGCAGTGCTGCCATAACCATGAGTGATAACACTGCGGCCAACTTACTTCTGACAACGATCGGAGGACCGAAGGAGCTAACCGCTTTTTTGCACAACATGGGGGATCATGTAACCCGCCTTGATCGTTGGGAACCGGAGCTGAATGAAGCCATACCAAACGACGAGCGTGACACCACGATGCCTGCAGCAATGGCAACAACGTTGCGCAAACTATTAACTGGCGAACTACTTACTCTAGCTTCCCGGCAACAATTAATAGACTGGATGGAGGCGGATAAAGTTGCAGGACCACTTCTGCGCTCGGCCCTTCCGGCTGGCTGGTTTATTGCTGATAAATCTGGAGCCGGTGAGCGTGGATCTCGCGGTATCATTGCAGCACTGGGGCCAGATGGTAAGCCCTCCCGTATCGTAGTTATCTACACGACGGGGAGTCAGGCAACTATGGATGAACGAAATAGACAGAT
gb|HE616889|+|1826-2627|ARO:3001502|OXA-256 [Enterobacter cloacae] 	0	746	659	1405	801	104604+	746	ATGAAAACATTTGCCGCATATGTAATTATCGCGTGTCTTTCGAGTACGGCATTAGCTGGTTCAATTACAGAAAATACGTCTTGGAACAAAGAGTTCTCTGCCGAAGCCGTCAATGGTGTCTTCGTGCTTTGTAAAAGTAGCAGTAAATCCTGCGCTACCAATGACTTAGCTCGTGCATCAAAGGAATATCTTCCAGCATCAACATTTAAGATCCCCAACGCAATTATCGGCCTAGAAACTGGTGTCATAAAGAATGAGCATCAGGTTTTCAAATGGGACGGAAAGCCAAGAGCCATGAAGCAATGGGAAAGAGACTTGACCTTAAGAGGGGCAATACAAGTTTCAGCTGTTCCCGTATTTCAACAAATCGCCAGAGAAGTTGGCGAAGTAAGAATGCAGAAATACCTTAAAAAATTTTCCTATGGCAACCAGAATATCAGTGGTGGCATTGACAAATTCTGGTTGGAAGGCCAGCTTAGAATTTCCGCAGTTAATCAAGTGGAGTTTCTAGAGTCTCTATATTTAAATAAATTGTCAGCATCTAAAGAAAACCAGCTAATAGTAAAAGAGGCTTTGGTAACGGAGGCGGCACCTGAATATCTAGTGCATTCAAAAACTGGTTTTTCTGGTGTGGGAACTGAGTCAAATCCTGGTGTCGCATGGTGGGTTGGGTGGGTTGAGAAGGAGACAGAGGTTTACTTTTTCGCCTTTAACATGGATATAGACAACGAAAGTAAGTTGCCGCT
gb|AM286274|+|0-861|ARO:3001001|TEM-137 [Shigella sonnei] 	0	806	46	852	861	3478183-	806	ATGAGTATTCAACATTTCCGTGTCGCCCTTATTCCCTTTTTTGCGGCATTTTGCCTTCCTGTTTTTGCTCACCCAGAAACGCTGGTGAAAGTAAAAGATGCTGAAGATCAGTTGGGTGCACGAGTGGGTTACATCGAGCTGGATCTCAACAGCGGTAAGATCCTTGAGAGTTTTCGCCCCGAAGAACGTTTTCCAATGATGAGCACTTTTAAAGTTCTGCTATGTGGTGCGGTATTATCCCGTGTTGACGCCGGGCAAGAGCAACTCGGTCGCCGCATACACTATTCTCAGAATGACTTGGTTGAGTACTCACCAGTCACAGAAAAGCATCTTACGGATGGCATGACAGTAAGAGAATTATGCAGTGCTGCCATAACCATGAGTGATAACACTGCGGCCAACTTACTTCTGACAACGATCGGAGGACCGAAGGAGCTAACCGCTTTTTTGCACAACATGGGGGATCATGTAACCCGCCTTGATCGTTGGGAACCGGAGCTGAATGAAGCCATACCAAACGACGAGCGTGACACCACGATGCCTGCAGCAATGGCAACAACGTTGCGCAAACTATTAACTGGCGAACTACTTACTCTAGCTTCCCGGCAACAATTAATAGACTGGATGGAGGCGGATAAAGTTGCAGGACCACTTCTGCGCTCGGCCCTTCCGGCTGGCTGGTTTATTGCTGATAAATCTGGAGCCGGTGAGCGTGGATCTCGCGGTATCATTGCAGCACTGGGGCCAGATGGTAAGCCCTCCCGTATCGTAGTTATCTACACGACGGGGAGTCAGGCAACTATGGA
gb|AF104442|+|193-1054|ARO:3000923|TEM-54 [Escherichia coli] 	0	806	46	852	861	3478183-	806	ATGAGTATTCAACATTTCCGTGTCGCCCTTATTCCCTTTTTTGCGGCATTTTGCCTTCCTGTTTTTGCTCACCCAGAAACGCTGGTGAAAGTAAAAGATGCTGAAGATCAGTTGGGTGCACGAGTGGGTTACATCGAGCTGGATCTCAACAGCGGTAAGATCCTTGAGAGTTTTCGCCCCGAAGAACGTTTTCCAATGATGAGCACTTTTAAAGTTCTGCTATGTGGTGCGGTATTATCCCGTGTTGACGCCGGGCAAGAGCAACTCGGTCGCCGCATACACTATTCTCAGAATGACTTGGTTGAGTACTCACCAGTCACAGAAAAGCATCTTACGGATGGCATGACAGTAAGAGAATTATGCAGTGCTGCCATAACCATGAGTGATAACACTGCGGCCAACTTACTTCTGACAACGATCGGAGGACCGAAGGAGCTAACCGCTTTTTTGCACAACATGGGGGATCATGTAACCCGCCTTGATCGTTGGGAACCGGAGCTGAATGAAGCCATACCAAACGACGAGCGTGACACCACGATGCCTGCAGCAATGGCAACAACGTTGCGCAAACTATTAACTGGCGAACTACTTACTCTAGCTTCCCGGCAACAATTAATAGACTGGATGGAGGCGGATAAAGTTGCAGGACCACTTCTGCGCTCGGCCCTTCCGGCTGGCTGGTTTATTGCTGATAAATCTGGAGCCGGTGAGCGTGGATCTCGCGGTATCATTGCAGCACTGGGGCCAGATGGTAAGCCCTCCCGTATCGTAGTTATCTACACGACGGGGAGTCAGGCAACTATGGA
gb|HQ317449|+|0-861|ARO:3001373|TEM-182 [Haemophilus parainfluenzae] 	0	806	46	852	861	3478183-	806	ATGAGTATTCAACATTTCCGTGTCGCCCTTATTCCCTTTTTTGCGGCATTTTGCCTTCCTGTTTTTGCTCACCCAGAAACGCTGGTGAAAGTAAAAGATGCTGAAGATCAGTTGGGTGCACGAGTGGGTTACATCGAGCTGGATCTCAACAGCGGTAAGATCCTTGAGAGTTTTCGCCCCGAAGAACGTTTTCCAATGATGAGCACTTTTAAAGTTCTGCTATGTGGTGCGGTATTATCCCGTGTTGACGCCGGGCAAGAGCAACTCGGTCGCCGCATACACTATTCTCAGAATGACTTGGTTGAGTACTCACCAGTCACAGAAAAGCATCTTACGGATGGCATGACAGTAAGAGAATTATGCAGTGCTGCCATAACCATGAGTGATAACACTGCGGCCAACTTACTTCTGACAACGATCGGAGGACCGAAGGAGCTAACCGCTTTTTTGCACAACATGGGGGATCATGTAACCCGCCTTGATCGTTGGGAACCGGAGCTGAATGAAGCCATACCAAACGACGAGCGTGACACCACGATGCCTGCAGCAATGGCAACAACGTTGCGCAAACTATTAACTGGCGAACTACTTACTCTAGCTTCCCGGCAACAATTAATAGACTGGATGGAGGCGGATAAAGTTGCAGGACCACTTCTGCGCTCGGCCCTTCCGGCTGGCTGGTTTATTGCTGATAAATCTGGAGCCGGTGAGCGTGGATCTCGCGGTATCATTGCAGCACTGGGGCCAGATGGTAAGCCCTCCCGTATCGTAGTTATCTACACGACGGGGAGTCAGGCAACTATGGA
gb|AF156486|+|5012-5792|ARO:3002602|aadA2 [Klebsiella pneumoniae] 	0	267	0	267	780	41790385+	267	GTGACCATCGAAATTTCGAACCAACTATCAGAGGTGCTAAGCGTCATTGAGCGCCATCTGGAATCAACGTTGCTGGCCGTGCATTTGTACGGCTCCGCAGTGGATGGCGGCCTGAAGCCATACAGCGATATTGATTTGTTGGTTACTGTGGCCGTAAAGCTTGATGAAACGACGCGGCGAGCATTGCTCAATGACCTTATGGAGGCTTCGGCTTTCCCTGGCGAGAGCGAGACGCTCCGCGCTATAGAAGTCACCCTTGTCGTGCAT
gb|AY853593|+|214-1075|ARO:3001002|TEM-138 [Salmonella enterica] 	0	806	46	852	861	3478183-	806	ATGAGTATTCAACATTTCCGTGTCGCCCTTATTCCCTTTTTTGCGGCATTTTGCCTTCCTGTTTTTGCTCACCCAGAAACGCTGGTGAAAGTAAAAGATGCTGAAGATCAGTTGGGTGCACGAGTGGGTTACATCGAGCTGGATCTCAACAGCGGTAAGATCCTTGAGAGTTTTCGCCCCGAAGAACGTTTTCCAATGATGAGCACTTTTAAAGTTCTGCTATGTGGTGCGGTATTATCCCGTGTTGACGCCGGGCAAGAGCAACTCGGTCGCCGCATACACTATTCTCAGAATGACTTGGTTGAGTACTCACCAGTCACAGAAAAGCATCTTACGGATGGCATGACAGTAAGAGAATTATGCAGTGCTGCCATAACCATGAGTGATAACACTGCGGCCAACTTACTTCTGACAACGATCGGAGGACCGAAGGAGCTAACCGCTTTTTTGCACAACATGGGGGATCATGTAACCCGCCTTGATCGTTGGGAACCGGAGCTGAATGAAGCCATACCAAACGACGAGCGTGACACCACGATGCCTGCAGCAATGGCAACAACGTTGCGCAAACTATTAACTGGCGAACTACTTACTCTAGCTTCCCGGCAACAATTAATAGACTGGATGGAGGCGGATAAAGTTGCAGGACCACTTCTGCGCTCGGCCCTTCCGGCTGGCTGGTTTATTGCTGATAAATCTGGAGCCGGTGAGCGTGGATCTCGCGGTATCATTGCAGCACTGGGGCCAGATGGTAAGCCCTCCCGTATCGTAGTTATCTACACGACGGGGAGTCAGGCAACTATGGA
gb|HQ529916|+|110-971|ARO:3001045|TEM-183 [Klebsiella pneumoniae] 	0	806	46	852	861	3478183-	806	ATGAGTATTCAACATTTCCGTGTCGCCCTTATTCCCTTTTTTGCGGCATTTTGCCTTCCTGTTTTTGCTCACCCAGAAACGCTGGTGAAAGTAAAAGATGCTGAAGATCAGTTGGGTGCACGAGTGGGTTACATCGAGCTGGATCTCAACAGCGGTAAGATCCTTGAGAGTTTTCGCCCCGAAGAACGTTTTCCAATGATGAGCACTTTTAAAGTTCTGCTATGTGGTGCGGTATTATCCCGTGTTGACGCCGGGCAAGAGCAACTCGGTCGCCGCATACACTATTCTCAGAATGACTTGGTTGAGTACTCACCAGTCACAGAAAAGCATCTTACGGATGGCATGACAGTAAGAGAATTATGCAGTGCTGCCATAACCATGAGTGATAACACTGCGGCCAACTTACTTCTGACAACGATCGGAGGACCGAAGGAGCTAACCGCTTTTTTGCACAACATGGGGGATCATGTAACCCGCCTTGATCGTTGGGAACCGGAGCTGAATGAAGCCATACCAAACGACGAGCGTGACACCACGATGCCTGCAGCAATGGCAACAACGTTGCGCAAACTATTAACTGGCGAACTACTTACTCTAGCTTCCCGGCAACAATTAATAGACTGGATGGAGGCGGATAAAGTTGCAGGACCACTTCTGCGCTCGGCCCTTCCGGCTGGCTGGTTTATTGCTGATAAATCTGGAGCCGGTGAGCGTGGATCTCGCGGTATCATTGCAGCACTGGGGCCAGATGGTAAGCCCTCCCGTATCGTAGTTATCTACACGACGGGGAGTCAGGCAACTATGGA
gb|DQ072853|+|0-861|ARO:3001003|TEM-139 [Klebsiella pneumoniae] 	0	806	46	852	861	3478183-	806	ATGAGTATTCAACATTTCCGTGTCGCCCTTATTCCCTTTTTTGCGGCATTTTGCCTTCCTGTTTTTGCTCACCCAGAAACGCTGGTGAAAGTAAAAGATGCTGAAGATCAGTTGGGTGCACGAGTGGGTTACATCGAGCTGGATCTCAACAGCGGTAAGATCCTTGAGAGTTTTCGCCCCGAAGAACGTTTTCCAATGATGAGCACTTTTAAAGTTCTGCTATGTGGTGCGGTATTATCCCGTGTTGACGCCGGGCAAGAGCAACTCGGTCGCCGCATACACTATTCTCAGAATGACTTGGTTGAGTACTCACCAGTCACAGAAAAGCATCTTACGGATGGCATGACAGTAAGAGAATTATGCAGTGCTGCCATAACCATGAGTGATAACACTGCGGCCAACTTACTTCTGACAACGATCGGAGGACCGAAGGAGCTAACCGCTTTTTTGCACAACATGGGGGATCATGTAACCCGCCTTGATCGTTGGGAACCGGAGCTGAATGAAGCCATACCAAACGACGAGCGTGACACCACGATGCCTGCAGCAATGGCAACAACGTTGCGCAAACTATTAACTGGCGAACTACTTACTCTAGCTTCCCGGCAACAATTAATAGACTGGATGGAGGCGGATAAAGTTGCAGGACCACTTCTGCGCTCGGCCCTTCCGGCTGGCTGGTTTATTGCTGATAAATCTGGAGCCGGTGAGCGTGGATCTCGCGGTATCATTGCAGCACTGGGGCCAGATGGTAAGCCCTCCCGTATCGTAGTTATCTACACGACGGGGAGTCAGGCAACTATGGA
gb|AY171244|+|46-838|ARO:3002618|aadA21 [Salmonella enterica subsp. enterica serovar Typhimurium] 	0	737	10	747	792	104600-	737	ATGAGGGAAGCGGTGATCGCCGAAGTATCGACTCAACTATCAGAGGTAGTTGGCGTCATCGAGCGCCATCTCGAACCGACGTTGCTGGCCGTACATTTGTACGGCTCCGCAGTGGATGGCGGCCTGAAGCCACACAGTGATATTGATTTGCTGGTTACGGTGACCGTAAGGCTTGATGAAACAACGCGGCGAGCTTTGATCAACGACCTTTTGGAAACTTCGGCTTCCCCTGGAGAGAGCGAGATTCTCCGCGCTGTAGAAGTCACCATTGTTGTGCACGACGACATCATTCCGTGGCGTTATCCAGCTAAGCGCGAACTGCAATTTGGAGAATGGCAGCGCAATGACATTCTTGCAGGTATCTTCGAGCCAGCCACGATCGACATTGATCTGGCTATCTTGCTGACAAAAGCAAGAGAACATAGCGTTGCCTTGGTAGGTCCAGCGGCGGAGGAACTCTTTGATCCGGTTCCTGAACAGGATCTATTTGAGGCGCTAAATGAAACCTTAACGCTATGGAACTCGCCGCCCGACTGGGCTGGCGATGAGCGAAATGTAGTGCTTACGTTGTCCCGCATTTGGTACAGCGCAGTAACCGGCAAAATCGCGCCGAAGGATGTCGCTGCCGACTGGGCAATGGAGCGCCTGCCGGCCCAGTATCAGCCCGTCATACTTGAAGCTAGACAGGCTTATCTTGGACAAGAAGAAGATCGCTTGGCCTCGCGCGCAGATCAGTT
gb|KJ427797|+|0-825|ARO:3001577|OXA-391 [Acinetobacter baumannii] 	0	770	54149	54919	825	246080-	770	ATGAACATTAAAGCACTCTTACTTATAACAAGCGCTATTTTTATTTCAGCCTGCTCACCTTATATAGTGACTGCTAATCCAAATCACAGCGCTTCAAAATCTGATGTAAAAGCAGAGAAAATTAAAAATTTATTTAACGAAGCACACACTACGGGTGTTTTAGTTATCCAACAAGGCCAAACTCAACAAAGCTATGGTAATGATCTTGCTCGTGCTTCGACCGAGTATGTACCTGCTTCGACCTTCAAAATGCTTAATGCTTTGATCGGCCTTGAGCACCATAAGGCAACCACCACAGAAGTATTTAAGTGGGATGGTAAAAAAAGGTTATTCCCAGAATGGGAAAAGGACATGACCCTAGGCGATGCCATGAAAGCTTCCGCTATTCCAGTTTATCAAGATTTAGCTCGTCGTATTGGACTTGAGCTCATGTCTAAGGAAGTGAAGCGTGTTGGTTATGGCAATGCAGATATCGGTACCCAAGTCGATAATTTTTGGCTGGTGGGTCCTTTAAAAATTACTCCTCAGCAAGAGGCACAGTTTGCTTACAAGCTAGCTAATAAAACGCTTCCATTTAGCCAAAAAGTCCAAGATGAAGTGCAATCCATGCTATTCATAGAAGAAAAGAATGGAAACAAAATATACGCAAAAAGTGGTTGGGGATGGGATGTAAACCCACAAGTAGGCTGGTTAACTGGATGGGTTGTTCAGCCTCAAGGGAATATTGTAGCGTTCTCCCTTAACTTAGAAATGAAAAAAGGAATACCTAG
gb|KP881237.1|+|53-1205|ARO:3003883|ADC-77 [Acinetobacter baumannii] 	0	1097	63	1160	1152	126080+	1097	ATGCGATTTAAAAAAATTTCTTGTCTACTTTTATCCCCGCTTTTTATTTTTAGTACCTCAATTTATGCGGGCAATACACCAAAAGACCAAGAAATTAAAAAACTGGTAGATCAAAACTTTAAACCGTTATTAGAAAAATATGATGTGCCAGGTATGGCTGTGGGTGTTATTCAAAATAATAAAAAGTATGAAATGTATTATGGTCTTCAATCTGTTCAAGATAAAAAAGCCGTAAATAGCAGTACTATTTTTGAGCTAGGTTCTGTCAGTAAATTATTTACCGCGACAGCAGGTGGATATGCAAAAAATAAAGGAAAAATCTCTTTTGACGATACGCCTGGTAAGTATTGGAAAGAACTAAAAAATACACCGATTGACCAAGTTAACTTACTTCAACTCGCGACGTATACAAGTGGTAACCTTGCCTTGCAATTTCCAGATGAAGTAAAAACAGATCAGCAAGTTTTAACATTTTTTAAAGACTGGAAACCTAAAAACTCAATCGGTGAATATCGACAATATTCAAACCCAAGCATTGGTTTATTTGGAAAAGTTGTAGCTTTGTCTATGAATAAACCTTTCGACCAAGTCTTAGAAAAAACAATTTTTCCGGCCCTTGGCTTAAAACATAGCTATGTAAATGTACCTAAGACCCAGATGCAAAACTATGCTTTTGGCTATAACCAAGAAAATCAGCCGATTCGAGTTAACCCCGGCCCACTCGATGCCCCAGCATATGGCGTCAAATCGACACTACCCGACATGTTGAGTTTTATTCATGCCAACCTAAATCCACAAAAATATCCAGCAGATATTCAACGGGCAATTAATGAAACACATCAGGGTCGCTATCAAGTAAATACCATGTATCAGGCACTCGGTTGGGAAGAGTTTTCTTATCCGGCAACGTTACAAACTTTATTAGACAGTAATTCAGAACAGATTGTGATGAAACCTAATAAAGTGACTGCTATTTCAAAGGAACCTTCAGTTAAGATGTACCATAAAACTGGCTCAACTACCGGTTTCGGAACATATGTGGTGTTTATTCCTAAAGAAAATATTGGTTTAGTCATGTTAACCAATAAACGTATTCC
gb|FR848831|+|0-861|ARO:3001375|TEM-184 [Escherichia coli] 	0	806	46	852	861	3478183-	806	ATGAGTATTCAACATTTCCGTGTCGCCCTTATTCCCTTTTTTGCGGCATTTTGCCTTCCTGTTTTTGCTCACCCAGAAACGCTGGTGAAAGTAAAAGATGCTGAAGATCAGTTGGGTGCACGAGTGGGTTACATCGAGCTGGATCTCAACAGCGGTAAGATCCTTGAGAGTTTTCGCCCCGAAGAACGTTTTCCAATGATGAGCACTTTTAAAGTTCTGCTATGTGGTGCGGTATTATCCCGTGTTGACGCCGGGCAAGAGCAACTCGGTCGCCGCATACACTATTCTCAGAATGACTTGGTTGAGTACTCACCAGTCACAGAAAAGCATCTTACGGATGGCATGACAGTAAGAGAATTATGCAGTGCTGCCATAACCATGAGTGATAACACTGCGGCCAACTTACTTCTGACAACGATCGGAGGACCGAAGGAGCTAACCGCTTTTTTGCACAACATGGGGGATCATGTAACCCGCCTTGATCGTTGGGAACCGGAGCTGAATGAAGCCATACCAAACGACGAGCGTGACACCACGATGCCTGCAGCAATGGCAACAACGTTGCGCAAACTATTAACTGGCGAACTACTTACTCTAGCTTCCCGGCAACAATTAATAGACTGGATGGAGGCGGATAAAGTTGCAGGACCACTTCTGCGCTCGGCCCTTCCGGCTGGCTGGTTTATTGCTGATAAATCTGGAGCCGGTGAGCGTGGATCTCGCGGTATCATTGCAGCACTGGGGCCAGATGGTAAGCCCTCCCGTATCGTAGTTATCTACACGACGGGGAGTCAGGCAACTATGGA
gb|AM261837|+|73-865|ARO:3002619|aadA22 [Salmonella enterica subsp. enterica serovar Typhimurium] 	0	737	10	747	792	104600-	737	ATGAGGGAAGCGGTGATCGCCGAAGTATCGACTCAACTATCAGAGGTAGTTGGCGTCATCGAGCGCCATCTCGAACCGACGTTGCTGGCCGTACATTTGTACGGCTCCGCAGTGGATGGCGGCCTGAAGCCACACAGTGATATTGATTTGCTGGTTACGGTGACCGTAAGGCTTGATGAAACAACGCGGCGAGCTTTGATCAACGACCTTTTGGAAACTTCGGCTTCCCCTGGAGAGAGCGAGATTCTCCGCGCTGTAGAAGTCACCATTGTTGTGCACGACGACATCATTCCGTGGCGTTATCCAGCTAAGCGCGAACTGCAATTTGGAGAATGGCAGCGCAATGACATTCTTGCAGGTATCTTCGAGCCAGCCACGATCGACATTGATCTGGCTATCTTGCTGACAAAAGCAAGAGAACATAGCGTTGCCTTGGTAGGTCCAGCGGCGGAGGAACTCTTTGATCCGGTTCCTGAACAGGATCTATTTGAGGCGCTAAATGAAACCTTAACGCTATGGAACTCGCCGCCCGACTGGGCTGGCGATGAGCGAAATGTAGTGCTTACGTTGTCCCGCATTTGGTACAGCGCAGTAACCGGCAAAATCGCGCCGAAGGATGTCGCTGCCGACTGGGCAATGGAGCGCCTGCCGGCCCAGTATCAGCCCGTCATACTTGAAGCTAGACAGGCTTATCTTGGACAAGAAGAAGATCGCTTGGCCTCGCGCGCAGATCAGTT
gb|FJ666072|+|0-1194|ARO:3002508|PDC-9 [Pseudomonas aeruginosa] 	0	1139	35513	36652	1194	232416+	1139	ATGCGCGATACCAGATTCCCCTGCCTGTGCGGCATCGCCGCTTCCACACTGCTGTTCGCCACCACCCCGGCCATTGCCGATGAGGCCCCGGCGGATCGCCTGAAGGCACTGGTCGACGCCGCCGTACAACCGGTGATGAAGGCCAATGACATTCCGGGCCTGGCCGTAGCCATCAGCCTGAAAGGAGAACCGCATTACTTCAGCTATGGGCTGGCCTCGAAAGAGGACGGCCGCCGGGTGACGCCGGAGACCCTGTTCGAGATCGGCTCGGTGAGCAAGACCTTCACCGTCACCCTCGCCGGCTATGCCCTGGCCCAGGACAAGATGCGCCTCGACGACCGCGCCAGCCAGCACTGGCCGGCACTGCAGGGCAGCCGCTTCGACGGCATCAGCCTGCTCGACCTCGCGACCTATACCGCCGGCGGCTTGCCGCTGCAGTTCCCCGACTCGGTGCAGAAGGACCAGGCACAGATCCGCGACTACTACCGCCAGTGGCAGCCGACCTACGCGCCGGGCAGCCAGCGCCTCTATTCCAACCCGAGCATCGGCCTGTTCGGCTATCTCGCCGCGCGCAGCCTGGGCCAGCCGTTCGAACGGCTCATGGAGCAGCAATTGTTCCCGGCACTGGGCCTCGAACAGACCCACCTCGACGTGCCCGAGGCGGCGCTGGCGCAGTACGCCCAGGGCTACGGCAAGGACGACCGCCCGCTACGGGTCGGTCCCGGCCCGCTGGATGCCGAAGGCTACGGGGTGAAGACCAGCGCGGCCGACCTGCTGCGCTTCGTCGATGCCAACCTGCATCCGGAGCGCCTGGACAGGCCCTGGGCGCAGGCGCTCGATGCCACCCATCGCGGTTACTACAAGGTCGGCGACATGACCCAGGGCCTGGGCTGGGAAGCCTACGACTGGCCGATCTCCCTGAAGCGCCTGCAGGCCGGCAACTCGACGCCGATGGCGCTGCAACCACACAGGATCGCCAGGCTGCCCGCGCCACAGGCGCTGGAGGGCCAGCGCCTGCTGAACAAGACCGGCTCCACCAACGGCTTCGGCGCCTACGTGGCGTTCGTCCCGGGCCGCGACCTGGGCCTGGTGATCCTGGCCAACCGCAACTATCCCAATGCCGAGCGGGTGAAGATCGC
gb|AY956335|+|38-899|ARO:3001004|TEM-141 [Enterobacter cloacae] 	0	806	46	852	861	3478183-	806	ATGAGTATTCAACATTTCCGTGTCGCCCTTATTCCCTTTTTTGCGGCATTTTGCCTTCCTGTTTTTGCTCACCCAGAAACGCTGGTGAAAGTAAAAGATGCTGAAGATCAGTTGGGTGCACGAGTGGGTTACATCGAGCTGGATCTCAACAGCGGTAAGATCCTTGAGAGTTTTCGCCCCGAAGAACGTTTTCCAATGATGAGCACTTTTAAAGTTCTGCTATGTGGTGCGGTATTATCCCGTGTTGACGCCGGGCAAGAGCAACTCGGTCGCCGCATACACTATTCTCAGAATGACTTGGTTGAGTACTCACCAGTCACAGAAAAGCATCTTACGGATGGCATGACAGTAAGAGAATTATGCAGTGCTGCCATAACCATGAGTGATAACACTGCGGCCAACTTACTTCTGACAACGATCGGAGGACCGAAGGAGCTAACCGCTTTTTTGCACAACATGGGGGATCATGTAACCCGCCTTGATCGTTGGGAACCGGAGCTGAATGAAGCCATACCAAACGACGAGCGTGACACCACGATGCCTGCAGCAATGGCAACAACGTTGCGCAAACTATTAACTGGCGAACTACTTACTCTAGCTTCCCGGCAACAATTAATAGACTGGATGGAGGCGGATAAAGTTGCAGGACCACTTCTGCGCTCGGCCCTTCCGGCTGGCTGGTTTATTGCTGATAAATCTGGAGCCGGTGAGCGTGGATCTCGCGGTATCATTGCAGCACTGGGGCCAGATGGTAAGCCCTCCCGTATCGTAGTTATCTACACGACGGGGAGTCAGGCAACTATGGA
gb|JF795538|+|0-861|ARO:3001374|TEM-185 [Escherichia coli] 	0	806	46	852	861	3478183-	806	ATGAGTATTCAACATTTCCGTGTCGCCCTTATTCCCTTTTTTGCGGCATTTTGCCTTCCTGTTTTTGCTCACCCAGAAACGCTGGTGAAAGTAAAAGATGCTGAAGATCAGTTGGGTGCACGAGTGGGTTACATCGAGCTGGATCTCAACAGCGGTAAGATCCTTGAGAGTTTTCGCCCCGAAGAACGTTTTCCAATGATGAGCACTTTTAAAGTTCTGCTATGTGGTGCGGTATTATCCCGTGTTGACGCCGGGCAAGAGCAACTCGGTCGCCGCATACACTATTCTCAGAATGACTTGGTTGAGTACTCACCAGTCACAGAAAAGCATCTTACGGATGGCATGACAGTAAGAGAATTATGCAGTGCTGCCATAACCATGAGTGATAACACTGCGGCCAACTTACTTCTGACAACGATCGGAGGACCGAAGGAGCTAACCGCTTTTTTGCACAACATGGGGGATCATGTAACCCGCCTTGATCGTTGGGAACCGGAGCTGAATGAAGCCATACCAAACGACGAGCGTGACACCACGATGCCTGCAGCAATGGCAACAACGTTGCGCAAACTATTAACTGGCGAACTACTTACTCTAGCTTCCCGGCAACAATTAATAGACTGGATGGAGGCGGATAAAGTTGCAGGACCACTTCTGCGCTCGGCCCTTCCGGCTGGCTGGTTTATTGCTGATAAATCTGGAGCCGGTGAGCGTGGATCTCGCGGTATCATTGCAGCACTGGGGCCAGATGGTAAGCCCTCCCGTATCGTAGTTATCTACACGACGGGGAGTCAGGCAACTATGGA
gb|AJ809407|+|118-898|ARO:3002620|aadA23 [Salmonella enterica subsp. enterica serovar Agona] 	15	725	37	747	780	104600-	710	TCGACTCAACTATCAGAGGTAGTTGGCGTCATCGAGCGCCATCTCGAACCGACGTTGCTGGCCGTACATTTGTACGGCTCCGCAGTGGATGGCGGCCTGAAGCCACACAGTGATATTGATTTGCTGGTTACGGTGACCGTAAGGCTTGATGAAACAACGCGGCGAGCTTTGATCAACGACCTTTTGGAAACTTCGGCTTCCCCTGGAGAGAGCGAGATTCTCCGCGCTGTAGAAGTCACCATTGTTGTGCACGACGACATCATTCCGTGGCGTTATCCAGCTAAGCGCGAACTGCAATTTGGAGAATGGCAGCGCAATGACATTCTTGCAGGTATCTTCGAGCCAGCCACGATCGACATTGATCTGGCTATCTTGCTGACAAAAGCAAGAGAACATAGCGTTGCCTTGGTAGGTCCAGCGGCGGAGGAACTCTTTGATCCGGTTCCTGAACAGGATCTATTTGAGGCGCTAAATGAAACCTTAACGCTATGGAACTCGCCGCCCGACTGGGCTGGCGATGAGCGAAATGTAGTGCTTACGTTGTCCCGCATTTGGTACAGCGCAGTAACCGGCAAAATCGCGCCGAAGGATGTCGCTGCCGACTGGGCAATGGAGCGCCTGCCGGCCCAGTATCAGCCCGTCATACTTGAAGCTAGACAGGCTTATCTTGGACAAGAAGAAGATCGCTTGGCCTCGCGCGCAGATCAGTT
gb|KM087842|+|0-822|ARO:3001584|OXA-398 [Acinetobacter baumannii] 	0	767	80	847	822	254088-	767	ATGAATAAATATTTTACTTGCTATGTGGTTGCTTCTCTTTTTCTTTCTGGTTGTACGGTTCAGCATAATTTAATAAATGAAACCCCGAGTCAGATTGTTCAAGGACATAATCAGGTGATTCATCAATACTTTGATGAAAAAAACACCTCAGGTGTGCTGGTTATTCAAACAGATAAAAAAATTAATCTATATGGTAATGCTCTAAGCCGCGCAAATACAGAATATGTGCCAGCCTCTACATTTAAAATGTTGAATGCCCTGATCGGATTGGAGAACCAGAAAACGGATATTAATGAAATATTTAAATGGAAGGGCGAGAAAAGGTCATTTACCGCTTGGGAAAAAGACATGACACTAGGAGAAGCCATGAAGCTTTCTGCAGTCCCAGTCTATCAGGAACTTGCGCGACGTATCGGTCTTGATCTCATGCAAAAAGAAGTAAAACGTATTGGTTTCGGTAATGCTGAAATTGGACAGCAGGTTGATAATTTCTGGTTGGTAGGACCATTAAAGGTTACGCCTATTCAAGAGGTAGAGTTTGTTTCCCAATTAGCACATACACAGCTTCCATTTAGTGAAAAAGTGCAGGCTAATGTAAAAAATATGCTTCTTTTAGAAGAGAGTAATGGCTACAAAATTTTTGGAAAGACTGGTTGGGCAATGGATATAAAACCACAAGTGGGCTGGTTGACCGGCTGGGTTGAGCAGCCAGATGGAAAAATTGTCGCTTTTGCATTAAATATGGAAATGCGGTCAGAAATGCCGGC
gb|JN227084|+|308-1169|ARO:3001046|TEM-186 [Escherichia coli] 	0	806	46	852	861	3478183-	806	ATGAGTATTCAACATTTCCGTGTCGCCCTTATTCCCTTTTTTGCGGCATTTTGCCTTCCTGTTTTTGCTCACCCAGAAACGCTGGTGAAAGTAAAAGATGCTGAAGATCAGTTGGGTGCACGAGTGGGTTACATCGAGCTGGATCTCAACAGCGGTAAGATCCTTGAGAGTTTTCGCCCCGAAGAACGTTTTCCAATGATGAGCACTTTTAAAGTTCTGCTATGTGGTGCGGTATTATCCCGTGTTGACGCCGGGCAAGAGCAACTCGGTCGCCGCATACACTATTCTCAGAATGACTTGGTTGAGTACTCACCAGTCACAGAAAAGCATCTTACGGATGGCATGACAGTAAGAGAATTATGCAGTGCTGCCATAACCATGAGTGATAACACTGCGGCCAACTTACTTCTGACAACGATCGGAGGACCGAAGGAGCTAACCGCTTTTTTGCACAACATGGGGGATCATGTAACCCGCCTTGATCGTTGGGAACCGGAGCTGAATGAAGCCATACCAAACGACGAGCGTGACACCACGATGCCTGCAGCAATGGCAACAACGTTGCGCAAACTATTAACTGGCGAACTACTTACTCTAGCTTCCCGGCAACAATTAATAGACTGGATGGAGGCGGATAAAGTTGCAGGACCACTTCTGCGCTCGGCCCTTCCGGCTGGCTGGTTTATTGCTGATAAATCTGGAGCCGGTGAGCGTGGATCTCGCGGTATCATTGCAGCACTGGGGCCAGATGGTAAGCCCTCCCGTATCGTAGTTATCTACACGACGGGGAGTCAGGCAACTATGGA
gb|DQ388882|+|0-861|ARO:3001005|TEM-142 [Escherichia coli] 	0	806	46	852	861	3478183-	806	ATGAGTATTCAACATTTCCGTGTCGCCCTTATTCCCTTTTTTGCGGCATTTTGCCTTCCTGTTTTTGCTCACCCAGAAACGCTGGTGAAAGTAAAAGATGCTGAAGATCAGTTGGGTGCACGAGTGGGTTACATCGAGCTGGATCTCAACAGCGGTAAGATCCTTGAGAGTTTTCGCCCCGAAGAACGTTTTCCAATGATGAGCACTTTTAAAGTTCTGCTATGTGGTGCGGTATTATCCCGTGTTGACGCCGGGCAAGAGCAACTCGGTCGCCGCATACACTATTCTCAGAATGACTTGGTTGAGTACTCACCAGTCACAGAAAAGCATCTTACGGATGGCATGACAGTAAGAGAATTATGCAGTGCTGCCATAACCATGAGTGATAACACTGCGGCCAACTTACTTCTGACAACGATCGGAGGACCGAAGGAGCTAACCGCTTTTTTGCACAACATGGGGGATCATGTAACCCGCCTTGATCGTTGGGAACCGGAGCTGAATGAAGCCATACCAAACGACGAGCGTGACACCACGATGCCTGCAGCAATGGCAACAACGTTGCGCAAACTATTAACTGGCGAACTACTTACTCTAGCTTCCCGGCAACAATTAATAGACTGGATGGAGGCGGATAAAGTTGCAGGACCACTTCTGCGCTCGGCCCTTCCGGCTGGCTGGTTTATTGCTGATAAATCTGGAGCCGGTGAGCGTGGATCTCGCGGTATCATTGCAGCACTGGGGCCAGATGGTAAGCCCTCCCGTATCGTAGTTATCTACACGACGGGGAGTCAGGCAACTATGGA
gb|DQ286729|+|0-861|ARO:3000924|TEM-55 [Escherichia coli] 	0	806	46	852	861	3478183-	806	ATGAGTATTCAACATTTCCGTGTCGCCCTTATTCCCTTTTTTGCGGCATTTTGCCTTCCTGTTTTTGCTCACCCAGAAACGCTGGTGAAAGTAAAAGATGCTGAAGATCAGTTGGGTGCACGAGTGGGTTACATCGAGCTGGATCTCAACAGCGGTAAGATCCTTGAGAGTTTTCGCCCCGAAGAACGTTTTCCAATGATGAGCACTTTTAAAGTTCTGCTATGTGGTGCGGTATTATCCCGTGTTGACGCCGGGCAAGAGCAACTCGGTCGCCGCATACACTATTCTCAGAATGACTTGGTTGAGTACTCACCAGTCACAGAAAAGCATCTTACGGATGGCATGACAGTAAGAGAATTATGCAGTGCTGCCATAACCATGAGTGATAACACTGCGGCCAACTTACTTCTGACAACGATCGGAGGACCGAAGGAGCTAACCGCTTTTTTGCACAACATGGGGGATCATGTAACCCGCCTTGATCGTTGGGAACCGGAGCTGAATGAAGCCATACCAAACGACGAGCGTGACACCACGATGCCTGCAGCAATGGCAACAACGTTGCGCAAACTATTAACTGGCGAACTACTTACTCTAGCTTCCCGGCAACAATTAATAGACTGGATGGAGGCGGATAAAGTTGCAGGACCACTTCTGCGCTCGGCCCTTCCGGCTGGCTGGTTTATTGCTGATAAATCTGGAGCCGGTGAGCGTGGATCTCGCGGTATCATTGCAGCACTGGGGCCAGATGGTAAGCCCTCCCGTATCGTAGTTATCTACACGACGGGGAGTCAGGCAACTATGGA
gb|DQ677333|+|0-780|ARO:3002621|aadA24 [Salmonella enterica subsp. enterica serovar Newport] 	15	725	37	747	780	104600-	710	TCGACTCAACTATCAGAGGTAGTTGGCGTCATCGAGCGCCATCTCGAACCGACGTTGCTGGCCGTACATTTGTACGGCTCCGCAGTGGATGGCGGCCTGAAGCCACACAGTGATATTGATTTGCTGGTTACGGTGACCGTAAGGCTTGATGAAACAACGCGGCGAGCTTTGATCAACGACCTTTTGGAAACTTCGGCTTCCCCTGGAGAGAGCGAGATTCTCCGCGCTGTAGAAGTCACCATTGTTGTGCACGACGACATCATTCCGTGGCGTTATCCAGCTAAGCGCGAACTGCAATTTGGAGAATGGCAGCGCAATGACATTCTTGCAGGTATCTTCGAGCCAGCCACGATCGACATTGATCTGGCTATCTTGCTGACAAAAGCAAGAGAACATAGCGTTGCCTTGGTAGGTCCAGCGGCGGAGGAACTCTTTGATCCGGTTCCTGAACAGGATCTATTTGAGGCGCTAAATGAAACCTTAACGCTATGGAACTCGCCGCCCGACTGGGCTGGCGATGAGCGAAATGTAGTGCTTACGTTGTCCCGCATTTGGTACAGCGCAGTAACCGGCAAAATCGCGCCGAAGGATGTCGCTGCCGACTGGGCAATGGAGCGCCTGCCGGCCCAGTATCAGCCCGTCATACTTGAAGCTAGACAGGCTTATCTTGGACAAGAAGAAGATCGCTTGGCCTCGCGCGCAGATCAGTT
gb|KP881238.1|+|0-1152|ARO:3003884|ADC-78 [Acinetobacter baumannii] 	0	1097	63	1160	1152	126080+	1097	ATGCGATTTAAAAAAATTTCTTGTCTACTTTTATCCCCGCTTTTTATTTTTAGTACCTCAATTTATGCGGGCAATACACCAAAAGACCAAGAAATTAAAAAACTGGTAGATCAAAACTTTAAACCGTTATTAGAAAAATATGATGTGCCAGGTATGGCTGTGGGTGTTATTCAAAATAATAAAAAGTATGAAATGTATTATGGTCTTCAATCTGTTCAAGATAAAAAAGCCGTAAATAGCAGTACTATTTTTGAGCTAGGTTCTGTCAGTAAATTATTTACCGCGACAGCAGGTGGATATGCAAAAAATAAAGGAAAAATCTCTTTTGACGATACGCCTGGTAAGTATTGGAAAGAACTAAAAAATACACCGATTGACCAAGTTAACTTACTTCAACTCGCGACGTATACAAGTGGTAACCTTGCCTTGCAATTTCCAGATGAAGTAAAAACAGATCAGCAAGTTTTAACATTTTTTAAAGACTGGAAACCTAAAAACTCAATCGGTGAATATCGACAATATTCAAACCCAAGCATTGGTTTATTTGGAAAAGTTGTAGCTTTGTCTATGAATAAACCTTTCGACCAAGTCTTAGAAAAAACAATTTTTCCGGCCCTTGGCTTAAAACATAGCTATGTAAATGTACCTAAGACCCAGATGCAAAACTATGCTTTTGGCTATAACCAAGAAAATCAGCCGATTCGAGTTAACCCCGGCCCACTCGATGCCCCAGCATATGGCGTCAAATCGACACTACCCGACATGTTGAGTTTTATTCATGCCAACCTAAATCCACAAAAATATCCAGCAGATATTCAACGGGCAATTAATGAAACACATCAGGGTCGCTATCAAGTAAATACCATGTATCAGGCACTCGGTTGGGAAGAGTTTTCTTATCCGGCAACGTTACAAACTTTATTAGACAGTAATTCAGAACAGATTGTGATGAAACCTAATAAAGTGACTGCTATTTCAAAGGAACCTTCAGTTAAGATGTACCATAAAACTGGCTCAACTACCGGTTTCGGAACATATGTGGTGTTTATTCCTAAAGAAAATATTGGTTTAGTCATGTTAACCAATAAACGTATTCC
gb|KR057759.1|+|0-1107|ARO:3004353|PDC-90 [Pseudomonas aeruginosa] 	0	1052	35591	36652	1107	232416+	1061	GATGAGGCCCCGGCGGATCGCCTGAAGGCACTGGTCGACGCCGCCGTACAACCGGTGATGAAGGCCAATGACATTCCGGGCCTGGCCGTAGCCATCAGCCTGAAAGGAGAACCGCATTACTTCAGCTATGGGCTGGCCTCGAAAGAGGACGGCCGCCGGGTGACGCCGGAGACCCTGTTCGAGATCGGCTCGGTGAGCAAGACCTTCACCGTCACCCTCGCCGGCTATGCCCTGGCCCAGGACAAGATGCGCCTCGACGACCGCGCCAGCCAGCACTGGCCGGCACTGCAGGGCAGCCGCTTCGACGGCATCAGCCTGCTCGACCTCGCGACCTATACCGCCGGCGGCTTGCCGCTGCAGTTCCCCGACTCGGTGCAGAAGGACCAGGCACAGATCCGCGACTACTACCGCCAGTGGCAGCCGACCTACGCGCCGGGCAGCCAGCGCCTCTATTCCAACCCGAGCATCGGCCTGTTCGGCTATCTCGCCGCGCGCAGCCTGGGCCAGCCGTTCGAACGGCTCATGGAGCAGCAATTGTTCCCGGCACTGGGCCTCGAACAGACCCACCTCGACGTGCCCGAGGCGGCGCTGGCGCAGTACGCCCAGGGCTACGGCAAGGACGACCGCCCGCTACGGGTCGGTCCCGGCCCGCTGGATGCCGAAGGCTACGGGGTGAAGACCAGCGCGGCCGACCTGCTGCGCTTCGTCGATGCCAACCTGCATCCGGAGCGCCTGGACAGGCCCTGGGCGCAGGCGCTCGATGCCACCCATCGCGGTTACTACAAGGTCGGCGACATGACCCAGGGCCTGGGCTGGGAAGCCTACGACTGGCCGATCTCCCTGAAGCGCCTGCAGGCCGGCAACTCGACGCCGATGGCGCTGCAACCACACAGGATCGCCAGGCTGCCCGCGCCACAGGCGCTGGAGGGCCAGCGCCTGCTGAACAAGACCGGCTCCACCAACGGCTTCGGCGCCTACGTGGCGTTCGTCCCGGGCCGCGACCTGGGCCTGGTGATCCTGGCCAACCGCAACTATCCCAATGCCGAGCGGGTGAAGATCGC
gb|CP003022|+|336788-337580|ARO:3003197|aadA25 [Pasteurella multocida 36950] 	0	737	10	747	792	104600-	737	ATGAGGGAAGCGGTGATCGCCGAAGTATCGACTCAACTATCAGAGGTAGTTGGCGTCATCGAGCGCCATCTCGAACCGACGTTGCTGGCCGTACATTTGTACGGCTCCGCAGTGGATGGCGGCCTGAAGCCACACAGTGATATTGATTTGCTGGTTACGGTGACCGTAAGGCTTGATGAAACAACGCGGCGAGCTTTGATCAACGACCTTTTGGAAACTTCGGCTTCCCCTGGAGAGAGCGAGATTCTCCGCGCTGTAGAAGTCACCATTGTTGTGCACGACGACATCATTCCGTGGCGTTATCCAGCTAAGCGCGAACTGCAATTTGGAGAATGGCAGCGCAATGACATTCTTGCAGGTATCTTCGAGCCAGCCACGATCGACATTGATCTGGCTATCTTGCTGACAAAAGCAAGAGAACATAGCGTTGCCTTGGTAGGTCCAGCGGCGGAGGAACTCTTTGATCCGGTTCCTGAACAGGATCTATTTGAGGCGCTAAATGAAACCTTAACGCTATGGAACTCGCCGCCCGACTGGGCTGGCGATGAGCGAAATGTAGTGCTTACGTTGTCCCGCATTTGGTACAGCGCAGTAACCGGCAAAATCGCGCCGAAGGATGTCGCTGCCGACTGGGCAATGGAGCGCCTGCCGGCCCAGTATCAGCCCGTCATACTTGAAGCTAGACAGGCTTATCTTGGACAAGAAGAAGATCGCTTGGCCTCGCGCGCAGATCAGTT
gb|HM246246|+|211-1069|ARO:3001047|TEM-187 [Proteus mirabilis] 	0	802	46	848	858	3478183-	802	ATGAGTATTCAACATTTCCGTGTCGCCCTTATTCCCTTTTTTGCGGCATTTTGCCTTCCTGTTTTTGCTCACCCAGAAACGCTGGTGAAAGTAAAAGATGCTGAAGATCAGTTGGGTGCACGAGTGGGTTACATCGAGCTGGATCTCAACAGCGGTAAGATCCTTGAGAGTTTTCGCCCCGAAGAACGTTTTCCAATGATGAGCACTTTTAAAGTTCTGCTATGTGGTGCGGTATTATCCCGTGTTGACGCCGGGCAAGAGCAACTCGGTCGCCGCATACACTATTCTCAGAATGACTTGGTTGAGTACTCACCAGTCACAGAAAAGCATCTTACGGATGGCATGACAGTAAGAGAATTATGCAGTGCTGCCATAACCATGAGTGATAACACTGCGGCCAACTTACTTCTGACAACGATCGGAGGACCGAAGGAGCTAACCGCTTTTTTGCACAACATGGGGGATCATGTAACCCGCCTTGATCGTTGGGAACCGGAGCTGAATGAAGCCATACCAAACGACGAGCGTGACACCACGATGCCTGCAGCAATGGCAACAACGTTGCGCAAACTATTAACTGGCGAACTACTTACTCTAGCTTCCCGGCAACAATTAATAGACTGGATGGAGGCGGATAAAGTTGCAGGACCACTTCTGCGCTCGGCCCTTCCGGCTGGCTGGTTTATTGCTGATAAATCTGGAGCCGGTGAGCGTGGATCTCGCGGTATCATTGCAGCACTGGGGCCAGATGGTAAGCCCTCCCGTATCGTAGTTATCTACACGACGGGGAGTCAGGCAACTA
gb|KJ780078.1|+|0-825|ARO:3001586|OXA-400 [Acinetobacter baumannii] 	0	770	54149	54919	825	246080-	770	ATGAACATTAAAGCACTCTTACTTATAACAAGCGCTATTTTTATTTCAGCCTGCTCACCTTATATAGTGACTGCTAATCCAAATCACAGCGCTTCAAAATCTGATGTAAAAGCAGAGAAAATTAAAAATTTATTTAACGAAGCACACACTACGGGTGTTTTAGTTATCCAACAAGGCCAAACTCAACAAAGCTATGGTAATGATCTTGCTCGTGCTTCGACCGAGTATGTACCTGCTTCGACCTTCAAAATGCTTAATGCTTTGATCGGCCTTGAGCACCATAAGGCAACCACCACAGAAGTATTTAAGTGGGATGGTAAAAAAAGGTTATTCCCAGAATGGGAAAAGGACATGACCCTAGGCGATGCCATGAAAGCTTCCGCTATTCCAGTTTATCAAGATTTAGCTCGTCGTATTGGACTTGAGCTCATGTCTAAGGAAGTGAAGCGTGTTGGTTATGGCAATGCAGATATCGGTACCCAAGTCGATAATTTTTGGCTGGTGGGTCCTTTAAAAATTACTCCTCAGCAAGAGGCACAGTTTGCTTACAAGCTAGCTAATAAAACGCTTCCATTTAGCCAAAAAGTCCAAGATGAAGTGCAATCCATGCTATTCATAGAAGAAAAGAATGGAAACAAAATATACGCAAAAAGTGGTTGGGGATGGGATGTAAACCCACAAGTAGGCTGGTTAACTGGATGGGTTGTTCAGCCTCAAGGGAATATTGTAGCGTTCTCCCTTAACTTAGAAATGAAAAAAGGAATACCTAG
gb|FJ405211|+|0-861|ARO:3000926|TEM-57 [Escherichia coli] 	0	806	46	852	861	3478183-	806	ATGAGTATTCAACATTTCCGTGTCGCCCTTATTCCCTTTTTTGCGGCATTTTGCCTTCCTGTTTTTGCTCACCCAGAAACGCTGGTGAAAGTAAAAGATGCTGAAGATCAGTTGGGTGCACGAGTGGGTTACATCGAGCTGGATCTCAACAGCGGTAAGATCCTTGAGAGTTTTCGCCCCGAAGAACGTTTTCCAATGATGAGCACTTTTAAAGTTCTGCTATGTGGTGCGGTATTATCCCGTGTTGACGCCGGGCAAGAGCAACTCGGTCGCCGCATACACTATTCTCAGAATGACTTGGTTGAGTACTCACCAGTCACAGAAAAGCATCTTACGGATGGCATGACAGTAAGAGAATTATGCAGTGCTGCCATAACCATGAGTGATAACACTGCGGCCAACTTACTTCTGACAACGATCGGAGGACCGAAGGAGCTAACCGCTTTTTTGCACAACATGGGGGATCATGTAACCCGCCTTGATCGTTGGGAACCGGAGCTGAATGAAGCCATACCAAACGACGAGCGTGACACCACGATGCCTGCAGCAATGGCAACAACGTTGCGCAAACTATTAACTGGCGAACTACTTACTCTAGCTTCCCGGCAACAATTAATAGACTGGATGGAGGCGGATAAAGTTGCAGGACCACTTCTGCGCTCGGCCCTTCCGGCTGGCTGGTTTATTGCTGATAAATCTGGAGCCGGTGAGCGTGGATCTCGCGGTATCATTGCAGCACTGGGGCCAGATGGTAAGCCCTCCCGTATCGTAGTTATCTACACGACGGGGAGTCAGGCAACTATGGA
gb|JN211012|+|213-1074|ARO:3001048|TEM-188 [Salmonella enterica] 	0	806	46	852	861	3478183-	806	ATGAGTATTCAACATTTCCGTGTCGCCCTTATTCCCTTTTTTGCGGCATTTTGCCTTCCTGTTTTTGCTCACCCAGAAACGCTGGTGAAAGTAAAAGATGCTGAAGATCAGTTGGGTGCACGAGTGGGTTACATCGAGCTGGATCTCAACAGCGGTAAGATCCTTGAGAGTTTTCGCCCCGAAGAACGTTTTCCAATGATGAGCACTTTTAAAGTTCTGCTATGTGGTGCGGTATTATCCCGTGTTGACGCCGGGCAAGAGCAACTCGGTCGCCGCATACACTATTCTCAGAATGACTTGGTTGAGTACTCACCAGTCACAGAAAAGCATCTTACGGATGGCATGACAGTAAGAGAATTATGCAGTGCTGCCATAACCATGAGTGATAACACTGCGGCCAACTTACTTCTGACAACGATCGGAGGACCGAAGGAGCTAACCGCTTTTTTGCACAACATGGGGGATCATGTAACCCGCCTTGATCGTTGGGAACCGGAGCTGAATGAAGCCATACCAAACGACGAGCGTGACACCACGATGCCTGCAGCAATGGCAACAACGTTGCGCAAACTATTAACTGGCGAACTACTTACTCTAGCTTCCCGGCAACAATTAATAGACTGGATGGAGGCGGATAAAGTTGCAGGACCACTTCTGCGCTCGGCCCTTCCGGCTGGCTGGTTTATTGCTGATAAATCTGGAGCCGGTGAGCGTGGATCTCGCGGTATCATTGCAGCACTGGGGCCAGATGGTAAGCCCTCCCGTATCGTAGTTATCTACACGACGGGGAGTCAGGCAACTATGGA
gb|AF047479|+|1295-2087|ARO:3002603|aadA3 [Plasmid NR79] 	12	279	0	267	792	41790385+	267	GTGACCATCGAAATTTCGAACCAACTATCAGAGGTGCTAAGCGTCATTGAGCGCCATCTGGAATCAACGTTGCTGGCCGTGCATTTGTACGGCTCCGCAGTGGATGGCGGCCTGAAGCCATACAGCGATATTGATTTGTTGGTTACTGTGGCCGTAAAGCTTGATGAAACGACGCGGCGAGCATTGCTCAATGACCTTATGGAGGCTTCGGCTTTCCCTGGCGAGAGCGAGACGCTCCGCGCTATAGAAGTCACCCTTGTCGTGCAT
gb|AF062386|+|30-862|ARO:3000928|TEM-59 [Klebsiella oxytoca] 	0	776	46	822	831	3478183-	776	ATGAGTATTCAACATTTCCGTGTCGCCCTTATTCCCTTTTTTGCGGCATTTTGCCTTCCTGTTTTTGCTCACCCAGAAACGCTGGTGAAAGTAAAAGATGCTGAAGATCAGTTGGGTGCACGAGTGGGTTACATCGAGCTGGATCTCAACAGCGGTAAGATCCTTGAGAGTTTTCGCCCCGAAGAACGTTTTCCAATGATGAGCACTTTTAAAGTTCTGCTATGTGGTGCGGTATTATCCCGTGTTGACGCCGGGCAAGAGCAACTCGGTCGCCGCATACACTATTCTCAGAATGACTTGGTTGAGTACTCACCAGTCACAGAAAAGCATCTTACGGATGGCATGACAGTAAGAGAATTATGCAGTGCTGCCATAACCATGAGTGATAACACTGCGGCCAACTTACTTCTGACAACGATCGGAGGACCGAAGGAGCTAACCGCTTTTTTGCACAACATGGGGGATCATGTAACCCGCCTTGATCGTTGGGAACCGGAGCTGAATGAAGCCATACCAAACGACGAGCGTGACACCACGATGCCTGCAGCAATGGCAACAACGTTGCGCAAACTATTAACTGGCGAACTACTTACTCTAGCTTCCCGGCAACAATTAATAGACTGGATGGAGGCGGATAAAGTTGCAGGACCACTTCTGCGCTCGGCCCTTCCGGCTGGCTGGTTTATTGCTGATAAATCTGGAGCCGGTGAGCGTGGATCTCGCGGTATCATTGCAGCACTGGGGCCAGATGGTAAGCCCTCCCGTATCGTAGTTAT
gb|DQ075245|+|217-1078|ARO:3001006|TEM-143 [Escherichia coli] 	0	806	46	852	861	3478183-	806	ATGAGTATTCAACATTTCCGTGTCGCCCTTATTCCCTTTTTTGCGGCATTTTGCCTTCCTGTTTTTGCTCACCCAGAAACGCTGGTGAAAGTAAAAGATGCTGAAGATCAGTTGGGTGCACGAGTGGGTTACATCGAGCTGGATCTCAACAGCGGTAAGATCCTTGAGAGTTTTCGCCCCGAAGAACGTTTTCCAATGATGAGCACTTTTAAAGTTCTGCTATGTGGTGCGGTATTATCCCGTGTTGACGCCGGGCAAGAGCAACTCGGTCGCCGCATACACTATTCTCAGAATGACTTGGTTGAGTACTCACCAGTCACAGAAAAGCATCTTACGGATGGCATGACAGTAAGAGAATTATGCAGTGCTGCCATAACCATGAGTGATAACACTGCGGCCAACTTACTTCTGACAACGATCGGAGGACCGAAGGAGCTAACCGCTTTTTTGCACAACATGGGGGATCATGTAACCCGCCTTGATCGTTGGGAACCGGAGCTGAATGAAGCCATACCAAACGACGAGCGTGACACCACGATGCCTGCAGCAATGGCAACAACGTTGCGCAAACTATTAACTGGCGAACTACTTACTCTAGCTTCCCGGCAACAATTAATAGACTGGATGGAGGCGGATAAAGTTGCAGGACCACTTCTGCGCTCGGCCCTTCCGGCTGGCTGGTTTATTGCTGATAAATCTGGAGCCGGTGAGCGTGGATCTCGCGGTATCATTGCAGCACTGGGGCCAGATGGTAAGCCCTCCCGTATCGTAGTTATCTACACGACGGGGAGTCAGGCAACTATGGA
gb|KP881239.1|+|0-1152|ARO:3003885|ADC-79 [Acinetobacter baumannii] 	5	1097	68	1160	1152	126080+	1092	ATTTAAAAAAATTTCTTGTCTACTTTTATCCCCGCTTTTTATTTTTAGTACCTCAATTTATGCGGGCAATACACCAAAAGACCAAGAAATTAAAAAACTGGTAGATCAAAACTTTAAACCGTTATTAGAAAAATATGATGTGCCAGGTATGGCTGTGGGTGTTATTCAAAATAATAAAAAGTATGAAATGTATTATGGTCTTCAATCTGTTCAAGATAAAAAAGCCGTAAATAGCAGTACTATTTTTGAGCTAGGTTCTGTCAGTAAATTATTTACCGCGACAGCAGGTGGATATGCAAAAAATAAAGGAAAAATCTCTTTTGACGATACGCCTGGTAAGTATTGGAAAGAACTAAAAAATACACCGATTGACCAAGTTAACTTACTTCAACTCGCGACGTATACAAGTGGTAACCTTGCCTTGCAATTTCCAGATGAAGTAAAAACAGATCAGCAAGTTTTAACATTTTTTAAAGACTGGAAACCTAAAAACTCAATCGGTGAATATCGACAATATTCAAACCCAAGCATTGGTTTATTTGGAAAAGTTGTAGCTTTGTCTATGAATAAACCTTTCGACCAAGTCTTAGAAAAAACAATTTTTCCGGCCCTTGGCTTAAAACATAGCTATGTAAATGTACCTAAGACCCAGATGCAAAACTATGCTTTTGGCTATAACCAAGAAAATCAGCCGATTCGAGTTAACCCCGGCCCACTCGATGCCCCAGCATATGGCGTCAAATCGACACTACCCGACATGTTGAGTTTTATTCATGCCAACCTAAATCCACAAAAATATCCAGCAGATATTCAACGGGCAATTAATGAAACACATCAGGGTCGCTATCAAGTAAATACCATGTATCAGGCACTCGGTTGGGAAGAGTTTTCTTATCCGGCAACGTTACAAACTTTATTAGACAGTAATTCAGAACAGATTGTGATGAAACCTAATAAAGTGACTGCTATTTCAAAGGAACCTTCAGTTAAGATGTACCATAAAACTGGCTCAACTACCGGTTTCGGAACATATGTGGTGTTTATTCCTAAAGAAAATATTGGTTTAGTCATGTTAACCAATAAACGTATTCC
gb|KJ780076.1|+|0-825|ARO:3001587|OXA-401 [Acinetobacter baumannii] 	0	770	54149	54919	825	246080-	770	ATGAACATTAAAGCACTCTTACTTATAACAAGCGCTATTTTTATTTCAGCCTGCTCACCTTATATAGTGACTGCTAATCCAAATCACAGCGCTTCAAAATCTGATGTAAAAGCAGAGAAAATTAAAAATTTATTTAACGAAGCACACACTACGGGTGTTTTAGTTATCCAACAAGGCCAAACTCAACAAAGCTATGGTAATGATCTTGCTCGTGCTTCGACCGAGTATGTACCTGCTTCGACCTTCAAAATGCTTAATGCTTTGATCGGCCTTGAGCACCATAAGGCAACCACCACAGAAGTATTTAAGTGGGATGGTAAAAAAAGGTTATTCCCAGAATGGGAAAAGGACATGACCCTAGGCGATGCCATGAAAGCTTCCGCTATTCCAGTTTATCAAGATTTAGCTCGTCGTATTGGACTTGAGCTCATGTCTAAGGAAGTGAAGCGTGTTGGTTATGGCAATGCAGATATCGGTACCCAAGTCGATAATTTTTGGCTGGTGGGTCCTTTAAAAATTACTCCTCAGCAAGAGGCACAGTTTGCTTACAAGCTAGCTAATAAAACGCTTCCATTTAGCCAAAAAGTCCAAGATGAAGTGCAATCCATGCTATTCATAGAAGAAAAGAATGGAAACAAAATATACGCAAAAAGTGGTTGGGGATGGGATGTAAACCCACAAGTAGGCTGGTTAACTGGATGGGTTGTTCAGCCTCAAGGGAATATTGTAGCGTTCTCCCTTAACTTAGAAATGAAAAAAGGAATACCTAG
gb|AJ222769.3|+|3686-5606|ARO:3000194|tetW [Butyrivibrio fibrisolvens] 	0	1865	745	2610	1920	211793-	1865	ATGAAAATAATCAATATTGGAATTCTTGCCCATGTAGACGCTGGAAAGACGACCTTGACGGAGAGCCTGCTATATGCCAGCGGAGCCATTTCAGAACCGGGGAGCGTCGAAAAAGGGACAACGAGGACGGACACCATGTTTTTGGAGCGGCAGCGTGGGATTACCATTCAAGCGGCAGTCACTTCCTTCCAGTGGCACAGATGTAAAGTCAACATTGTGGATACGCCCGGCCACATGGATTTTTTGGCGGAGGTGTACCGCTCTTTGGCTGTTTTAGATGGGGCCATCTTGGTGATCTCCGCTAAAGATGGCGTGCAGGCCCAGACCCGTATTCTGTTCCATGCCCTGCGGAAAATGAACATTCCCACCGTTATCTTTATCAACAAGATCGACCAGGCTGGCGTTGATTTGCAGAGCGTGGTTCAGTCTGTTCGGGATAAGCTCTCCGCCGATATTATCATCAAGCAGACGGTGTCGCTGTCCCCGGAAATAGTCCTGGAGGAAAATACCGACATAGAAGCATGGGATGCGGTCATCGAAAATAACGATAAATTATTGGAAAAGTATATCGCAGGAGAACCAATCAGCCGGGAAAAACTTGTGCGGGAGGAACAGCGGCGGGTTCAAGACGCCTCCCTGTTCCCGGTCTATTATGGCAGCGCCAAAAAGGGCCTTGGCATTCAACCGTTGATGGATGCGGTGACAGGGCTGTTCCAACCGATTGGGGAACAGGGGAGCGCCGCCCTATGCGGCAGCGTTTTCAAGGTGGAGTATACAGATTGCGGCCAGCGGCGTGTCTATCTACGGCTATACAGCGGAACGCTGCGCCTGCGGGATACGGTGGCCCTGGCCGGGAGAGAAAAGCTGAAAATCACAGAGATGCGTATTCCATCCAAAGGGGAAATTGTTCGGACAGACACCGCTTATCCGGGTGAAATTGTTATCCTTCCCAGCGACAGCGTGAGGTTAAACGATGTATTAGGGGACCCAACCCGGCTCCCTCGTAAAAGGTGGCGTGAGGACCCCCTCCCCATGCTGCGGACGTCGATTGCGCCGAAAACGGCAGCGCAAAGAGAACGGCTGCTGGACGCTCTTACGCAACTTGCGGATACTGACCCGCTTTTGCGCTGCGAGGTGGATTCCATCACCCATGAGATCATTCTTTCTTTTTTGGGCCGGGTGCAGTTGGAGGTTGTTTCCGCTTTGCTGTCGGAAAAATACAAGCTTGAAACAGTGGTAAAGGAACCCACCGTCATTTATATGGAGCGGCCGCTCAAAGCAGCCAGCCACACCATCCATATCGAGGTGCCGCCCAACCCGTTTTGGGCATCCATCGGACTGTCTGTTACACCACTCCCGCTTGGCTCCGGTGTACAATACGAGAGCCGGGTTTCGCTGGGATACTTGAACCAGAGTTTTCAAAACGCTGTCAGGGATGGTATCCGTTACGGGCTGGAGCAGGGCTTGTTCGGCTGGAACGTAACGGACTGTAAGATTTGCTTTGAATACGGGCTTTATTACAGTCCGGTCAGCACGCCGGCGGACTTCCGCTCATTGGCCCCGATTGTATTGGAACAGGCATTGAAGGAATCAGGGACGCAACTGCTGGAACCTTATCTCTCCTTCACCCTCTATGCGCCCCGGGAATATCTTTCCAGGGCTTATCATGATGCACCGAAATACTGTGCCACCATCGAAACGGTCCAGGTAAAAAAGGATGAAGTTGTCTTTACTGGCGAGATTCCCGCCCGCTGTATACAGGCATACCGTACTGATCTGGCCTTTTACACCAACGGGCAGAGCGTATGCCTTACAGAACTGAAAGGGTATCAGGCCGCTGTCGGCAAGCCAGTCATCCAGCCCCG
gb|AM049399|+|0-861|ARO:3001007|TEM-144 [Salmonella enterica subsp. enterica serovar Derby] 	0	806	46	852	861	3478183-	806	ATGAGTATTCAACATTTCCGTGTCGCCCTTATTCCCTTTTTTGCGGCATTTTGCCTTCCTGTTTTTGCTCACCCAGAAACGCTGGTGAAAGTAAAAGATGCTGAAGATCAGTTGGGTGCACGAGTGGGTTACATCGAGCTGGATCTCAACAGCGGTAAGATCCTTGAGAGTTTTCGCCCCGAAGAACGTTTTCCAATGATGAGCACTTTTAAAGTTCTGCTATGTGGTGCGGTATTATCCCGTGTTGACGCCGGGCAAGAGCAACTCGGTCGCCGCATACACTATTCTCAGAATGACTTGGTTGAGTACTCACCAGTCACAGAAAAGCATCTTACGGATGGCATGACAGTAAGAGAATTATGCAGTGCTGCCATAACCATGAGTGATAACACTGCGGCCAACTTACTTCTGACAACGATCGGAGGACCGAAGGAGCTAACCGCTTTTTTGCACAACATGGGGGATCATGTAACCCGCCTTGATCGTTGGGAACCGGAGCTGAATGAAGCCATACCAAACGACGAGCGTGACACCACGATGCCTGCAGCAATGGCAACAACGTTGCGCAAACTATTAACTGGCGAACTACTTACTCTAGCTTCCCGGCAACAATTAATAGACTGGATGGAGGCGGATAAAGTTGCAGGACCACTTCTGCGCTCGGCCCTTCCGGCTGGCTGGTTTATTGCTGATAAATCTGGAGCCGGTGAGCGTGGATCTCGCGGTATCATTGCAGCACTGGGGCCAGATGGTAAGCCCTCCCGTATCGTAGTTATCTACACGACGGGGAGTCAGGCAACTATGGA
gb|AY139603|+|106-898|ARO:3002608|aadA8 [uncultured bacterium] 	12,0	279,737	0,10	267,747	792	41790385+;104600-	267;737	GTGACCATCGAAATTTCGAACCAACTATCAGAGGTGCTAAGCGTCATTGAGCGCCATCTGGAATCAACGTTGCTGGCCGTGCATTTGTACGGCTCCGCAGTGGATGGCGGCCTGAAGCCATACAGCGATATTGATTTGTTGGTTACTGTGGCCGTAAAGCTTGATGAAACGACGCGGCGAGCATTGCTCAATGACCTTATGGAGGCTTCGGCTTTCCCTGGCGAGAGCGAGACGCTCCGCGCTATAGAAGTCACCCTTGTCGTGCAT;ATGAGGGAAGCGGTGATCGCCGAAGTATCGACTCAACTATCAGAGGTAGTTGGCGTCATCGAGCGCCATCTCGAACCGACGTTGCTGGCCGTACATTTGTACGGCTCCGCAGTGGATGGCGGCCTGAAGCCACACAGTGATATTGATTTGCTGGTTACGGTGACCGTAAGGCTTGATGAAACAACGCGGCGAGCTTTGATCAACGACCTTTTGGAAACTTCGGCTTCCCCTGGAGAGAGCGAGATTCTCCGCGCTGTAGAAGTCACCATTGTTGTGCACGACGACATCATTCCGTGGCGTTATCCAGCTAAGCGCGAACTGCAATTTGGAGAATGGCAGCGCAATGACATTCTTGCAGGTATCTTCGAGCCAGCCACGATCGACATTGATCTGGCTATCTTGCTGACAAAAGCAAGAGAACATAGCGTTGCCTTGGTAGGTCCAGCGGCGGAGGAACTCTTTGATCCGGTTCCTGAACAGGATCTATTTGAGGCGCTAAATGAAACCTTAACGCTATGGAACTCGCCGCCCGACTGGGCTGGCGATGAGCGAAATGTAGTGCTTACGTTGTCCCGCATTTGGTACAGCGCAGTAACCGGCAAAATCGCGCCGAAGGATGTCGCTGCCGACTGGGCAATGGAGCGCCTGCCGGCCCAGTATCAGCCCGTCATACTTGAAGCTAGACAGGCTTATCTTGGACAAGAAGAAGATCGCTTGGCCTCGCGCGCAGATCAGTT
gb|KR057760.1|+|0-1104|ARO:3004354|PDC-91 [Pseudomonas aeruginosa] 	0	1049	35591	36652	1104	232416+	1061	GATGAGGCCCCGGCGGATCGCCTGAAGGCACTGGTCGACGCCGCCGTACAACCGGTGATGAAGGCCAATGACATTCCGGGCCTGGCCGTAGCCATCAGCCTGAAAGGAGAACCGCATTACTTCAGCTATGGGCTGGCCTCGAAAGAGGACGGCCGCCGGGTGACGCCGGAGACCCTGTTCGAGATCGGCTCGGTGAGCAAGACCTTCACCGTCACCCTCGCCGGCTATGCCCTGGCCCAGGACAAGATGCGCCTCGACGACCGCGCCAGCCAGCACTGGCCGGCACTGCAGGGCAGCCGCTTCGACGGCATCAGCCTGCTCGACCTCGCGACCTATACCGCCGGCGGCTTGCCGCTGCAGTTCCCCGACTCGGTGCAGAAGGACCAGGCACAGATCCGCGACTACTACCGCCAGTGGCAGCCGACCTACGCGCCGGGCAGCCAGCGCCTCTATTCCAACCCGAGCATCGGCCTGTTCGGCTATCTCGCCGCGCGCAGCCTGGGCCAGCCGTTCGAACGGCTCATGGAGCAGCAATTGTTCCCGGCACTGGGCCTCGAACAGACCCACCTCGACGTGCCCGAGGCGGCGCTGGCGCAGTACGCCCAGGGCTACGGCAAGGACGACCGCCCGCTACGGGTCGGTCCCGGCCCGCTGGATGCCGAAGGCTACGGGGTGAAGACCAGCGCGGCCGACCTGCTGCGCTTCGTCGATGCCAACCTGCATCCGGAGCGCCTGGACAGGCCCTGGGCGCAGGCGCTCGATGCCACCCATCGCGGTTACTACAAGGTCGGCGACATGACCCAGGGCCTGGGCTGGGAAGCCTACGACTGGCCGATCTCCCTGAAGCGCCTGCAGGCCGGCAACTCGACGCCGATGGCGCTGCAACCACACAGGATCGCCAGGCTGCCCGCGCCACAGGCGCTGGAGGGCCAGCGCCTGCTGAACAAGACCGGCTCCACCAACGGCTTCGGCGCCTACGTGGCGTTCGTCCCGGGCCGCGACCTGGGCCTGGTGATCCTGGCCAACCGCAACTATCCCAATGCCGAGCGGGTGAAGATCGC
gb|JN254627|+|0-861|ARO:3001049|TEM-189 [Escherichia coli] 	0	806	46	852	861	3478183-	806	ATGAGTATTCAACATTTCCGTGTCGCCCTTATTCCCTTTTTTGCGGCATTTTGCCTTCCTGTTTTTGCTCACCCAGAAACGCTGGTGAAAGTAAAAGATGCTGAAGATCAGTTGGGTGCACGAGTGGGTTACATCGAGCTGGATCTCAACAGCGGTAAGATCCTTGAGAGTTTTCGCCCCGAAGAACGTTTTCCAATGATGAGCACTTTTAAAGTTCTGCTATGTGGTGCGGTATTATCCCGTGTTGACGCCGGGCAAGAGCAACTCGGTCGCCGCATACACTATTCTCAGAATGACTTGGTTGAGTACTCACCAGTCACAGAAAAGCATCTTACGGATGGCATGACAGTAAGAGAATTATGCAGTGCTGCCATAACCATGAGTGATAACACTGCGGCCAACTTACTTCTGACAACGATCGGAGGACCGAAGGAGCTAACCGCTTTTTTGCACAACATGGGGGATCATGTAACCCGCCTTGATCGTTGGGAACCGGAGCTGAATGAAGCCATACCAAACGACGAGCGTGACACCACGATGCCTGCAGCAATGGCAACAACGTTGCGCAAACTATTAACTGGCGAACTACTTACTCTAGCTTCCCGGCAACAATTAATAGACTGGATGGAGGCGGATAAAGTTGCAGGACCACTTCTGCGCTCGGCCCTTCCGGCTGGCTGGTTTATTGCTGATAAATCTGGAGCCGGTGAGCGTGGATCTCGCGGTATCATTGCAGCACTGGGGCCAGATGGTAAGCCCTCCCGTATCGTAGTTATCTACACGACGGGGAGTCAGGCAACTATGGA
gb|X57972|+|339-1200|ARO:3000878|TEM-6 [Escherichia coli] 	0	806	46	852	861	3478183-	806	ATGAGTATTCAACATTTCCGTGTCGCCCTTATTCCCTTTTTTGCGGCATTTTGCCTTCCTGTTTTTGCTCACCCAGAAACGCTGGTGAAAGTAAAAGATGCTGAAGATCAGTTGGGTGCACGAGTGGGTTACATCGAGCTGGATCTCAACAGCGGTAAGATCCTTGAGAGTTTTCGCCCCGAAGAACGTTTTCCAATGATGAGCACTTTTAAAGTTCTGCTATGTGGTGCGGTATTATCCCGTGTTGACGCCGGGCAAGAGCAACTCGGTCGCCGCATACACTATTCTCAGAATGACTTGGTTGAGTACTCACCAGTCACAGAAAAGCATCTTACGGATGGCATGACAGTAAGAGAATTATGCAGTGCTGCCATAACCATGAGTGATAACACTGCGGCCAACTTACTTCTGACAACGATCGGAGGACCGAAGGAGCTAACCGCTTTTTTGCACAACATGGGGGATCATGTAACCCGCCTTGATCGTTGGGAACCGGAGCTGAATGAAGCCATACCAAACGACGAGCGTGACACCACGATGCCTGCAGCAATGGCAACAACGTTGCGCAAACTATTAACTGGCGAACTACTTACTCTAGCTTCCCGGCAACAATTAATAGACTGGATGGAGGCGGATAAAGTTGCAGGACCACTTCTGCGCTCGGCCCTTCCGGCTGGCTGGTTTATTGCTGATAAATCTGGAGCCGGTGAGCGTGGATCTCGCGGTATCATTGCAGCACTGGGGCCAGATGGTAAGCCCTCCCGTATCGTAGTTATCTACACGACGGGGAGTCAGGCAACTATGGA
gb|JX042489|+|141-1002|ARO:3000890|TEM-19 [Acinetobacter baumannii] 	0	806	46	852	861	3478183-	806	ATGAGTATTCAACATTTCCGTGTCGCCCTTATTCCCTTTTTTGCGGCATTTTGCCTTCCTGTTTTTGCTCACCCAGAAACGCTGGTGAAAGTAAAAGATGCTGAAGATCAGTTGGGTGCACGAGTGGGTTACATCGAGCTGGATCTCAACAGCGGTAAGATCCTTGAGAGTTTTCGCCCCGAAGAACGTTTTCCAATGATGAGCACTTTTAAAGTTCTGCTATGTGGTGCGGTATTATCCCGTGTTGACGCCGGGCAAGAGCAACTCGGTCGCCGCATACACTATTCTCAGAATGACTTGGTTGAGTACTCACCAGTCACAGAAAAGCATCTTACGGATGGCATGACAGTAAGAGAATTATGCAGTGCTGCCATAACCATGAGTGATAACACTGCGGCCAACTTACTTCTGACAACGATCGGAGGACCGAAGGAGCTAACCGCTTTTTTGCACAACATGGGGGATCATGTAACCCGCCTTGATCGTTGGGAACCGGAGCTGAATGAAGCCATACCAAACGACGAGCGTGACACCACGATGCCTGCAGCAATGGCAACAACGTTGCGCAAACTATTAACTGGCGAACTACTTACTCTAGCTTCCCGGCAACAATTAATAGACTGGATGGAGGCGGATAAAGTTGCAGGACCACTTCTGCGCTCGGCCCTTCCGGCTGGCTGGTTTATTGCTGATAAATCTGGAGCCGGTGAGCGTGGATCTCGCGGTATCATTGCAGCACTGGGGCCAGATGGTAAGCCCTCCCGTATCGTAGTTATCTACACGACGGGGAGTCAGGCAACTATGGA
gb|AF047171|+|135-996|ARO:3000929|TEM-60 [Providencia stuartii] 	0	806	46	852	861	3478183-	806	ATGAGTATTCAACATTTCCGTGTCGCCCTTATTCCCTTTTTTGCGGCATTTTGCCTTCCTGTTTTTGCTCACCCAGAAACGCTGGTGAAAGTAAAAGATGCTGAAGATCAGTTGGGTGCACGAGTGGGTTACATCGAGCTGGATCTCAACAGCGGTAAGATCCTTGAGAGTTTTCGCCCCGAAGAACGTTTTCCAATGATGAGCACTTTTAAAGTTCTGCTATGTGGTGCGGTATTATCCCGTGTTGACGCCGGGCAAGAGCAACTCGGTCGCCGCATACACTATTCTCAGAATGACTTGGTTGAGTACTCACCAGTCACAGAAAAGCATCTTACGGATGGCATGACAGTAAGAGAATTATGCAGTGCTGCCATAACCATGAGTGATAACACTGCGGCCAACTTACTTCTGACAACGATCGGAGGACCGAAGGAGCTAACCGCTTTTTTGCACAACATGGGGGATCATGTAACCCGCCTTGATCGTTGGGAACCGGAGCTGAATGAAGCCATACCAAACGACGAGCGTGACACCACGATGCCTGCAGCAATGGCAACAACGTTGCGCAAACTATTAACTGGCGAACTACTTACTCTAGCTTCCCGGCAACAATTAATAGACTGGATGGAGGCGGATAAAGTTGCAGGACCACTTCTGCGCTCGGCCCTTCCGGCTGGCTGGTTTATTGCTGATAAATCTGGAGCCGGTGAGCGTGGATCTCGCGGTATCATTGCAGCACTGGGGCCAGATGGTAAGCCCTCCCGTATCGTAGTTATCTACACGACGGGGAGTCAGGCAACTATGGA
gb|AM040708.1|+|1173-1965|ARO:3004704|aadA8b [Escherichia coli] 	12,0	279,737	0,10	267,747	792	41790385+;104600-	267;737	GTGACCATCGAAATTTCGAACCAACTATCAGAGGTGCTAAGCGTCATTGAGCGCCATCTGGAATCAACGTTGCTGGCCGTGCATTTGTACGGCTCCGCAGTGGATGGCGGCCTGAAGCCATACAGCGATATTGATTTGTTGGTTACTGTGGCCGTAAAGCTTGATGAAACGACGCGGCGAGCATTGCTCAATGACCTTATGGAGGCTTCGGCTTTCCCTGGCGAGAGCGAGACGCTCCGCGCTATAGAAGTCACCCTTGTCGTGCAT;ATGAGGGAAGCGGTGATCGCCGAAGTATCGACTCAACTATCAGAGGTAGTTGGCGTCATCGAGCGCCATCTCGAACCGACGTTGCTGGCCGTACATTTGTACGGCTCCGCAGTGGATGGCGGCCTGAAGCCACACAGTGATATTGATTTGCTGGTTACGGTGACCGTAAGGCTTGATGAAACAACGCGGCGAGCTTTGATCAACGACCTTTTGGAAACTTCGGCTTCCCCTGGAGAGAGCGAGATTCTCCGCGCTGTAGAAGTCACCATTGTTGTGCACGACGACATCATTCCGTGGCGTTATCCAGCTAAGCGCGAACTGCAATTTGGAGAATGGCAGCGCAATGACATTCTTGCAGGTATCTTCGAGCCAGCCACGATCGACATTGATCTGGCTATCTTGCTGACAAAAGCAAGAGAACATAGCGTTGCCTTGGTAGGTCCAGCGGCGGAGGAACTCTTTGATCCGGTTCCTGAACAGGATCTATTTGAGGCGCTAAATGAAACCTTAACGCTATGGAACTCGCCGCCCGACTGGGCTGGCGATGAGCGAAATGTAGTGCTTACGTTGTCCCGCATTTGGTACAGCGCAGTAACCGGCAAAATCGCGCCGAAGGATGTCGCTGCCGACTGGGCAATGGAGCGCCTGCCGGCCCAGTATCAGCCCGTCATACTTGAAGCTAGACAGGCTTATCTTGGACAAGAAGAAGATCGCTTGGCCTCGCGCGCAGATCAGTT
gb|DQ105528|+|0-861|ARO:3001012|TEM-145 [Escherichia coli] 	0	806	46	852	861	3478183-	806	ATGAGTATTCAACATTTCCGTGTCGCCCTTATTCCCTTTTTTGCGGCATTTTGCCTTCCTGTTTTTGCTCACCCAGAAACGCTGGTGAAAGTAAAAGATGCTGAAGATCAGTTGGGTGCACGAGTGGGTTACATCGAGCTGGATCTCAACAGCGGTAAGATCCTTGAGAGTTTTCGCCCCGAAGAACGTTTTCCAATGATGAGCACTTTTAAAGTTCTGCTATGTGGTGCGGTATTATCCCGTGTTGACGCCGGGCAAGAGCAACTCGGTCGCCGCATACACTATTCTCAGAATGACTTGGTTGAGTACTCACCAGTCACAGAAAAGCATCTTACGGATGGCATGACAGTAAGAGAATTATGCAGTGCTGCCATAACCATGAGTGATAACACTGCGGCCAACTTACTTCTGACAACGATCGGAGGACCGAAGGAGCTAACCGCTTTTTTGCACAACATGGGGGATCATGTAACCCGCCTTGATCGTTGGGAACCGGAGCTGAATGAAGCCATACCAAACGACGAGCGTGACACCACGATGCCTGCAGCAATGGCAACAACGTTGCGCAAACTATTAACTGGCGAACTACTTACTCTAGCTTCCCGGCAACAATTAATAGACTGGATGGAGGCGGATAAAGTTGCAGGACCACTTCTGCGCTCGGCCCTTCCGGCTGGCTGGTTTATTGCTGATAAATCTGGAGCCGGTGAGCGTGGATCTCGCGGTATCATTGCAGCACTGGGGCCAGATGGTAAGCCCTCCCGTATCGTAGTTATCTACACGACGGGGAGTCAGGCAACTATGGA
gb|AF332513|+|103-964|ARO:3000931|TEM-63 [Escherichia coli] 	0	806	46	852	861	3478183-	806	ATGAGTATTCAACATTTCCGTGTCGCCCTTATTCCCTTTTTTGCGGCATTTTGCCTTCCTGTTTTTGCTCACCCAGAAACGCTGGTGAAAGTAAAAGATGCTGAAGATCAGTTGGGTGCACGAGTGGGTTACATCGAGCTGGATCTCAACAGCGGTAAGATCCTTGAGAGTTTTCGCCCCGAAGAACGTTTTCCAATGATGAGCACTTTTAAAGTTCTGCTATGTGGTGCGGTATTATCCCGTGTTGACGCCGGGCAAGAGCAACTCGGTCGCCGCATACACTATTCTCAGAATGACTTGGTTGAGTACTCACCAGTCACAGAAAAGCATCTTACGGATGGCATGACAGTAAGAGAATTATGCAGTGCTGCCATAACCATGAGTGATAACACTGCGGCCAACTTACTTCTGACAACGATCGGAGGACCGAAGGAGCTAACCGCTTTTTTGCACAACATGGGGGATCATGTAACCCGCCTTGATCGTTGGGAACCGGAGCTGAATGAAGCCATACCAAACGACGAGCGTGACACCACGATGCCTGCAGCAATGGCAACAACGTTGCGCAAACTATTAACTGGCGAACTACTTACTCTAGCTTCCCGGCAACAATTAATAGACTGGATGGAGGCGGATAAAGTTGCAGGACCACTTCTGCGCTCGGCCCTTCCGGCTGGCTGGTTTATTGCTGATAAATCTGGAGCCGGTGAGCGTGGATCTCGCGGTATCATTGCAGCACTGGGGCCAGATGGTAAGCCCTCCCGTATCGTAGTTATCTACACGACGGGGAGTCAGGCAACTATGGA
gb|KR057761.1|+|0-1110|ARO:3004355|PDC-92 [Pseudomonas aeruginosa] 	0	1055	35591	36652	1110	232416+	1061	GATGAGGCCCCGGCGGATCGCCTGAAGGCACTGGTCGACGCCGCCGTACAACCGGTGATGAAGGCCAATGACATTCCGGGCCTGGCCGTAGCCATCAGCCTGAAAGGAGAACCGCATTACTTCAGCTATGGGCTGGCCTCGAAAGAGGACGGCCGCCGGGTGACGCCGGAGACCCTGTTCGAGATCGGCTCGGTGAGCAAGACCTTCACCGTCACCCTCGCCGGCTATGCCCTGGCCCAGGACAAGATGCGCCTCGACGACCGCGCCAGCCAGCACTGGCCGGCACTGCAGGGCAGCCGCTTCGACGGCATCAGCCTGCTCGACCTCGCGACCTATACCGCCGGCGGCTTGCCGCTGCAGTTCCCCGACTCGGTGCAGAAGGACCAGGCACAGATCCGCGACTACTACCGCCAGTGGCAGCCGACCTACGCGCCGGGCAGCCAGCGCCTCTATTCCAACCCGAGCATCGGCCTGTTCGGCTATCTCGCCGCGCGCAGCCTGGGCCAGCCGTTCGAACGGCTCATGGAGCAGCAATTGTTCCCGGCACTGGGCCTCGAACAGACCCACCTCGACGTGCCCGAGGCGGCGCTGGCGCAGTACGCCCAGGGCTACGGCAAGGACGACCGCCCGCTACGGGTCGGTCCCGGCCCGCTGGATGCCGAAGGCTACGGGGTGAAGACCAGCGCGGCCGACCTGCTGCGCTTCGTCGATGCCAACCTGCATCCGGAGCGCCTGGACAGGCCCTGGGCGCAGGCGCTCGATGCCACCCATCGCGGTTACTACAAGGTCGGCGACATGACCCAGGGCCTGGGCTGGGAAGCCTACGACTGGCCGATCTCCCTGAAGCGCCTGCAGGCCGGCAACTCGACGCCGATGGCGCTGCAACCACACAGGATCGCCAGGCTGCCCGCGCCACAGGCGCTGGAGGGCCAGCGCCTGCTGAACAAGACCGGCTCCACCAACGGCTTCGGCGCCTACGTGGCGTTCGTCCCGGGCCGCGACCTGGGCCTGGTGATCCTGGCCAACCGCAACTATCCCAATGCCGAGCGGGTGAAGATCGC
gb|KJ780077.1|+|0-825|ARO:3001588|OXA-402 [Acinetobacter baumannii] 	0	770	54149	54919	825	246080-	770	ATGAACATTAAAGCACTCTTACTTATAACAAGCGCTATTTTTATTTCAGCCTGCTCACCTTATATAGTGACTGCTAATCCAAATCACAGCGCTTCAAAATCTGATGTAAAAGCAGAGAAAATTAAAAATTTATTTAACGAAGCACACACTACGGGTGTTTTAGTTATCCAACAAGGCCAAACTCAACAAAGCTATGGTAATGATCTTGCTCGTGCTTCGACCGAGTATGTACCTGCTTCGACCTTCAAAATGCTTAATGCTTTGATCGGCCTTGAGCACCATAAGGCAACCACCACAGAAGTATTTAAGTGGGATGGTAAAAAAAGGTTATTCCCAGAATGGGAAAAGGACATGACCCTAGGCGATGCCATGAAAGCTTCCGCTATTCCAGTTTATCAAGATTTAGCTCGTCGTATTGGACTTGAGCTCATGTCTAAGGAAGTGAAGCGTGTTGGTTATGGCAATGCAGATATCGGTACCCAAGTCGATAATTTTTGGCTGGTGGGTCCTTTAAAAATTACTCCTCAGCAAGAGGCACAGTTTGCTTACAAGCTAGCTAATAAAACGCTTCCATTTAGCCAAAAAGTCCAAGATGAAGTGCAATCCATGCTATTCATAGAAGAAAAGAATGGAAACAAAATATACGCAAAAAGTGGTTGGGGATGGGATGTAAACCCACAAGTAGGCTGGTTAACTGGATGGGTTGTTCAGCCTCAAGGGAATATTGTAGCGTTCTCCCTTAACTTAGAAATGAAAAAAGGAATACCTAG
gb|JN416112|+|0-861|ARO:3001050|TEM-190 [Escherichia coli] 	0	806	46	852	861	3478183-	806	ATGAGTATTCAACATTTCCGTGTCGCCCTTATTCCCTTTTTTGCGGCATTTTGCCTTCCTGTTTTTGCTCACCCAGAAACGCTGGTGAAAGTAAAAGATGCTGAAGATCAGTTGGGTGCACGAGTGGGTTACATCGAGCTGGATCTCAACAGCGGTAAGATCCTTGAGAGTTTTCGCCCCGAAGAACGTTTTCCAATGATGAGCACTTTTAAAGTTCTGCTATGTGGTGCGGTATTATCCCGTGTTGACGCCGGGCAAGAGCAACTCGGTCGCCGCATACACTATTCTCAGAATGACTTGGTTGAGTACTCACCAGTCACAGAAAAGCATCTTACGGATGGCATGACAGTAAGAGAATTATGCAGTGCTGCCATAACCATGAGTGATAACACTGCGGCCAACTTACTTCTGACAACGATCGGAGGACCGAAGGAGCTAACCGCTTTTTTGCACAACATGGGGGATCATGTAACCCGCCTTGATCGTTGGGAACCGGAGCTGAATGAAGCCATACCAAACGACGAGCGTGACACCACGATGCCTGCAGCAATGGCAACAACGTTGCGCAAACTATTAACTGGCGAACTACTTACTCTAGCTTCCCGGCAACAATTAATAGACTGGATGGAGGCGGATAAAGTTGCAGGACCACTTCTGCGCTCGGCCCTTCCGGCTGGCTGGTTTATTGCTGATAAATCTGGAGCCGGTGAGCGTGGATCTCGCGGTATCATTGCAGCACTGGGGCCAGATGGTAAGCCCTCCCGTATCGTAGTTATCTACACGACGGGGAGTCAGGCAACTATGGA
gb|AF091113|+|450-1311|ARO:3000934|TEM-67 [Proteus mirabilis] 	0	806	46	852	861	3478183-	806	ATGAGTATTCAACATTTCCGTGTCGCCCTTATTCCCTTTTTTGCGGCATTTTGCCTTCCTGTTTTTGCTCACCCAGAAACGCTGGTGAAAGTAAAAGATGCTGAAGATCAGTTGGGTGCACGAGTGGGTTACATCGAGCTGGATCTCAACAGCGGTAAGATCCTTGAGAGTTTTCGCCCCGAAGAACGTTTTCCAATGATGAGCACTTTTAAAGTTCTGCTATGTGGTGCGGTATTATCCCGTGTTGACGCCGGGCAAGAGCAACTCGGTCGCCGCATACACTATTCTCAGAATGACTTGGTTGAGTACTCACCAGTCACAGAAAAGCATCTTACGGATGGCATGACAGTAAGAGAATTATGCAGTGCTGCCATAACCATGAGTGATAACACTGCGGCCAACTTACTTCTGACAACGATCGGAGGACCGAAGGAGCTAACCGCTTTTTTGCACAACATGGGGGATCATGTAACCCGCCTTGATCGTTGGGAACCGGAGCTGAATGAAGCCATACCAAACGACGAGCGTGACACCACGATGCCTGCAGCAATGGCAACAACGTTGCGCAAACTATTAACTGGCGAACTACTTACTCTAGCTTCCCGGCAACAATTAATAGACTGGATGGAGGCGGATAAAGTTGCAGGACCACTTCTGCGCTCGGCCCTTCCGGCTGGCTGGTTTATTGCTGATAAATCTGGAGCCGGTGAGCGTGGATCTCGCGGTATCATTGCAGCACTGGGGCCAGATGGTAAGCCCTCCCGTATCGTAGTTATCTACACGACGGGGAGTCAGGCAACTATGGA
gb|AL009126|-|2735681-2736536|ARO:3002627|aadK [Bacillus subtilis subsp. subtilis str. 168] 	0	798	2991	3789	855	3873945+	798	ATGCGAAGTGAGCAGGAAATGATGGACATTTTTTTGGACTTTGCTTTGAACGATGAGAGAATCCGATTGGTCACTTTGGAAGGGTCGCGTACAAACAGAAATATCCCTCCTGACAACTTCCAAGATTATGACATCTCGTATTTTGTAACTGATGTAGATTCTTTTAAAGAAAATGATCAGTGGCTCGAAATCTTTGGGAAGCGCATTATGATGCAAAAACCAGAAGATATGGAGCTTTTTCCTCCCGAATTAGGTAATTGGTTTTCATACATTATTCTTTTTGAGTATGGCAACAAATTAGATCTAACCCTTATTCCAATTCGTGAAGCAGAAGACTATTTTGCTAATAACGATGGTTTGGTTAAGGTATTGCTTGATAAGGATTCGTTCATCAACTATAAAGTGACCCCAAATGATCACCAATACTGGATGAAAAAGCCGACTGCAAGGGAATTTGATGATTGCTGTAATGAGTTCTGGATGGTTTCGACTTACGTAGTAAAAGGATTAGCAAGAAATGAAATCCTTTTTGCCATTGACCATTTAAATGAAATTGTACGTCCTAATTTATTGAGAATGATGGCCTGGCATATCGCATCTCAGAAAGGGTATTCATTTAGTATGGGGAAGAACTATAAATTTATGAAGCGGTACCTTTCAAATAAAGAATGGGAGGAACTCATGTCTACATATTCTGTGAATGGGTATCAGGAAATGTGGAAGTCTTTATTTACTTGCTATGCATTATTTAGAAAGTATTCAAAAGCTGTATCAGAAAGTCTTGCATATCAGTATCCT
gb|KY432484.1|+|0-861|ARO:3001051|TEM-191 [Acinetobacter baumannii] 	0	806	46	852	861	3478183-	806	ATGAGTATTCAACATTTCCGTGTCGCCCTTATTCCCTTTTTTGCGGCATTTTGCCTTCCTGTTTTTGCTCACCCAGAAACGCTGGTGAAAGTAAAAGATGCTGAAGATCAGTTGGGTGCACGAGTGGGTTACATCGAGCTGGATCTCAACAGCGGTAAGATCCTTGAGAGTTTTCGCCCCGAAGAACGTTTTCCAATGATGAGCACTTTTAAAGTTCTGCTATGTGGTGCGGTATTATCCCGTGTTGACGCCGGGCAAGAGCAACTCGGTCGCCGCATACACTATTCTCAGAATGACTTGGTTGAGTACTCACCAGTCACAGAAAAGCATCTTACGGATGGCATGACAGTAAGAGAATTATGCAGTGCTGCCATAACCATGAGTGATAACACTGCGGCCAACTTACTTCTGACAACGATCGGAGGACCGAAGGAGCTAACCGCTTTTTTGCACAACATGGGGGATCATGTAACCCGCCTTGATCGTTGGGAACCGGAGCTGAATGAAGCCATACCAAACGACGAGCGTGACACCACGATGCCTGCAGCAATGGCAACAACGTTGCGCAAACTATTAACTGGCGAACTACTTACTCTAGCTTCCCGGCAACAATTAATAGACTGGATGGAGGCGGATAAAGTTGCAGGACCACTTCTGCGCTCGGCCCTTCCGGCTGGCTGGTTTATTGCTGATAAATCTGGAGCCGGTGAGCGTGGATCTCGCGGTATCATTGCAGCACTGGGGCCAGATGGTAAGCCCTCCCGTATCGTAGTTATCTACACGACGGGGAGTCAGGCAACTATGGA
gb|AJ239002|+|0-861|ARO:3000935|TEM-68 [Klebsiella pneumoniae] 	0	806	46	852	861	3478183-	806	ATGAGTATTCAACATTTCCGTGTCGCCCTTATTCCCTTTTTTGCGGCATTTTGCCTTCCTGTTTTTGCTCACCCAGAAACGCTGGTGAAAGTAAAAGATGCTGAAGATCAGTTGGGTGCACGAGTGGGTTACATCGAGCTGGATCTCAACAGCGGTAAGATCCTTGAGAGTTTTCGCCCCGAAGAACGTTTTCCAATGATGAGCACTTTTAAAGTTCTGCTATGTGGTGCGGTATTATCCCGTGTTGACGCCGGGCAAGAGCAACTCGGTCGCCGCATACACTATTCTCAGAATGACTTGGTTGAGTACTCACCAGTCACAGAAAAGCATCTTACGGATGGCATGACAGTAAGAGAATTATGCAGTGCTGCCATAACCATGAGTGATAACACTGCGGCCAACTTACTTCTGACAACGATCGGAGGACCGAAGGAGCTAACCGCTTTTTTGCACAACATGGGGGATCATGTAACCCGCCTTGATCGTTGGGAACCGGAGCTGAATGAAGCCATACCAAACGACGAGCGTGACACCACGATGCCTGCAGCAATGGCAACAACGTTGCGCAAACTATTAACTGGCGAACTACTTACTCTAGCTTCCCGGCAACAATTAATAGACTGGATGGAGGCGGATAAAGTTGCAGGACCACTTCTGCGCTCGGCCCTTCCGGCTGGCTGGTTTATTGCTGATAAATCTGGAGCCGGTGAGCGTGGATCTCGCGGTATCATTGCAGCACTGGGGCCAGATGGTAAGCCCTCCCGTATCGTAGTTATCTACACGACGGGGAGTCAGGCAACTATGGA
gb|DQ105529|+|0-861|ARO:3001013|TEM-146 [Escherichia coli] 	0	806	46	852	861	3478183-	806	ATGAGTATTCAACATTTCCGTGTCGCCCTTATTCCCTTTTTTGCGGCATTTTGCCTTCCTGTTTTTGCTCACCCAGAAACGCTGGTGAAAGTAAAAGATGCTGAAGATCAGTTGGGTGCACGAGTGGGTTACATCGAGCTGGATCTCAACAGCGGTAAGATCCTTGAGAGTTTTCGCCCCGAAGAACGTTTTCCAATGATGAGCACTTTTAAAGTTCTGCTATGTGGTGCGGTATTATCCCGTGTTGACGCCGGGCAAGAGCAACTCGGTCGCCGCATACACTATTCTCAGAATGACTTGGTTGAGTACTCACCAGTCACAGAAAAGCATCTTACGGATGGCATGACAGTAAGAGAATTATGCAGTGCTGCCATAACCATGAGTGATAACACTGCGGCCAACTTACTTCTGACAACGATCGGAGGACCGAAGGAGCTAACCGCTTTTTTGCACAACATGGGGGATCATGTAACCCGCCTTGATCGTTGGGAACCGGAGCTGAATGAAGCCATACCAAACGACGAGCGTGACACCACGATGCCTGCAGCAATGGCAACAACGTTGCGCAAACTATTAACTGGCGAACTACTTACTCTAGCTTCCCGGCAACAATTAATAGACTGGATGGAGGCGGATAAAGTTGCAGGACCACTTCTGCGCTCGGCCCTTCCGGCTGGCTGGTTTATTGCTGATAAATCTGGAGCCGGTGAGCGTGGATCTCGCGGTATCATTGCAGCACTGGGGCCAGATGGTAAGCCCTCCCGTATCGTAGTTATCTACACGACGGGGAGTCAGGCAACTATGGA
gb|KP881241.1|+|0-1167|ARO:3003887|ADC-81 [Acinetobacter baumannii] 	0	1112	63	1160	1167	126080+	1097	ATGCGATTTAAAAAAATTTCTTGTCTACTTTTATCCCCGCTTTTTATTTTTAGTACCTCAATTTATGCGGGCAATACACCAAAAGACCAAGAAATTAAAAAACTGGTAGATCAAAACTTTAAACCGTTATTAGAAAAATATGATGTGCCAGGTATGGCTGTGGGTGTTATTCAAAATAATAAAAAGTATGAAATGTATTATGGTCTTCAATCTGTTCAAGATAAAAAAGCCGTAAATAGCAGTACTATTTTTGAGCTAGGTTCTGTCAGTAAATTATTTACCGCGACAGCAGGTGGATATGCAAAAAATAAAGGAAAAATCTCTTTTGACGATACGCCTGGTAAGTATTGGAAAGAACTAAAAAATACACCGATTGACCAAGTTAACTTACTTCAACTCGCGACGTATACAAGTGGTAACCTTGCCTTGCAATTTCCAGATGAAGTAAAAACAGATCAGCAAGTTTTAACATTTTTTAAAGACTGGAAACCTAAAAACTCAATCGGTGAATATCGACAATATTCAAACCCAAGCATTGGTTTATTTGGAAAAGTTGTAGCTTTGTCTATGAATAAACCTTTCGACCAAGTCTTAGAAAAAACAATTTTTCCGGCCCTTGGCTTAAAACATAGCTATGTAAATGTACCTAAGACCCAGATGCAAAACTATGCTTTTGGCTATAACCAAGAAAATCAGCCGATTCGAGTTAACCCCGGCCCACTCGATGCCCCAGCATATGGCGTCAAATCGACACTACCCGACATGTTGAGTTTTATTCATGCCAACCTAAATCCACAAAAATATCCAGCAGATATTCAACGGGCAATTAATGAAACACATCAGGGTCGCTATCAAGTAAATACCATGTATCAGGCACTCGGTTGGGAAGAGTTTTCTTATCCGGCAACGTTACAAACTTTATTAGACAGTAATTCAGAACAGATTGTGATGAAACCTAATAAAGTGACTGCTATTTCAAAGGAACCTTCAGTTAAGATGTACCATAAAACTGGCTCAACTACCGGTTTCGGAACATATGTGGTGTTTATTCCTAAAGAAAATATTGGTTTAGTCATGTTAACCAATAAACGTATTCC
gb|GU437214.1|+|0-774|ARO:3000858|armA [Pseudomonas aeruginosa] 	0	719	137	856	774	638787+	719	ATGGATAAGAATGATGTTGTTAAGAAGATACTTGAATCAAAAAAGTACGAAAACCTTGATTCAGATATTGTTGAAAAGGTTGTTTCCATTTCTGAGAAGAAATATAAATTAAAGGAAGTTGAGAATTATTCTAAAAAGAAATTGCATCAAATATGGGGGTCTTACTATTCTGCCTATCCTAATTGGGATAAATTATTAAAAAAGTACAATCAGGGGCAGTTATCAATAGAAGATTTACTAAAGATTCATTCTTCGACGAATGAAAGAGTCGCAACATTAAATGACTTTTACACTTATGTATTTGGAAATATCAAACATGTCTCATCTATTTTAGATTTTGGTTGTGGCTTCAATCCATTAGCTTTATACCAATGGAATGAAAATGAAAAAATAATATATCATGCATACGATATTGATAGAGCTGAGATAGCTTTTTTGAGTAGCATTATTGGGAAGTTAAAGACGACGATAAAGTATAGGTTTTTGAATAAAGAGAGTGATGTCTACAAAGGTACTTATGATGTAGTATTCCTTTTAAAGATGCTTCCTGTGCTAAAACAGCAAGATGTAAATATCTTGGATTTCCTACAGCTTTTTCATACTCAAAACTTTGTAATATCTTTTCCAATAAAGTCTTTATCTGGAAAGGAGAAGGGAATGGAAGAGAATTACCAGCTATGGTTTGAATCTTTTACAAAAGGTTGGATAAAAATCCTTGA
gb|AF527798.1|+|0-785|ARO:3000879|TEM-7 [Escherichia coli] Partial	0	730	82	812	785	3478183-	730	TTTTTTGCGGCATTTTGCCTTCCTGTTTTTGCTCACCCAGAAACGCTGGTGAAAGTAAAAGATGCTGAAGATCAGTTGGGTGCACGAGTGGGTTACATCGAGCTGGATCTCAACAGCGGTAAGATCCTTGAGAGTTTTCGCCCCGAAGAACGTTTTCCAATGATGAGCACTTTTAAAGTTCTGCTATGTGGTGCGGTATTATCCCGTGTTGACGCCGGGCAAGAGCAACTCGGTCGCCGCATACACTATTCTCAGAATGACTTGGTTGAGTACTCACCAGTCACAGAAAAGCATCTTACGGATGGCATGACAGTAAGAGAATTATGCAGTGCTGCCATAACCATGAGTGATAACACTGCGGCCAACTTACTTCTGACAACGATCGGAGGACCGAAGGAGCTAACCGCTTTTTTGCACAACATGGGGGATCATGTAACCCGCCTTGATCGTTGGGAACCGGAGCTGAATGAAGCCATACCAAACGACGAGCGTGACACCACGATGCCTGCAGCAATGGCAACAACGTTGCGCAAACTATTAACTGGCGAACTACTTACTCTAGCTTCCCGGCAACAATTAATAGACTGGATGGAGGCGGATAAAGTTGCAGGACCACTTCTGCGCTCGGCCCTTCCGGCTGGCTGGTTTATTGCTGATAAATCTGGAGCCGGTGAGCGTGGATCTCGCGGTATCATTGCAGCACTGGGGCCAGATGGTAAGCCCTCCCGTA
gb|JF949915|+|0-754|ARO:3001052|TEM-192 [Klebsiella pneumoniae] 	0	698	76	774	753	3478183-	698	ATTCCCTTTTTTGCGGCATTTTGCCTTCCTGTTTTTGCTCACCCAGAAACGCTGGTGAAAGTAAAAGATGCTGAAGATCAGTTGGGTGCACGAGTGGGTTACATCGAGCTGGATCTCAACAGCGGTAAGATCCTTGAGAGTTTTCGCCCCGAAGAACGTTTTCCAATGATGAGCACTTTTAAAGTTCTGCTATGTGGTGCGGTATTATCCCGTGTTGACGCCGGGCAAGAGCAACTCGGTCGCCGCATACACTATTCTCAGAATGACTTGGTTGAGTACTCACCAGTCACAGAAAAGCATCTTACGGATGGCATGACAGTAAGAGAATTATGCAGTGCTGCCATAACCATGAGTGATAACACTGCGGCCAACTTACTTCTGACAACGATCGGAGGACCGAAGGAGCTAACCGCTTTTTTGCACAACATGGGGGATCATGTAACCCGCCTTGATCGTTGGGAACCGGAGCTGAATGAAGCCATACCAAACGACGAGCGTGACACCACGATGCCTGCAGCAATGGCAACAACGTTGCGCAAACTATTAACTGGCGAACTACTTACTCTAGCTTCCCGGCAACAATTAATAGACTGGATGGAGGCGGATAAAGTTGCAGGACCACTTCTGCGCTCGGCCCTTCCGGCTGGCTGGTTTATTGCTGATAAATCTGGAGCCGGTGAGCGTGGATCTCGCGGTAT
gb|KR057762.1|+|0-1116|ARO:3004356|PDC-93 [Pseudomonas aeruginosa] 	0	1061	35591	36652	1116	232416+	1061	GATGAGGCCCCGGCGGATCGCCTGAAGGCACTGGTCGACGCCGCCGTACAACCGGTGATGAAGGCCAATGACATTCCGGGCCTGGCCGTAGCCATCAGCCTGAAAGGAGAACCGCATTACTTCAGCTATGGGCTGGCCTCGAAAGAGGACGGCCGCCGGGTGACGCCGGAGACCCTGTTCGAGATCGGCTCGGTGAGCAAGACCTTCACCGTCACCCTCGCCGGCTATGCCCTGGCCCAGGACAAGATGCGCCTCGACGACCGCGCCAGCCAGCACTGGCCGGCACTGCAGGGCAGCCGCTTCGACGGCATCAGCCTGCTCGACCTCGCGACCTATACCGCCGGCGGCTTGCCGCTGCAGTTCCCCGACTCGGTGCAGAAGGACCAGGCACAGATCCGCGACTACTACCGCCAGTGGCAGCCGACCTACGCGCCGGGCAGCCAGCGCCTCTATTCCAACCCGAGCATCGGCCTGTTCGGCTATCTCGCCGCGCGCAGCCTGGGCCAGCCGTTCGAACGGCTCATGGAGCAGCAATTGTTCCCGGCACTGGGCCTCGAACAGACCCACCTCGACGTGCCCGAGGCGGCGCTGGCGCAGTACGCCCAGGGCTACGGCAAGGACGACCGCCCGCTACGGGTCGGTCCCGGCCCGCTGGATGCCGAAGGCTACGGGGTGAAGACCAGCGCGGCCGACCTGCTGCGCTTCGTCGATGCCAACCTGCATCCGGAGCGCCTGGACAGGCCCTGGGCGCAGGCGCTCGATGCCACCCATCGCGGTTACTACAAGGTCGGCGACATGACCCAGGGCCTGGGCTGGGAAGCCTACGACTGGCCGATCTCCCTGAAGCGCCTGCAGGCCGGCAACTCGACGCCGATGGCGCTGCAACCACACAGGATCGCCAGGCTGCCCGCGCCACAGGCGCTGGAGGGCCAGCGCCTGCTGAACAAGACCGGCTCCACCAACGGCTTCGGCGCCTACGTGGCGTTCGTCCCGGGCCGCGACCTGGGCCTGGTGATCCTGGCCAACCGCAACTATCCCAATGCCGAGCGGGTGAAGATCGC
gb|AF188199|+|214-1075|ARO:3000936|TEM-70 [Escherichia coli] 	0	806	46	852	861	3478183-	806	ATGAGTATTCAACATTTCCGTGTCGCCCTTATTCCCTTTTTTGCGGCATTTTGCCTTCCTGTTTTTGCTCACCCAGAAACGCTGGTGAAAGTAAAAGATGCTGAAGATCAGTTGGGTGCACGAGTGGGTTACATCGAGCTGGATCTCAACAGCGGTAAGATCCTTGAGAGTTTTCGCCCCGAAGAACGTTTTCCAATGATGAGCACTTTTAAAGTTCTGCTATGTGGTGCGGTATTATCCCGTGTTGACGCCGGGCAAGAGCAACTCGGTCGCCGCATACACTATTCTCAGAATGACTTGGTTGAGTACTCACCAGTCACAGAAAAGCATCTTACGGATGGCATGACAGTAAGAGAATTATGCAGTGCTGCCATAACCATGAGTGATAACACTGCGGCCAACTTACTTCTGACAACGATCGGAGGACCGAAGGAGCTAACCGCTTTTTTGCACAACATGGGGGATCATGTAACCCGCCTTGATCGTTGGGAACCGGAGCTGAATGAAGCCATACCAAACGACGAGCGTGACACCACGATGCCTGCAGCAATGGCAACAACGTTGCGCAAACTATTAACTGGCGAACTACTTACTCTAGCTTCCCGGCAACAATTAATAGACTGGATGGAGGCGGATAAAGTTGCAGGACCACTTCTGCGCTCGGCCCTTCCGGCTGGCTGGTTTATTGCTGATAAATCTGGAGCCGGTGAGCGTGGATCTCGCGGTATCATTGCAGCACTGGGGCCAGATGGTAAGCCCTCCCGTATCGTAGTTATCTACACGACGGGGAGTCAGGCAACTATGGA
gb|DQ279850|+|0-861|ARO:3001014|TEM-147 [Pseudomonas aeruginosa] 	0	806	46	852	861	3478183-	806	ATGAGTATTCAACATTTCCGTGTCGCCCTTATTCCCTTTTTTGCGGCATTTTGCCTTCCTGTTTTTGCTCACCCAGAAACGCTGGTGAAAGTAAAAGATGCTGAAGATCAGTTGGGTGCACGAGTGGGTTACATCGAGCTGGATCTCAACAGCGGTAAGATCCTTGAGAGTTTTCGCCCCGAAGAACGTTTTCCAATGATGAGCACTTTTAAAGTTCTGCTATGTGGTGCGGTATTATCCCGTGTTGACGCCGGGCAAGAGCAACTCGGTCGCCGCATACACTATTCTCAGAATGACTTGGTTGAGTACTCACCAGTCACAGAAAAGCATCTTACGGATGGCATGACAGTAAGAGAATTATGCAGTGCTGCCATAACCATGAGTGATAACACTGCGGCCAACTTACTTCTGACAACGATCGGAGGACCGAAGGAGCTAACCGCTTTTTTGCACAACATGGGGGATCATGTAACCCGCCTTGATCGTTGGGAACCGGAGCTGAATGAAGCCATACCAAACGACGAGCGTGACACCACGATGCCTGCAGCAATGGCAACAACGTTGCGCAAACTATTAACTGGCGAACTACTTACTCTAGCTTCCCGGCAACAATTAATAGACTGGATGGAGGCGGATAAAGTTGCAGGACCACTTCTGCGCTCGGCCCTTCCGGCTGGCTGGTTTATTGCTGATAAATCTGGAGCCGGTGAGCGTGGATCTCGCGGTATCATTGCAGCACTGGGGCCAGATGGTAAGCCCTCCCGTATCGTAGTTATCTACACGACGGGGAGTCAGGCAACTATGGA
gb|KJ920337.1|+|0-825|ARO:3001589|OXA-403 [Acinetobacter baumannii] 	0	770	54149	54919	825	246080-	770	ATGAACATTAAAGCACTCTTACTTATAACAAGCGCTATTTTTATTTCAGCCTGCTCACCTTATATAGTGACTGCTAATCCAAATCACAGCGCTTCAAAATCTGATGTAAAAGCAGAGAAAATTAAAAATTTATTTAACGAAGCACACACTACGGGTGTTTTAGTTATCCAACAAGGCCAAACTCAACAAAGCTATGGTAATGATCTTGCTCGTGCTTCGACCGAGTATGTACCTGCTTCGACCTTCAAAATGCTTAATGCTTTGATCGGCCTTGAGCACCATAAGGCAACCACCACAGAAGTATTTAAGTGGGATGGTAAAAAAAGGTTATTCCCAGAATGGGAAAAGGACATGACCCTAGGCGATGCCATGAAAGCTTCCGCTATTCCAGTTTATCAAGATTTAGCTCGTCGTATTGGACTTGAGCTCATGTCTAAGGAAGTGAAGCGTGTTGGTTATGGCAATGCAGATATCGGTACCCAAGTCGATAATTTTTGGCTGGTGGGTCCTTTAAAAATTACTCCTCAGCAAGAGGCACAGTTTGCTTACAAGCTAGCTAATAAAACGCTTCCATTTAGCCAAAAAGTCCAAGATGAAGTGCAATCCATGCTATTCATAGAAGAAAAGAATGGAAACAAAATATACGCAAAAAGTGGTTGGGGATGGGATGTAAACCCACAAGTAGGCTGGTTAACTGGATGGGTTGTTCAGCCTCAAGGGAATATTGTAGCGTTCTCCCTTAACTTAGAAATGAAAAAAGGAATACCTAG
gb|AF203816|+|210-1071|ARO:3000937|TEM-71 [Klebsiella pneumoniae] 	0	806	46	852	861	3478183-	806	ATGAGTATTCAACATTTCCGTGTCGCCCTTATTCCCTTTTTTGCGGCATTTTGCCTTCCTGTTTTTGCTCACCCAGAAACGCTGGTGAAAGTAAAAGATGCTGAAGATCAGTTGGGTGCACGAGTGGGTTACATCGAGCTGGATCTCAACAGCGGTAAGATCCTTGAGAGTTTTCGCCCCGAAGAACGTTTTCCAATGATGAGCACTTTTAAAGTTCTGCTATGTGGTGCGGTATTATCCCGTGTTGACGCCGGGCAAGAGCAACTCGGTCGCCGCATACACTATTCTCAGAATGACTTGGTTGAGTACTCACCAGTCACAGAAAAGCATCTTACGGATGGCATGACAGTAAGAGAATTATGCAGTGCTGCCATAACCATGAGTGATAACACTGCGGCCAACTTACTTCTGACAACGATCGGAGGACCGAAGGAGCTAACCGCTTTTTTGCACAACATGGGGGATCATGTAACCCGCCTTGATCGTTGGGAACCGGAGCTGAATGAAGCCATACCAAACGACGAGCGTGACACCACGATGCCTGCAGCAATGGCAACAACGTTGCGCAAACTATTAACTGGCGAACTACTTACTCTAGCTTCCCGGCAACAATTAATAGACTGGATGGAGGCGGATAAAGTTGCAGGACCACTTCTGCGCTCGGCCCTTCCGGCTGGCTGGTTTATTGCTGATAAATCTGGAGCCGGTGAGCGTGGATCTCGCGGTATCATTGCAGCACTGGGGCCAGATGGTAAGCCCTCCCGTATCGTAGTTATCTACACGACGGGGAGTCAGGCAACTATGGA
gb|JEXY01000001.1|+|379-1531|ARO:3003888|ADC-82 [Acinetobacter baumannii 1552865] 	0	1097	63	1160	1152	126080+	1097	ATGCGATTTAAAAAAATTTCTTGTCTACTTTTATCCCCGCTTTTTATTTTTAGTACCTCAATTTATGCGGGCAATACACCAAAAGACCAAGAAATTAAAAAACTGGTAGATCAAAACTTTAAACCGTTATTAGAAAAATATGATGTGCCAGGTATGGCTGTGGGTGTTATTCAAAATAATAAAAAGTATGAAATGTATTATGGTCTTCAATCTGTTCAAGATAAAAAAGCCGTAAATAGCAGTACTATTTTTGAGCTAGGTTCTGTCAGTAAATTATTTACCGCGACAGCAGGTGGATATGCAAAAAATAAAGGAAAAATCTCTTTTGACGATACGCCTGGTAAGTATTGGAAAGAACTAAAAAATACACCGATTGACCAAGTTAACTTACTTCAACTCGCGACGTATACAAGTGGTAACCTTGCCTTGCAATTTCCAGATGAAGTAAAAACAGATCAGCAAGTTTTAACATTTTTTAAAGACTGGAAACCTAAAAACTCAATCGGTGAATATCGACAATATTCAAACCCAAGCATTGGTTTATTTGGAAAAGTTGTAGCTTTGTCTATGAATAAACCTTTCGACCAAGTCTTAGAAAAAACAATTTTTCCGGCCCTTGGCTTAAAACATAGCTATGTAAATGTACCTAAGACCCAGATGCAAAACTATGCTTTTGGCTATAACCAAGAAAATCAGCCGATTCGAGTTAACCCCGGCCCACTCGATGCCCCAGCATATGGCGTCAAATCGACACTACCCGACATGTTGAGTTTTATTCATGCCAACCTAAATCCACAAAAATATCCAGCAGATATTCAACGGGCAATTAATGAAACACATCAGGGTCGCTATCAAGTAAATACCATGTATCAGGCACTCGGTTGGGAAGAGTTTTCTTATCCGGCAACGTTACAAACTTTATTAGACAGTAATTCAGAACAGATTGTGATGAAACCTAATAAAGTGACTGCTATTTCAAAGGAACCTTCAGTTAAGATGTACCATAAAACTGGCTCAACTACCGGTTTCGGAACATATGTGGTGTTTATTCCTAAAGAAAATATTGGTTTAGTCATGTTAACCAATAAACGTATTCC
gb|KU736867.1|+|19653-21573|ARO:3004442|tet(W/N/W) [uncultured bacterium IN-02] 	0	1858	745	2603	1920	211793-	1858	ATGAAAATAATCAATATTGGAATTCTTGCCCATGTAGACGCTGGAAAGACGACCTTGACGGAGAGCCTGCTATATGCCAGCGGAGCCATTTCAGAACCGGGGAGCGTCGAAAAAGGGACAACGAGGACGGACACCATGTTTTTGGAGCGGCAGCGTGGGATTACCATTCAAGCGGCAGTCACTTCCTTCCAGTGGCACAGATGTAAAGTCAACATTGTGGATACGCCCGGCCACATGGATTTTTTGGCGGAGGTGTACCGCTCTTTGGCTGTTTTAGATGGGGCCATCTTGGTGATCTCCGCTAAAGATGGCGTGCAGGCCCAGACCCGTATTCTGTTCCATGCCCTGCGGAAAATGAACATTCCCACCGTTATCTTTATCAACAAGATCGACCAGGCTGGCGTTGATTTGCAGAGCGTGGTTCAGTCTGTTCGGGATAAGCTCTCCGCCGATATTATCATCAAGCAGACGGTGTCGCTGTCCCCGGAAATAGTCCTGGAGGAAAATACCGACATAGAAGCATGGGATGCGGTCATCGAAAATAACGATAAATTATTGGAAAAGTATATCGCAGGAGAACCAATCAGCCGGGAAAAACTTGTGCGGGAGGAACAGCGGCGGGTTCAAGACGCCTCCCTGTTCCCGGTCTATTATGGCAGCGCCAAAAAGGGCCTTGGCATTCAACCGTTGATGGATGCGGTGACAGGGCTGTTCCAACCGATTGGGGAACAGGGGAGCGCCGCCCTATGCGGCAGCGTTTTCAAGGTGGAGTATACAGATTGCGGCCAGCGGCGTGTCTATCTACGGCTATACAGCGGAACGCTGCGCCTGCGGGATACGGTGGCCCTGGCCGGGAGAGAAAAGCTGAAAATCACAGAGATGCGTATTCCATCCAAAGGGGAAATTGTTCGGACAGACACCGCTTATCCGGGTGAAATTGTTATCCTTCCCAGCGACAGCGTGAGGTTAAACGATGTATTAGGGGACCCAACCCGGCTCCCTCGTAAAAGGTGGCGTGAGGACCCCCTCCCCATGCTGCGGACGTCGATTGCGCCGAAAACGGCAGCGCAAAGAGAACGGCTGCTGGACGCTCTTACGCAACTTGCGGATACTGACCCGCTTTTGCGCTGCGAGGTGGATTCCATCACCCATGAGATCATTCTTTCTTTTTTGGGCCGGGTGCAGTTGGAGGTTGTTTCCGCTTTGCTGTCGGAAAAATACAAGCTTGAAACAGTGGTAAAGGAACCCACCGTCATTTATATGGAGCGGCCGCTCAAAGCAGCCAGCCACACCATCCATATCGAGGTGCCGCCCAACCCGTTTTGGGCATCCATCGGACTGTCTGTTACACCACTCCCGCTTGGCTCCGGTGTACAATACGAGAGCCGGGTTTCGCTGGGATACTTGAACCAGAGTTTTCAAAACGCTGTCAGGGATGGTATCCGTTACGGGCTGGAGCAGGGCTTGTTCGGCTGGAACGTAACGGACTGTAAGATTTGCTTTGAATACGGGCTTTATTACAGTCCGGTCAGCACGCCGGCGGACTTCCGCTCATTGGCCCCGATTGTATTGGAACAGGCATTGAAGGAATCAGGGACGCAACTGCTGGAACCTTATCTCTCCTTCACCCTCTATGCGCCCCGGGAATATCTTTCCAGGGCTTATCATGATGCACCGAAATACTGTGCCACCATCGAAACGGTCCAGGTAAAAAAGGATGAAGTTGTCTTTACTGGCGAGATTCCCGCCCGCTGTATACAGGCATACCGTACTGATCTGGCCTTTTACACCAACGGGCAGAGCGTATGCCTTACAGAACTGAAAGGGTATCAGGCCGCTGTCGGCAAGCCAGTCATCC
gb|AF157553|+|147-1008|ARO:3000938|TEM-72 [Morganella morganii] 	0	806	46	852	861	3478183-	806	ATGAGTATTCAACATTTCCGTGTCGCCCTTATTCCCTTTTTTGCGGCATTTTGCCTTCCTGTTTTTGCTCACCCAGAAACGCTGGTGAAAGTAAAAGATGCTGAAGATCAGTTGGGTGCACGAGTGGGTTACATCGAGCTGGATCTCAACAGCGGTAAGATCCTTGAGAGTTTTCGCCCCGAAGAACGTTTTCCAATGATGAGCACTTTTAAAGTTCTGCTATGTGGTGCGGTATTATCCCGTGTTGACGCCGGGCAAGAGCAACTCGGTCGCCGCATACACTATTCTCAGAATGACTTGGTTGAGTACTCACCAGTCACAGAAAAGCATCTTACGGATGGCATGACAGTAAGAGAATTATGCAGTGCTGCCATAACCATGAGTGATAACACTGCGGCCAACTTACTTCTGACAACGATCGGAGGACCGAAGGAGCTAACCGCTTTTTTGCACAACATGGGGGATCATGTAACCCGCCTTGATCGTTGGGAACCGGAGCTGAATGAAGCCATACCAAACGACGAGCGTGACACCACGATGCCTGCAGCAATGGCAACAACGTTGCGCAAACTATTAACTGGCGAACTACTTACTCTAGCTTCCCGGCAACAATTAATAGACTGGATGGAGGCGGATAAAGTTGCAGGACCACTTCTGCGCTCGGCCCTTCCGGCTGGCTGGTTTATTGCTGATAAATCTGGAGCCGGTGAGCGTGGATCTCGCGGTATCATTGCAGCACTGGGGCCAGATGGTAAGCCCTCCCGTATCGTAGTTATCTACACGACGGGGAGTCAGGCAACTATGGA
gb|AF078527|+|3769-4303|ARO:3000230|ANT(2'')-Ia [Pseudomonas aeruginosa] 	0	479	57	536	534	104604+	479	ATGGACACAACGCAGGTCACATTGATACACAAAATTCTAGCTGCGGCAGATGAGCGAAATCTGCCGCTCTGGATCGGTGGGGGCTGGGCGATCGATGCACGGCTAGGGCGTGTAACACGCAAGCACGATGATATTGATCTGACGTTTCCCGGCGAGAGGCGCGGCGAGCTCGAGGCAATAGTTGAAATGCTCGGCGGGCGCGTCATGGAGGAGTTGGACTATGGATTCTTAGCGGAGATCGGGGATGAGTTACTTGACTGCGAACCTGCTTGGTGGGCAGACGAAGCGTATGAAATCGCGGAGGCTCCGCAGGGCTCGTGCCCAGAGGCGGCTGAGGGCGTCATCGCCGGGCGGCCAGTCCGTTGTAACAGCTGGGAGGCGATCATCTGGGATTACTTTTACTATGCCGATGAAGTACCACCAGTGGACTGGCCTACAAAGCACATAGAGTCCTACAGGCTCGCATGCACCTCACTCGG
gb|NC_002516.2|-|779462-780101|ARO:3002679|Pseudomonas_aeruginosa_catB7 [Pseudomonas aeruginosa PAO1] 	0	584	78566	79150	639	309838+	584	ATGGGCAACTATTTCGAGAGCCCCTTCAGGGGCAAGCTGCTCTCGGAACAGGTCAGCAACCCAAACATTCGGGTGGGGCGCTACAGCTACTACTCCGGCTACTATCACGGGCATTCCTTCGACGACTGCGCCCGCTACCTGATGCCGGACCGCGACGACGTGGACAAGCTGGTCATCGGCAGTTTCTGTTCGATCGGCAGTGGCGCCGCCTTCATCATGGCCGGCAACCAGGGACACCGCGCCGAATGGGCATCGACCTTCCCCTTCCACTTCATGCACGAAGAGCCTGCCTTCGCCGGCGCCGTGAACGGCTATCAGCCAGCGGGCGACACGCTGATCGGCCATGACGTCTGGATCGGTACCGAGGCGATGTTCATGCCCGGCGTACGGGTCGGCCACGGAGCCATCATCGGCAGCCGCGCGCTGGTGACCGGCGATGTCGAGCCCTATGCCATCGTCGGCGGTAACCCGGCCCGGACCATTCGTAAGCGCTTTTCCGATGGCGATATCCAGAACCTGCTGGAAATGGCCTGGTGGGACTGGCCACTGGCCGATATCGAGGCAGCCATGCCACTGCTGTGTAC
gb|JN935135|+|0-861|ARO:3001053|TEM-193 [Acinetobacter baumannii] 	0	806	46	852	861	3478183-	806	ATGAGTATTCAACATTTCCGTGTCGCCCTTATTCCCTTTTTTGCGGCATTTTGCCTTCCTGTTTTTGCTCACCCAGAAACGCTGGTGAAAGTAAAAGATGCTGAAGATCAGTTGGGTGCACGAGTGGGTTACATCGAGCTGGATCTCAACAGCGGTAAGATCCTTGAGAGTTTTCGCCCCGAAGAACGTTTTCCAATGATGAGCACTTTTAAAGTTCTGCTATGTGGTGCGGTATTATCCCGTGTTGACGCCGGGCAAGAGCAACTCGGTCGCCGCATACACTATTCTCAGAATGACTTGGTTGAGTACTCACCAGTCACAGAAAAGCATCTTACGGATGGCATGACAGTAAGAGAATTATGCAGTGCTGCCATAACCATGAGTGATAACACTGCGGCCAACTTACTTCTGACAACGATCGGAGGACCGAAGGAGCTAACCGCTTTTTTGCACAACATGGGGGATCATGTAACCCGCCTTGATCGTTGGGAACCGGAGCTGAATGAAGCCATACCAAACGACGAGCGTGACACCACGATGCCTGCAGCAATGGCAACAACGTTGCGCAAACTATTAACTGGCGAACTACTTACTCTAGCTTCCCGGCAACAATTAATAGACTGGATGGAGGCGGATAAAGTTGCAGGACCACTTCTGCGCTCGGCCCTTCCGGCTGGCTGGTTTATTGCTGATAAATCTGGAGCCGGTGAGCGTGGATCTCGCGGTATCATTGCAGCACTGGGGCCAGATGGTAAGCCCTCCCGTATCGTAGTTATCTACACGACGGGGAGTCAGGCAACTATGGA
gb|AM087454|+|208-1069|ARO:3001015|TEM-148 [Escherichia coli] 	0	806	46	852	861	3478183-	806	ATGAGTATTCAACATTTCCGTGTCGCCCTTATTCCCTTTTTTGCGGCATTTTGCCTTCCTGTTTTTGCTCACCCAGAAACGCTGGTGAAAGTAAAAGATGCTGAAGATCAGTTGGGTGCACGAGTGGGTTACATCGAGCTGGATCTCAACAGCGGTAAGATCCTTGAGAGTTTTCGCCCCGAAGAACGTTTTCCAATGATGAGCACTTTTAAAGTTCTGCTATGTGGTGCGGTATTATCCCGTGTTGACGCCGGGCAAGAGCAACTCGGTCGCCGCATACACTATTCTCAGAATGACTTGGTTGAGTACTCACCAGTCACAGAAAAGCATCTTACGGATGGCATGACAGTAAGAGAATTATGCAGTGCTGCCATAACCATGAGTGATAACACTGCGGCCAACTTACTTCTGACAACGATCGGAGGACCGAAGGAGCTAACCGCTTTTTTGCACAACATGGGGGATCATGTAACCCGCCTTGATCGTTGGGAACCGGAGCTGAATGAAGCCATACCAAACGACGAGCGTGACACCACGATGCCTGCAGCAATGGCAACAACGTTGCGCAAACTATTAACTGGCGAACTACTTACTCTAGCTTCCCGGCAACAATTAATAGACTGGATGGAGGCGGATAAAGTTGCAGGACCACTTCTGCGCTCGGCCCTTCCGGCTGGCTGGTTTATTGCTGATAAATCTGGAGCCGGTGAGCGTGGATCTCGCGGTATCATTGCAGCACTGGGGCCAGATGGTAAGCCCTCCCGTATCGTAGTTATCTACACGACGGGGAGTCAGGCAACTATGGA
gb|AJ012256|+|208-1069|ARO:3000939|TEM-73 [Proteus mirabilis] 	0	806	46	852	861	3478183-	806	ATGAGTATTCAACATTTCCGTGTCGCCCTTATTCCCTTTTTTGCGGCATTTTGCCTTCCTGTTTTTGCTCACCCAGAAACGCTGGTGAAAGTAAAAGATGCTGAAGATCAGTTGGGTGCACGAGTGGGTTACATCGAGCTGGATCTCAACAGCGGTAAGATCCTTGAGAGTTTTCGCCCCGAAGAACGTTTTCCAATGATGAGCACTTTTAAAGTTCTGCTATGTGGTGCGGTATTATCCCGTGTTGACGCCGGGCAAGAGCAACTCGGTCGCCGCATACACTATTCTCAGAATGACTTGGTTGAGTACTCACCAGTCACAGAAAAGCATCTTACGGATGGCATGACAGTAAGAGAATTATGCAGTGCTGCCATAACCATGAGTGATAACACTGCGGCCAACTTACTTCTGACAACGATCGGAGGACCGAAGGAGCTAACCGCTTTTTTGCACAACATGGGGGATCATGTAACCCGCCTTGATCGTTGGGAACCGGAGCTGAATGAAGCCATACCAAACGACGAGCGTGACACCACGATGCCTGCAGCAATGGCAACAACGTTGCGCAAACTATTAACTGGCGAACTACTTACTCTAGCTTCCCGGCAACAATTAATAGACTGGATGGAGGCGGATAAAGTTGCAGGACCACTTCTGCGCTCGGCCCTTCCGGCTGGCTGGTTTATTGCTGATAAATCTGGAGCCGGTGAGCGTGGATCTCGCGGTATCATTGCAGCACTGGGGCCAGATGGTAAGCCCTCCCGTATCGTAGTTATCTACACGACGGGGAGTCAGGCAACTATGGA
gb|KJ920338.1|+|0-825|ARO:3001595|OXA-404 [Acinetobacter baumannii] 	0	770	54149	54919	825	246080-	770	ATGAACATTAAAGCACTCTTACTTATAACAAGCGCTATTTTTATTTCAGCCTGCTCACCTTATATAGTGACTGCTAATCCAAATCACAGCGCTTCAAAATCTGATGTAAAAGCAGAGAAAATTAAAAATTTATTTAACGAAGCACACACTACGGGTGTTTTAGTTATCCAACAAGGCCAAACTCAACAAAGCTATGGTAATGATCTTGCTCGTGCTTCGACCGAGTATGTACCTGCTTCGACCTTCAAAATGCTTAATGCTTTGATCGGCCTTGAGCACCATAAGGCAACCACCACAGAAGTATTTAAGTGGGATGGTAAAAAAAGGTTATTCCCAGAATGGGAAAAGGACATGACCCTAGGCGATGCCATGAAAGCTTCCGCTATTCCAGTTTATCAAGATTTAGCTCGTCGTATTGGACTTGAGCTCATGTCTAAGGAAGTGAAGCGTGTTGGTTATGGCAATGCAGATATCGGTACCCAAGTCGATAATTTTTGGCTGGTGGGTCCTTTAAAAATTACTCCTCAGCAAGAGGCACAGTTTGCTTACAAGCTAGCTAATAAAACGCTTCCATTTAGCCAAAAAGTCCAAGATGAAGTGCAATCCATGCTATTCATAGAAGAAAAGAATGGAAACAAAATATACGCAAAAAGTGGTTGGGGATGGGATGTAAACCCACAAGTAGGCTGGTTAACTGGATGGGTTGTTCAGCCTCAAGGGAATATTGTAGCGTTCTCCCTTAACTTAGAAATGAAAAAAGGAATACCTAG
gb|GQ891757|+|2004-2661|ARO:3002801|QnrVC4 [Aeromonas caviae] 	0	602	292	894	657	53070132+	602	ATGGATAAAACAGACCAGTTATATGTACAAGCAGACTTTTCACATCAAGACATGAGTGGTCAGTATTTTAAAAATTGCAAATTTTTCTGCTGTTCCTTTAAACGAGCAAACCTCCGCGATACACAATTTGTAGACTGTTCTTTCATTGAACGAGGTGAATTAGAGGGGTGTGATTTTTCTTACTCGGATCTTAGAGATGCATCTTTTAAAAACTGCAGTCTTTCAATGTCGTATTTCAAAGGTGCAAATTGTTTTGGTATCGAGTTCAGAGAATGCGATTTAAAGGGTGCCAATTTTGCTCAAGCTAGCTTCATGAATCAGGTATCGAACAGAATGTATTTTTGTTCAGCTTATATAACAGGTTGTAATCTTTCATACGCCAACTTTGAAAGGCAGTGTATCGAAAAGTGTGATTTGTTTGAGAACAGATGGATTGGTGCAAATCTAAGTGGGGCATCATTTAAAGAGTCTGATTTAAGTCGGGGAGTATTTTCTGAAGGGTGTTGGAGCCAGTGTAGGTTGCAAGGTTGTGATTTGAGCCACTCGGACTTGTATGGTTTAGACCCTCGGAAAGTTGACCTTACAGGTGTAAAAATCTGTTC
gb|AL009126.3|-|339155-339749|ARO:3003059|tmrB [Bacillus subtilis subsp. subtilis str. 168] 	0	539	33	571	594	3056893-	538	ATGATCATTTGGATAAACGGGGCATTCGGTTCCGGAAAAACACAAACAGCCTTCGAACTGCACAGAAGGCTGAAATCATCTTACGTGTATGATCCCGAGAAAATGGGTTTTGCGCTGCGCTCCATGGTGCCGCAGGAGATCGCAAAGGACGATTTTCAAAGCTATCCTTTATGGCGGGCGTTCAATTACAGTTTGCTAGCTTCTCTGACAGATACATACCGCGGCATCATTATTGTGCCTATGACGATTGTACATCCTGAATACTTCAATGAGATCATCGGCAGGCTCAGACATGAAGGCAGGATCGTTCACCACTTTACACTAATGGCTTCAAAGGAAACCTTGTTAAAAAGGCTTCGCACCAGAGCAGAAGGAAAAAACTCATGGGCCGCCAAACAAATTGACCGCTGCGTTGAAGGTTTATCATTACCCATTTTTGAGGACCACATTCAAACAGACAACCTGTCGATTCAGGATGTGGCAGAGACATTGCCGCGAGAGCCGAACTCCCATTAGATCCTGATACAAGAGGCAGCCT
gb|DQ369751|+|0-861|ARO:3001016|TEM-149 [Klebsiella aerogenes] 	0	806	46	852	861	3478183-	806	ATGAGTATTCAACATTTCCGTGTCGCCCTTATTCCCTTTTTTGCGGCATTTTGCCTTCCTGTTTTTGCTCACCCAGAAACGCTGGTGAAAGTAAAAGATGCTGAAGATCAGTTGGGTGCACGAGTGGGTTACATCGAGCTGGATCTCAACAGCGGTAAGATCCTTGAGAGTTTTCGCCCCGAAGAACGTTTTCCAATGATGAGCACTTTTAAAGTTCTGCTATGTGGTGCGGTATTATCCCGTGTTGACGCCGGGCAAGAGCAACTCGGTCGCCGCATACACTATTCTCAGAATGACTTGGTTGAGTACTCACCAGTCACAGAAAAGCATCTTACGGATGGCATGACAGTAAGAGAATTATGCAGTGCTGCCATAACCATGAGTGATAACACTGCGGCCAACTTACTTCTGACAACGATCGGAGGACCGAAGGAGCTAACCGCTTTTTTGCACAACATGGGGGATCATGTAACCCGCCTTGATCGTTGGGAACCGGAGCTGAATGAAGCCATACCAAACGACGAGCGTGACACCACGATGCCTGCAGCAATGGCAACAACGTTGCGCAAACTATTAACTGGCGAACTACTTACTCTAGCTTCCCGGCAACAATTAATAGACTGGATGGAGGCGGATAAAGTTGCAGGACCACTTCTGCGCTCGGCCCTTCCGGCTGGCTGGTTTATTGCTGATAAATCTGGAGCCGGTGAGCGTGGATCTCGCGGTATCATTGCAGCACTGGGGCCAGATGGTAAGCCCTCCCGTATCGTAGTTATCTACACGACGGGGAGTCAGGCAACTATGGA
gb|X02340.1|+|222-1194|ARO:3004089|ANT(3'')-IIa [Escherichia coli] 	170	917	0	747	972	104600-	747	GTTAAACATCATGAGGGAAGCGGTGATCGCCGAAGTATCGACTCAACTATCAGAGGTAGTTGGCGTCATCGAGCGCCATCTCGAACCGACGTTGCTGGCCGTACATTTGTACGGCTCCGCAGTGGATGGCGGCCTGAAGCCACACAGTGATATTGATTTGCTGGTTACGGTGACCGTAAGGCTTGATGAAACAACGCGGCGAGCTTTGATCAACGACCTTTTGGAAACTTCGGCTTCCCCTGGAGAGAGCGAGATTCTCCGCGCTGTAGAAGTCACCATTGTTGTGCACGACGACATCATTCCGTGGCGTTATCCAGCTAAGCGCGAACTGCAATTTGGAGAATGGCAGCGCAATGACATTCTTGCAGGTATCTTCGAGCCAGCCACGATCGACATTGATCTGGCTATCTTGCTGACAAAAGCAAGAGAACATAGCGTTGCCTTGGTAGGTCCAGCGGCGGAGGAACTCTTTGATCCGGTTCCTGAACAGGATCTATTTGAGGCGCTAAATGAAACCTTAACGCTATGGAACTCGCCGCCCGACTGGGCTGGCGATGAGCGAAATGTAGTGCTTACGTTGTCCCGCATTTGGTACAGCGCAGTAACCGGCAAAATCGCGCCGAAGGATGTCGCTGCCGACTGGGCAATGGAGCGCCTGCCGGCCCAGTATCAGCCCGTCATACTTGAAGCTAGACAGGCTTATCTTGGACAAGAAGAAGATCGCTTGGCCTCGCGCGCAGATCAGTT
gb|AY130284|+|0-785|ARO:3000941|TEM-75 [Klebsiella pneumoniae] Partial	0	730	82	812	785	3478183-	730	TTTTTTGCGGCATTTTGCCTTCCTGTTTTTGCTCACCCAGAAACGCTGGTGAAAGTAAAAGATGCTGAAGATCAGTTGGGTGCACGAGTGGGTTACATCGAGCTGGATCTCAACAGCGGTAAGATCCTTGAGAGTTTTCGCCCCGAAGAACGTTTTCCAATGATGAGCACTTTTAAAGTTCTGCTATGTGGTGCGGTATTATCCCGTGTTGACGCCGGGCAAGAGCAACTCGGTCGCCGCATACACTATTCTCAGAATGACTTGGTTGAGTACTCACCAGTCACAGAAAAGCATCTTACGGATGGCATGACAGTAAGAGAATTATGCAGTGCTGCCATAACCATGAGTGATAACACTGCGGCCAACTTACTTCTGACAACGATCGGAGGACCGAAGGAGCTAACCGCTTTTTTGCACAACATGGGGGATCATGTAACCCGCCTTGATCGTTGGGAACCGGAGCTGAATGAAGCCATACCAAACGACGAGCGTGACACCACGATGCCTGCAGCAATGGCAACAACGTTGCGCAAACTATTAACTGGCGAACTACTTACTCTAGCTTCCCGGCAACAATTAATAGACTGGATGGAGGCGGATAAAGTTGCAGGACCACTTCTGCGCTCGGCCCTTCCGGCTGGCTGGTTTATTGCTGATAAATCTGGAGCCGGTGAGCGTGGATCTCGCGGTATCATTGCAGCACTGGGGCCAGATGGTAAGCCCTCCCGTA
gb|JN408080|+|0-657|ARO:3002802|QnrVC5 [Vibrio fluvialis] 	0	602	292	894	657	53070132+	602	ATGGATAAAACAGACCAGTTATATGTACAAGCAGACTTTTCACATCAAGACATGAGTGGTCAGTATTTTAAAAATTGCAAATTTTTCTGCTGTTCCTTTAAACGAGCAAACCTCCGCGATACACAATTTGTAGACTGTTCTTTCATTGAACGAGGTGAATTAGAGGGGTGTGATTTTTCTTACTCGGATCTTAGAGATGCATCTTTTAAAAACTGCAGTCTTTCAATGTCGTATTTCAAAGGTGCAAATTGTTTTGGTATCGAGTTCAGAGAATGCGATTTAAAGGGTGCCAATTTTGCTCAAGCTAGCTTCATGAATCAGGTATCGAACAGAATGTATTTTTGTTCAGCTTATATAACAGGTTGTAATCTTTCATACGCCAACTTTGAAAGGCAGTGTATCGAAAAGTGTGATTTGTTTGAGAACAGATGGATTGGTGCAAATCTAAGTGGGGCATCATTTAAAGAGTCTGATTTAAGTCGGGGAGTATTTTCTGAAGGGTGTTGGAGCCAGTGTAGGTTGCAAGGTTGTGATTTGAGCCACTCGGACTTGTATGGTTTAGACCCTCGGAAAGTTGACCTTACAGGTGTAAAAATCTGTTC
gb|JN935136|+|0-861|ARO:3001054|TEM-194 [Acinetobacter baumannii] 	0	806	46	852	861	3478183-	806	ATGAGTATTCAACATTTCCGTGTCGCCCTTATTCCCTTTTTTGCGGCATTTTGCCTTCCTGTTTTTGCTCACCCAGAAACGCTGGTGAAAGTAAAAGATGCTGAAGATCAGTTGGGTGCACGAGTGGGTTACATCGAGCTGGATCTCAACAGCGGTAAGATCCTTGAGAGTTTTCGCCCCGAAGAACGTTTTCCAATGATGAGCACTTTTAAAGTTCTGCTATGTGGTGCGGTATTATCCCGTGTTGACGCCGGGCAAGAGCAACTCGGTCGCCGCATACACTATTCTCAGAATGACTTGGTTGAGTACTCACCAGTCACAGAAAAGCATCTTACGGATGGCATGACAGTAAGAGAATTATGCAGTGCTGCCATAACCATGAGTGATAACACTGCGGCCAACTTACTTCTGACAACGATCGGAGGACCGAAGGAGCTAACCGCTTTTTTGCACAACATGGGGGATCATGTAACCCGCCTTGATCGTTGGGAACCGGAGCTGAATGAAGCCATACCAAACGACGAGCGTGACACCACGATGCCTGCAGCAATGGCAACAACGTTGCGCAAACTATTAACTGGCGAACTACTTACTCTAGCTTCCCGGCAACAATTAATAGACTGGATGGAGGCGGATAAAGTTGCAGGACCACTTCTGCGCTCGGCCCTTCCGGCTGGCTGGTTTATTGCTGATAAATCTGGAGCCGGTGAGCGTGGATCTCGCGGTATCATTGCAGCACTGGGGCCAGATGGTAAGCCCTCCCGTATCGTAGTTATCTACACGACGGGGAGTCAGGCAACTATGGA
gb|AM849805|+|262-1123|ARO:3000886|TEM-15 [Haemophilus parainfluenzae] 	0	806	46	852	861	3478183-	806	ATGAGTATTCAACATTTCCGTGTCGCCCTTATTCCCTTTTTTGCGGCATTTTGCCTTCCTGTTTTTGCTCACCCAGAAACGCTGGTGAAAGTAAAAGATGCTGAAGATCAGTTGGGTGCACGAGTGGGTTACATCGAGCTGGATCTCAACAGCGGTAAGATCCTTGAGAGTTTTCGCCCCGAAGAACGTTTTCCAATGATGAGCACTTTTAAAGTTCTGCTATGTGGTGCGGTATTATCCCGTGTTGACGCCGGGCAAGAGCAACTCGGTCGCCGCATACACTATTCTCAGAATGACTTGGTTGAGTACTCACCAGTCACAGAAAAGCATCTTACGGATGGCATGACAGTAAGAGAATTATGCAGTGCTGCCATAACCATGAGTGATAACACTGCGGCCAACTTACTTCTGACAACGATCGGAGGACCGAAGGAGCTAACCGCTTTTTTGCACAACATGGGGGATCATGTAACCCGCCTTGATCGTTGGGAACCGGAGCTGAATGAAGCCATACCAAACGACGAGCGTGACACCACGATGCCTGCAGCAATGGCAACAACGTTGCGCAAACTATTAACTGGCGAACTACTTACTCTAGCTTCCCGGCAACAATTAATAGACTGGATGGAGGCGGATAAAGTTGCAGGACCACTTCTGCGCTCGGCCCTTCCGGCTGGCTGGTTTATTGCTGATAAATCTGGAGCCGGTGAGCGTGGATCTCGCGGTATCATTGCAGCACTGGGGCCAGATGGTAAGCCCTCCCGTATCGTAGTTATCTACACGACGGGGAGTCAGGCAACTATGGA
gb|AF190694|+|208-1069|ARO:3000942|TEM-76 [Escherichia coli] 	0	806	46	852	861	3478183-	806	ATGAGTATTCAACATTTCCGTGTCGCCCTTATTCCCTTTTTTGCGGCATTTTGCCTTCCTGTTTTTGCTCACCCAGAAACGCTGGTGAAAGTAAAAGATGCTGAAGATCAGTTGGGTGCACGAGTGGGTTACATCGAGCTGGATCTCAACAGCGGTAAGATCCTTGAGAGTTTTCGCCCCGAAGAACGTTTTCCAATGATGAGCACTTTTAAAGTTCTGCTATGTGGTGCGGTATTATCCCGTGTTGACGCCGGGCAAGAGCAACTCGGTCGCCGCATACACTATTCTCAGAATGACTTGGTTGAGTACTCACCAGTCACAGAAAAGCATCTTACGGATGGCATGACAGTAAGAGAATTATGCAGTGCTGCCATAACCATGAGTGATAACACTGCGGCCAACTTACTTCTGACAACGATCGGAGGACCGAAGGAGCTAACCGCTTTTTTGCACAACATGGGGGATCATGTAACCCGCCTTGATCGTTGGGAACCGGAGCTGAATGAAGCCATACCAAACGACGAGCGTGACACCACGATGCCTGCAGCAATGGCAACAACGTTGCGCAAACTATTAACTGGCGAACTACTTACTCTAGCTTCCCGGCAACAATTAATAGACTGGATGGAGGCGGATAAAGTTGCAGGACCACTTCTGCGCTCGGCCCTTCCGGCTGGCTGGTTTATTGCTGATAAATCTGGAGCCGGTGAGCGTGGATCTCGCGGTATCATTGCAGCACTGGGGCCAGATGGTAAGCCCTCCCGTATCGTAGTTATCTACACGACGGGGAGTCAGGCAACTATGGA
gb|KJ584915.1|+|0-825|ARO:3001597|OXA-406 [Acinetobacter baumannii] 	0	770	54149	54919	825	246080-	770	ATGAACATTAAAGCACTCTTACTTATAACAAGCGCTATTTTTATTTCAGCCTGCTCACCTTATATAGTGACTGCTAATCCAAATCACAGCGCTTCAAAATCTGATGTAAAAGCAGAGAAAATTAAAAATTTATTTAACGAAGCACACACTACGGGTGTTTTAGTTATCCAACAAGGCCAAACTCAACAAAGCTATGGTAATGATCTTGCTCGTGCTTCGACCGAGTATGTACCTGCTTCGACCTTCAAAATGCTTAATGCTTTGATCGGCCTTGAGCACCATAAGGCAACCACCACAGAAGTATTTAAGTGGGATGGTAAAAAAAGGTTATTCCCAGAATGGGAAAAGGACATGACCCTAGGCGATGCCATGAAAGCTTCCGCTATTCCAGTTTATCAAGATTTAGCTCGTCGTATTGGACTTGAGCTCATGTCTAAGGAAGTGAAGCGTGTTGGTTATGGCAATGCAGATATCGGTACCCAAGTCGATAATTTTTGGCTGGTGGGTCCTTTAAAAATTACTCCTCAGCAAGAGGCACAGTTTGCTTACAAGCTAGCTAATAAAACGCTTCCATTTAGCCAAAAAGTCCAAGATGAAGTGCAATCCATGCTATTCATAGAAGAAAAGAATGGAAACAAAATATACGCAAAAAGTGGTTGGGGATGGGATGTAAACCCACAAGTAGGCTGGTTAACTGGATGGGTTGTTCAGCCTCAAGGGAATATTGTAGCGTTCTCCCTTAACTTAGAAATGAAAAAAGGAATACCTAG
gb|KM555152|+|0-657|ARO:3003193|QnrVC7 [Vibrio cholerae] 	0	602	292	894	657	53070132+	602	ATGGATAAAACAGACCAGTTATATGTACAAGCAGACTTTTCACATCAAGACATGAGTGGTCAGTATTTTAAAAATTGCAAATTTTTCTGCTGTTCCTTTAAACGAGCAAACCTCCGCGATACACAATTTGTAGACTGTTCTTTCATTGAACGAGGTGAATTAGAGGGGTGTGATTTTTCTTACTCGGATCTTAGAGATGCATCTTTTAAAAACTGCAGTCTTTCAATGTCGTATTTCAAAGGTGCAAATTGTTTTGGTATCGAGTTCAGAGAATGCGATTTAAAGGGTGCCAATTTTGCTCAAGCTAGCTTCATGAATCAGGTATCGAACAGAATGTATTTTTGTTCAGCTTATATAACAGGTTGTAATCTTTCATACGCCAACTTTGAAAGGCAGTGTATCGAAAAGTGTGATTTGTTTGAGAACAGATGGATTGGTGCAAATCTAAGTGGGGCATCATTTAAAGAGTCTGATTTAAGTCGGGGAGTATTTTCTGAAGGGTGTTGGAGCCAGTGTAGGTTGCAAGGTTGTGATTTGAGCCACTCGGACTTGTATGGTTTAGACCCTCGGAAAGTTGACCTTACAGGTGTAAAAATCTGTTC
gb|AE004091.2|+|3982020-3984009|ARO:3002985|arnA [Pseudomonas aeruginosa PAO1] 	0	1934	295	2229	1989	245411+	1934	ATGACCTCGAAAGCCGTCGTCTTCGCCTACCACGACATCGGTTGCACCGGTATCGAAGCCCTGCTCAATGCCGGCTACGAGATCGCCGCCGTCTTCACCCATGCCGACGACCCACGGGAAAACACCTTCTACGCCTCGGTCGCACGCCTCTGTGCCGAGCGCGGCATTCCGCTGCACGCGCCCGAGGACGTGAACCATCCGCTGTGGCTGGAGCGCATCCGCCAACTGCGCCCGGACTTCCTGTTCTCCTTCTACTACCGCCGCCTGCTCGGCGCCGAGCTGCTCGCCTGCGCCGCACGCGGCGCCTACAACCTGCACGGTTCGCTGCTGCCGCGCTACCGCGGACGCGCCCCGGCGAACTGGGTGCTGGTCAACGGCGAAACGCAGACCGGGGTGACCCTGCATCGCATGATCGAGCGCGCCGACGCCGGGCCGATCCTCGCCCAGCAGGCCGTCGCCATCGACCCCGAGGACACCGCCCTGAGCCTGCACGGCAAGCTGCGCAAGGCCGCCGGCGCCCTGCTGCGCGACAGCCTGCCGCTGCTCGCCCTCGGCGTGCTGCCGGAAGTCGAGCAGGACGAGAGCCAGGCCAGCCACTTCGGCCGGCGCACCCCGGCGGACGGCCTGCTCGACTGGCACAGGCCGGCACGGCAGTTGTACGACCTGGTGCGCGCGGTGACCCAGCCCTACCCTGGCGCCTTCTGCCAGGTCGGCGAACAGAAGCTGATCGTCTGGAGCGCCGAGGTGGTCGCCGGCAACCACGGTCGCGAGCCGGGCAGCGTACTGTCCTGCGACCCGCTGCGGATCGCCTGCGGCGAGGACTCGCTGGTGCTGCGCTTCGGCCAGCGCGGCGAGCGCGGCCTGTACCTGGCCGGCACGCAACTGGCCACCGAGCTGGGCCTGGTCGAGGGCGCGCGCCTGCGTGGCGCGGCGTCCGGCCCGCAGCGCCGCACGCGGGTGCTGATCCTCGGGGTCAACGGCTTCATCGGCAACCACCTGTCCGAACGCCTGCTGCGCGACGGGCGCTACGAGGTCCACGGCATGGACATCGGCTCCGACGCCATCGAACGGCTCAAGGCCGACCCGCATTTCCACTTCGTCGAAGGCGACATCGGCATCCATTCGGAGTGGCTCGAATACCATGTGAAGAAATGCGACGTGGTCCTGCCGCTGGTGGCCATCGCCACGCCCATCGAGTACACGCGCAACCCGCTGCGGGTGTTCGAACTGGACTTCGAGGAAAACCTGCGGATCGTCCGCTACTGCGTGAAATACGGCAAACGCGTGGTGTTCCCTTCCACCTCCGAGGTCTACGGCATGTGCCAGGACCCGGACTTCGACGAAGACCGCTCGAATCTGGTGGTCGGGCCGATCAACAAGCAGCGCTGGATCTACTCGGTGTCCAAGCAGTTGCTCGACCGGGTGATCTGGGCCTACGGCCAGCAGGGCCTGCGCTTCACCCTGTTCCGTCCGTTCAACTGGATGGGCCCGCGCCTGGACCGCCTGGATTCGGCGCGGATCGGCAGCTCGCGGGCGATCACCCAGCTCATCCTGCACCTGGTCGAAGGCACGCCGATCCGCCTGGTCGACGGCGGCGCGCAGAAGCGCTGCTTCACCGACGTCGACGACGGCATCGAGGCCCTCGCGCGGATCATCGACAACCGCGACGGCCGCTGCGACGGGCAGATCGTCAACATCGGCAACCCGGACAACGAGGCGAGCATCCGCCAGCTCGGCGAGGAACTGCTGCGCCAGTTCGAGGCCCACCCGCTGCGCGCGCAGTTCCCGCCCTTCGCCGGCTTCCGCGAGGTGGAGAGCCGCAGCTTCTACGGCGACGGCTACCAGGACGTGGCCCACCGCAAGCCGAGCATCGACAACGCCCGGCGCCTGCTCGACTGGCAGCCCACCATCGAACTGCGCGAGACCATCGGCAA
gb|AM183304|+|208-1069|ARO:3001017|TEM-150 [Escherichia coli] 	0	806	46	852	861	3478183-	806	ATGAGTATTCAACATTTCCGTGTCGCCCTTATTCCCTTTTTTGCGGCATTTTGCCTTCCTGTTTTTGCTCACCCAGAAACGCTGGTGAAAGTAAAAGATGCTGAAGATCAGTTGGGTGCACGAGTGGGTTACATCGAGCTGGATCTCAACAGCGGTAAGATCCTTGAGAGTTTTCGCCCCGAAGAACGTTTTCCAATGATGAGCACTTTTAAAGTTCTGCTATGTGGTGCGGTATTATCCCGTGTTGACGCCGGGCAAGAGCAACTCGGTCGCCGCATACACTATTCTCAGAATGACTTGGTTGAGTACTCACCAGTCACAGAAAAGCATCTTACGGATGGCATGACAGTAAGAGAATTATGCAGTGCTGCCATAACCATGAGTGATAACACTGCGGCCAACTTACTTCTGACAACGATCGGAGGACCGAAGGAGCTAACCGCTTTTTTGCACAACATGGGGGATCATGTAACCCGCCTTGATCGTTGGGAACCGGAGCTGAATGAAGCCATACCAAACGACGAGCGTGACACCACGATGCCTGCAGCAATGGCAACAACGTTGCGCAAACTATTAACTGGCGAACTACTTACTCTAGCTTCCCGGCAACAATTAATAGACTGGATGGAGGCGGATAAAGTTGCAGGACCACTTCTGCGCTCGGCCCTTCCGGCTGGCTGGTTTATTGCTGATAAATCTGGAGCCGGTGAGCGTGGATCTCGCGGTATCATTGCAGCACTGGGGCCAGATGGTAAGCCCTCCCGTATCGTAGTTATCTACACGACGGGGAGTCAGGCAACTATGGA
gb|AF190693|+|208-1069|ARO:3000944|TEM-78 [Escherichia coli] 	0	806	46	852	861	3478183-	806	ATGAGTATTCAACATTTCCGTGTCGCCCTTATTCCCTTTTTTGCGGCATTTTGCCTTCCTGTTTTTGCTCACCCAGAAACGCTGGTGAAAGTAAAAGATGCTGAAGATCAGTTGGGTGCACGAGTGGGTTACATCGAGCTGGATCTCAACAGCGGTAAGATCCTTGAGAGTTTTCGCCCCGAAGAACGTTTTCCAATGATGAGCACTTTTAAAGTTCTGCTATGTGGTGCGGTATTATCCCGTGTTGACGCCGGGCAAGAGCAACTCGGTCGCCGCATACACTATTCTCAGAATGACTTGGTTGAGTACTCACCAGTCACAGAAAAGCATCTTACGGATGGCATGACAGTAAGAGAATTATGCAGTGCTGCCATAACCATGAGTGATAACACTGCGGCCAACTTACTTCTGACAACGATCGGAGGACCGAAGGAGCTAACCGCTTTTTTGCACAACATGGGGGATCATGTAACCCGCCTTGATCGTTGGGAACCGGAGCTGAATGAAGCCATACCAAACGACGAGCGTGACACCACGATGCCTGCAGCAATGGCAACAACGTTGCGCAAACTATTAACTGGCGAACTACTTACTCTAGCTTCCCGGCAACAATTAATAGACTGGATGGAGGCGGATAAAGTTGCAGGACCACTTCTGCGCTCGGCCCTTCCGGCTGGCTGGTTTATTGCTGATAAATCTGGAGCCGGTGAGCGTGGATCTCGCGGTATCATTGCAGCACTGGGGCCAGATGGTAAGCCCTCCCGTATCGTAGTTATCTACACGACGGGGAGTCAGGCAACTATGGA
gb|JN935137|+|0-861|ARO:3001055|TEM-195 [Acinetobacter baumannii] 	0	806	46	852	861	3478183-	806	ATGAGTATTCAACATTTCCGTGTCGCCCTTATTCCCTTTTTTGCGGCATTTTGCCTTCCTGTTTTTGCTCACCCAGAAACGCTGGTGAAAGTAAAAGATGCTGAAGATCAGTTGGGTGCACGAGTGGGTTACATCGAGCTGGATCTCAACAGCGGTAAGATCCTTGAGAGTTTTCGCCCCGAAGAACGTTTTCCAATGATGAGCACTTTTAAAGTTCTGCTATGTGGTGCGGTATTATCCCGTGTTGACGCCGGGCAAGAGCAACTCGGTCGCCGCATACACTATTCTCAGAATGACTTGGTTGAGTACTCACCAGTCACAGAAAAGCATCTTACGGATGGCATGACAGTAAGAGAATTATGCAGTGCTGCCATAACCATGAGTGATAACACTGCGGCCAACTTACTTCTGACAACGATCGGAGGACCGAAGGAGCTAACCGCTTTTTTGCACAACATGGGGGATCATGTAACCCGCCTTGATCGTTGGGAACCGGAGCTGAATGAAGCCATACCAAACGACGAGCGTGACACCACGATGCCTGCAGCAATGGCAACAACGTTGCGCAAACTATTAACTGGCGAACTACTTACTCTAGCTTCCCGGCAACAATTAATAGACTGGATGGAGGCGGATAAAGTTGCAGGACCACTTCTGCGCTCGGCCCTTCCGGCTGGCTGGTTTATTGCTGATAAATCTGGAGCCGGTGAGCGTGGATCTCGCGGTATCATTGCAGCACTGGGGCCAGATGGTAAGCCCTCCCGTATCGTAGTTATCTACACGACGGGGAGTCAGGCAACTATGGA
gb|V00618.1|+|150-945|ARO:3002644|APH(3')-IIa [Escherichia coli] 	0	521	15	536	795	55547182+	521	ATGATTGAACAAGATGGATTGCACGCAGGTTCTCCGGCCGCTTGGGTGGAGAGGCTATTCGGCTATGACTGGGCACAACAGACAATCGGCTGCTCTGATGCCGCCGTGTTCCGGCTGTCAGCGCAGGGGCGCCCGGTTCTTTTTGTCAAGACCGACCTGTCCGGTGCCCTGAATGAACTGCAAGACGAGGCAGCGCGGCTATCGTGGCTGGCCACGACGGGCGTTCCTTGCGCAGCTGTGCTCGACGTTGTCACTGAAGCGGGAAGGGACTGGCTGCTATTGGGCGAAGTGCCGGGGCAGGATCTCCTGTCATCTCACCTTGCTCCTGCCGAGAAAGTATCCATCATGGCTGATGCAATGCGGCGGCTGCATACGCTTGATCCGGCTACCTGCCCATTCGACCACCAAGCGAAACATCGCATCGAGCGAGCACGTACTCGGATGGAAGCCGGTCTTGTCGATCAGGATGATCTGGACGAAGAGCATCAGGGGCTCGCGCCAGCCGAACTGTTCGCCAGGCT
gb|FJ668814|+|76-937|ARO:3001059|SHV-1 [Klebsiella pneumoniae] 	0	806	16	822	861	1612535+	806	ATGCGTTATATTCGCCTGTGTATTATCACCCTGTGAGCCACCCTGCCGCTGGCGGTACACGCCAGCCCGCAGCCGCTTGAGCAAATTAAACAAAGCGAAAGCCAGCTGTCGGGCCGCGTAGGCATGATAGAAATGGATCTGGCCAGCGGCCGCACGCTGACCGCCTGGCGCGCCGATGAACGCTTTCCCATGATGAGCACCTTTAAAGTAGTGCTCTGCGGCGCAGTGCTGGCGCGGGTGGATGCCGGTGACGAACAGCTGGAGCGAAAGATCCACTATCGCCAGCAGGATCTGGTGGACTACTCGCCGGTCAGCGAAAAACACCTTGCCGACGGCATGACGGTCGGCGAACTCTGCGCCGCCGCCATTACCATGAGCGATAACAGCGCCGCCAATCTGCTGCTGGCCACCGTCGGCGGCCCCGCAGGATTGACTGCCTTTTTGCGCCAGATCGGCGACAACGTCACCCGCCTTGACCGCTGGGAAACGGAACTGAATGAGGCGCTTCCCGGCGACGCCCGCGACACCACTACCCCGGCCAGCATGGCCGCGACCCTGCGCAAGCTGCTGACCAGCCAGCGTCTGAGCGCCCGTTCGCAACGGCAGCTGCTGCAGTGGATGGTGGACGATCGGGTCGCCGGACCGTTGATCCGCTCCGTGCTGCCGGCGGGCTGGTTTATCGCCGATAAGACCGGAGCTAGCAAGCGGGGTGCGCGCGGGATTGTCGCCCTGCTTGGCCCGAATAACAAAGCAGAGCGCATTGTGGTGATTTATCTGCGGGATACGCCGGCGAGCATGGCCGAGCG
gb|DQ834729|+|205-1066|ARO:3001018|TEM-151 [Escherichia coli] 	0	806	46	852	861	3478183-	806	ATGAGTATTCAACATTTCCGTGTCGCCCTTATTCCCTTTTTTGCGGCATTTTGCCTTCCTGTTTTTGCTCACCCAGAAACGCTGGTGAAAGTAAAAGATGCTGAAGATCAGTTGGGTGCACGAGTGGGTTACATCGAGCTGGATCTCAACAGCGGTAAGATCCTTGAGAGTTTTCGCCCCGAAGAACGTTTTCCAATGATGAGCACTTTTAAAGTTCTGCTATGTGGTGCGGTATTATCCCGTGTTGACGCCGGGCAAGAGCAACTCGGTCGCCGCATACACTATTCTCAGAATGACTTGGTTGAGTACTCACCAGTCACAGAAAAGCATCTTACGGATGGCATGACAGTAAGAGAATTATGCAGTGCTGCCATAACCATGAGTGATAACACTGCGGCCAACTTACTTCTGACAACGATCGGAGGACCGAAGGAGCTAACCGCTTTTTTGCACAACATGGGGGATCATGTAACCCGCCTTGATCGTTGGGAACCGGAGCTGAATGAAGCCATACCAAACGACGAGCGTGACACCACGATGCCTGCAGCAATGGCAACAACGTTGCGCAAACTATTAACTGGCGAACTACTTACTCTAGCTTCCCGGCAACAATTAATAGACTGGATGGAGGCGGATAAAGTTGCAGGACCACTTCTGCGCTCGGCCCTTCCGGCTGGCTGGTTTATTGCTGATAAATCTGGAGCCGGTGAGCGTGGATCTCGCGGTATCATTGCAGCACTGGGGCCAGATGGTAAGCCCTCCCGTATCGTAGTTATCTACACGACGGGGAGTCAGGCAACTATGGA
gb|DQ834728|+|205-1066|ARO:3001019|TEM-152 [Escherichia coli] 	0	806	46	852	861	3478183-	806	ATGAGTATTCAACATTTCCGTGTCGCCCTTATTCCCTTTTTTGCGGCATTTTGCCTTCCTGTTTTTGCTCACCCAGAAACGCTGGTGAAAGTAAAAGATGCTGAAGATCAGTTGGGTGCACGAGTGGGTTACATCGAGCTGGATCTCAACAGCGGTAAGATCCTTGAGAGTTTTCGCCCCGAAGAACGTTTTCCAATGATGAGCACTTTTAAAGTTCTGCTATGTGGTGCGGTATTATCCCGTGTTGACGCCGGGCAAGAGCAACTCGGTCGCCGCATACACTATTCTCAGAATGACTTGGTTGAGTACTCACCAGTCACAGAAAAGCATCTTACGGATGGCATGACAGTAAGAGAATTATGCAGTGCTGCCATAACCATGAGTGATAACACTGCGGCCAACTTACTTCTGACAACGATCGGAGGACCGAAGGAGCTAACCGCTTTTTTGCACAACATGGGGGATCATGTAACCCGCCTTGATCGTTGGGAACCGGAGCTGAATGAAGCCATACCAAACGACGAGCGTGACACCACGATGCCTGCAGCAATGGCAACAACGTTGCGCAAACTATTAACTGGCGAACTACTTACTCTAGCTTCCCGGCAACAATTAATAGACTGGATGGAGGCGGATAAAGTTGCAGGACCACTTCTGCGCTCGGCCCTTCCGGCTGGCTGGTTTATTGCTGATAAATCTGGAGCCGGTGAGCGTGGATCTCGCGGTATCATTGCAGCACTGGGGCCAGATGGTAAGCCCTCCCGTATCGTAGTTATCTACACGACGGGGAGTCAGGCAACTATGGA
gb|U00096.3|-|3203309-3204131|ARO:3002986|bacA [Escherichia coli str. K-12 substr. MG1655] 	0	765	2132	2897	822	248330-	765	ATGAGCGATATGCACTCGCTGCTGATAGCGGCAATATTGGGTGTGGTCGAAGGATTGACAGAATTTCTGCCGGTATCCAGCACGGGCCATATGATTATTGTCGGTCACTTGTTGGGGTTCGAGGGCGACACGGCGAAAACCTTTGAAGTTGTGATCCAGTTAGGATCAATTCTGGCGGTAGTAGTGATGTTCTGGCGGCGTCTGTTTGGCCTGATTGGCATCCACTTTGGCCGCCCGTTGCAGCACGAAGGAGAAAGCAAAGGTCGTTTAACGCTGATCCACATTTTGCTGGGGATGATTCCGGCGGTGGTACTGGGGCTGTTGTTCCACGACACGATTAAGTCATTGTTTAACCCGATAAATGTGATGTATGCACTGGTCGTTGGCGGTTTGTTGCTGATTGCCGCCGAATGCCTGAAGCCGAAAGAGCCGCGTGCGCCGGGTCTTGATGATATGACCTATCGTCAGGCGTTTATGATTGGCTGTTTCCAGTGTCTGGCGCTGTGGCCGGGTTTCTCCCGTTCCGGGGCCACCATTTCAGGTGGGATGCTGATGGGCGTGAGCCGTTACGCTGCTTCCGAGTTCTCGTTCCTGCTGGCGGTACCGATGATGATGGGCGCAACGGCGCTCGATCTCTACAAAAGCTGGGGCTTCCTGACAACCGGCGATATCCCGATGTTTGCCGTTGGGTTTATCACCGCTTTTGTGGTGGCGCTGATAGCGATTAAAACCTTCCTGCAATTGATTAAGCGCATTTCGTTTATC
gb|AF190692|+|208-1069|ARO:3000946|TEM-79 [Escherichia coli] 	0	806	46	852	861	3478183-	806	ATGAGTATTCAACATTTCCGTGTCGCCCTTATTCCCTTTTTTGCGGCATTTTGCCTTCCTGTTTTTGCTCACCCAGAAACGCTGGTGAAAGTAAAAGATGCTGAAGATCAGTTGGGTGCACGAGTGGGTTACATCGAGCTGGATCTCAACAGCGGTAAGATCCTTGAGAGTTTTCGCCCCGAAGAACGTTTTCCAATGATGAGCACTTTTAAAGTTCTGCTATGTGGTGCGGTATTATCCCGTGTTGACGCCGGGCAAGAGCAACTCGGTCGCCGCATACACTATTCTCAGAATGACTTGGTTGAGTACTCACCAGTCACAGAAAAGCATCTTACGGATGGCATGACAGTAAGAGAATTATGCAGTGCTGCCATAACCATGAGTGATAACACTGCGGCCAACTTACTTCTGACAACGATCGGAGGACCGAAGGAGCTAACCGCTTTTTTGCACAACATGGGGGATCATGTAACCCGCCTTGATCGTTGGGAACCGGAGCTGAATGAAGCCATACCAAACGACGAGCGTGACACCACGATGCCTGCAGCAATGGCAACAACGTTGCGCAAACTATTAACTGGCGAACTACTTACTCTAGCTTCCCGGCAACAATTAATAGACTGGATGGAGGCGGATAAAGTTGCAGGACCACTTCTGCGCTCGGCCCTTCCGGCTGGCTGGTTTATTGCTGATAAATCTGGAGCCGGTGAGCGTGGATCTCGCGGTATCATTGCAGCACTGGGGCCAGATGGTAAGCCCTCCCGTATCGTAGTTATCTACACGACGGGGAGTCAGGCAACTATGGA
gb|JQ034306|+|0-861|ARO:3001376|TEM-196 [Shigella sonnei] 	0	806	46	852	861	3478183-	806	ATGAGTATTCAACATTTCCGTGTCGCCCTTATTCCCTTTTTTGCGGCATTTTGCCTTCCTGTTTTTGCTCACCCAGAAACGCTGGTGAAAGTAAAAGATGCTGAAGATCAGTTGGGTGCACGAGTGGGTTACATCGAGCTGGATCTCAACAGCGGTAAGATCCTTGAGAGTTTTCGCCCCGAAGAACGTTTTCCAATGATGAGCACTTTTAAAGTTCTGCTATGTGGTGCGGTATTATCCCGTGTTGACGCCGGGCAAGAGCAACTCGGTCGCCGCATACACTATTCTCAGAATGACTTGGTTGAGTACTCACCAGTCACAGAAAAGCATCTTACGGATGGCATGACAGTAAGAGAATTATGCAGTGCTGCCATAACCATGAGTGATAACACTGCGGCCAACTTACTTCTGACAACGATCGGAGGACCGAAGGAGCTAACCGCTTTTTTGCACAACATGGGGGATCATGTAACCCGCCTTGATCGTTGGGAACCGGAGCTGAATGAAGCCATACCAAACGACGAGCGTGACACCACGATGCCTGCAGCAATGGCAACAACGTTGCGCAAACTATTAACTGGCGAACTACTTACTCTAGCTTCCCGGCAACAATTAATAGACTGGATGGAGGCGGATAAAGTTGCAGGACCACTTCTGCGCTCGGCCCTTCCGGCTGGCTGGTTTATTGCTGATAAATCTGGAGCCGGTGAGCGTGGATCTCGCGGTATCATTGCAGCACTGGGGCCAGATGGTAAGCCCTCCCGTATCGTAGTTATCTACACGACGGGGAGTCAGGCAACTATGGA
gb|U00096|-|2098446-2099613|ARO:3003577|ugd [Escherichia coli str. K-12 substr. MG1655] 	0,702	513,1112	71,0	584,364	1167	277880+;1912523-	513;364	ATGAAAATCACCATTTCCGGTACTGGCTATGTCGGCTTGTCAAACGGGCTTCTAATCGCACAAAATCATGAGGTTGTGGCATTAGATATTTTACCGTCACGCGTTGCTATGCTGAATGATCGGATATCTCCTATTGTTGATAAGGAAATTCAGCAGTTTTTGCAATCAGATAAAATACACTTTAATGCCACATTAGATAAAAATGAAGCCTATCGGGATGCTGATTACGTCATCATCGCCACTCCAACCGACTATGATCCTAAAACTAATTATTTCAATACATCGAGTGTAGAATCAGTAATTAAAGACGTAGTTGAGATAAATCCTTATGCGGTTATGGTGATCAAATCAACGGTTCCCGTTGGTTTTACCGCAGCGATGCATAAGAAATATCGCACTGAAAATATTATATTCTCCCCGGAATTTCTCCGTGAGGGTAAAGCCCTTTACGATAATCTCCATCCTTCACGTATTGTCATCGGTGAGCGTTCAGAACGCGCAGAACGTTTTGCT;GACCCACGTATTGGCAACCATTACAACAATCCGTCGTTTGGTTATGGTGGTTATTGTCTGCCGAAAGATACTAAGCAGTTACTGGCGAACTACCAGTCTGTGCCGAATAACCTGATCTCGGCAATTGTCGATGCAAACCGCAAGTGGTGGGTATTTATCGTCTGATTATGAAGAGCGGTTCAGACAACTTCCGCGCGTCTTCCATTCAGGGGATTATGAAACGTATCAAGGCGAAAGGCGTTGAAGTGATCATTTACGAGCCGGTGATGAAAGAAGACTCATTCTTCAACTCTCGCCTGGAACGTGATCTCGCCACTTTCAAACAACAAGCCGATGTCATTATTTCCAACCGTATGGCAGAAGA
gb|KJ584916.1|+|0-825|ARO:3001598|OXA-407 [Acinetobacter baumannii] 	0	770	54149	54919	825	246080-	770	ATGAACATTAAAGCACTCTTACTTATAACAAGCGCTATTTTTATTTCAGCCTGCTCACCTTATATAGTGACTGCTAATCCAAATCACAGCGCTTCAAAATCTGATGTAAAAGCAGAGAAAATTAAAAATTTATTTAACGAAGCACACACTACGGGTGTTTTAGTTATCCAACAAGGCCAAACTCAACAAAGCTATGGTAATGATCTTGCTCGTGCTTCGACCGAGTATGTACCTGCTTCGACCTTCAAAATGCTTAATGCTTTGATCGGCCTTGAGCACCATAAGGCAACCACCACAGAAGTATTTAAGTGGGATGGTAAAAAAAGGTTATTCCCAGAATGGGAAAAGGACATGACCCTAGGCGATGCCATGAAAGCTTCCGCTATTCCAGTTTATCAAGATTTAGCTCGTCGTATTGGACTTGAGCTCATGTCTAAGGAAGTGAAGCGTGTTGGTTATGGCAATGCAGATATCGGTACCCAAGTCGATAATTTTTGGCTGGTGGGTCCTTTAAAAATTACTCCTCAGCAAGAGGCACAGTTTGCTTACAAGCTAGCTAATAAAACGCTTCCATTTAGCCAAAAAGTCCAAGATGAAGTGCAATCCATGCTATTCATAGAAGAAAAGAATGGAAACAAAATATACGCAAAAAGTGGTTGGGGATGGGATGTAAACCCACAAGTAGGCTGGTTAACTGGATGGGTTGTTCAGCCTCAAGGGAATATTGTAGCGTTCTCCCTTAACTTAGAAATGAAAAAAGGAATACCTAG
gb|KC149518|+|0-861|ARO:3001369|TEM-153 [Escherichia coli] 	0	806	46	852	861	3478183-	806	ATGAGTATTCAACATTTCCGTGTCGCCCTTATTCCCTTTTTTGCGGCATTTTGCCTTCCTGTTTTTGCTCACCCAGAAACGCTGGTGAAAGTAAAAGATGCTGAAGATCAGTTGGGTGCACGAGTGGGTTACATCGAGCTGGATCTCAACAGCGGTAAGATCCTTGAGAGTTTTCGCCCCGAAGAACGTTTTCCAATGATGAGCACTTTTAAAGTTCTGCTATGTGGTGCGGTATTATCCCGTGTTGACGCCGGGCAAGAGCAACTCGGTCGCCGCATACACTATTCTCAGAATGACTTGGTTGAGTACTCACCAGTCACAGAAAAGCATCTTACGGATGGCATGACAGTAAGAGAATTATGCAGTGCTGCCATAACCATGAGTGATAACACTGCGGCCAACTTACTTCTGACAACGATCGGAGGACCGAAGGAGCTAACCGCTTTTTTGCACAACATGGGGGATCATGTAACCCGCCTTGATCGTTGGGAACCGGAGCTGAATGAAGCCATACCAAACGACGAGCGTGACACCACGATGCCTGCAGCAATGGCAACAACGTTGCGCAAACTATTAACTGGCGAACTACTTACTCTAGCTTCCCGGCAACAATTAATAGACTGGATGGAGGCGGATAAAGTTGCAGGACCACTTCTGCGCTCGGCCCTTCCGGCTGGCTGGTTTATTGCTGATAAATCTGGAGCCGGTGAGCGTGGATCTCGCGGTATCATTGCAGCACTGGGGCCAGATGGTAAGCCCTCCCGTATCGTAGTTATCTACACGACGGGGAGTCAGGCAACTATGGA
gb|HQ877606|+|0-861|ARO:3001056|TEM-197 [Klebsiella pneumoniae] 	0	806	46	852	861	3478183-	806	ATGAGTATTCAACATTTCCGTGTCGCCCTTATTCCCTTTTTTGCGGCATTTTGCCTTCCTGTTTTTGCTCACCCAGAAACGCTGGTGAAAGTAAAAGATGCTGAAGATCAGTTGGGTGCACGAGTGGGTTACATCGAGCTGGATCTCAACAGCGGTAAGATCCTTGAGAGTTTTCGCCCCGAAGAACGTTTTCCAATGATGAGCACTTTTAAAGTTCTGCTATGTGGTGCGGTATTATCCCGTGTTGACGCCGGGCAAGAGCAACTCGGTCGCCGCATACACTATTCTCAGAATGACTTGGTTGAGTACTCACCAGTCACAGAAAAGCATCTTACGGATGGCATGACAGTAAGAGAATTATGCAGTGCTGCCATAACCATGAGTGATAACACTGCGGCCAACTTACTTCTGACAACGATCGGAGGACCGAAGGAGCTAACCGCTTTTTTGCACAACATGGGGGATCATGTAACCCGCCTTGATCGTTGGGAACCGGAGCTGAATGAAGCCATACCAAACGACGAGCGTGACACCACGATGCCTGCAGCAATGGCAACAACGTTGCGCAAACTATTAACTGGCGAACTACTTACTCTAGCTTCCCGGCAACAATTAATAGACTGGATGGAGGCGGATAAAGTTGCAGGACCACTTCTGCGCTCGGCCCTTCCGGCTGGCTGGTTTATTGCTGATAAATCTGGAGCCGGTGAGCGTGGATCTCGCGGTATCATTGCAGCACTGGGGCCAGATGGTAAGCCCTCCCGTATCGTAGTTATCTACACGACGGGGAGTCAGGCAACTATGGA
gb|EU155018|+|0-861|ARO:3001150|SHV-101 [Klebsiella pneumoniae] 	0	806	16	822	861	1612535+	806	ATGCGTTATATTCGCCTGTGTATTATCACCCTGTGAGCCACCCTGCCGCTGGCGGTACACGCCAGCCCGCAGCCGCTTGAGCAAATTAAACAAAGCGAAAGCCAGCTGTCGGGCCGCGTAGGCATGATAGAAATGGATCTGGCCAGCGGCCGCACGCTGACCGCCTGGCGCGCCGATGAACGCTTTCCCATGATGAGCACCTTTAAAGTAGTGCTCTGCGGCGCAGTGCTGGCGCGGGTGGATGCCGGTGACGAACAGCTGGAGCGAAAGATCCACTATCGCCAGCAGGATCTGGTGGACTACTCGCCGGTCAGCGAAAAACACCTTGCCGACGGCATGACGGTCGGCGAACTCTGCGCCGCCGCCATTACCATGAGCGATAACAGCGCCGCCAATCTGCTGCTGGCCACCGTCGGCGGCCCCGCAGGATTGACTGCCTTTTTGCGCCAGATCGGCGACAACGTCACCCGCCTTGACCGCTGGGAAACGGAACTGAATGAGGCGCTTCCCGGCGACGCCCGCGACACCACTACCCCGGCCAGCATGGCCGCGACCCTGCGCAAGCTGCTGACCAGCCAGCGTCTGAGCGCCCGTTCGCAACGGCAGCTGCTGCAGTGGATGGTGGACGATCGGGTCGCCGGACCGTTGATCCGCTCCGTGCTGCCGGCGGGCTGGTTTATCGCCGATAAGACCGGAGCTAGCAAGCGGGGTGCGCGCGGGATTGTCGCCCTGCTTGGCCCGAATAACAAAGCAGAGCGCATTGTGGTGATTTATCTGCGGGATACGCCGGCGAGCATGGCCGAGCG
gb|FJ807656|+|0-861|ARO:3001020|TEM-154 [Escherichia coli] 	0	806	46	852	861	3478183-	806	ATGAGTATTCAACATTTCCGTGTCGCCCTTATTCCCTTTTTTGCGGCATTTTGCCTTCCTGTTTTTGCTCACCCAGAAACGCTGGTGAAAGTAAAAGATGCTGAAGATCAGTTGGGTGCACGAGTGGGTTACATCGAGCTGGATCTCAACAGCGGTAAGATCCTTGAGAGTTTTCGCCCCGAAGAACGTTTTCCAATGATGAGCACTTTTAAAGTTCTGCTATGTGGTGCGGTATTATCCCGTGTTGACGCCGGGCAAGAGCAACTCGGTCGCCGCATACACTATTCTCAGAATGACTTGGTTGAGTACTCACCAGTCACAGAAAAGCATCTTACGGATGGCATGACAGTAAGAGAATTATGCAGTGCTGCCATAACCATGAGTGATAACACTGCGGCCAACTTACTTCTGACAACGATCGGAGGACCGAAGGAGCTAACCGCTTTTTTGCACAACATGGGGGATCATGTAACCCGCCTTGATCGTTGGGAACCGGAGCTGAATGAAGCCATACCAAACGACGAGCGTGACACCACGATGCCTGCAGCAATGGCAACAACGTTGCGCAAACTATTAACTGGCGAACTACTTACTCTAGCTTCCCGGCAACAATTAATAGACTGGATGGAGGCGGATAAAGTTGCAGGACCACTTCTGCGCTCGGCCCTTCCGGCTGGCTGGTTTATTGCTGATAAATCTGGAGCCGGTGAGCGTGGATCTCGCGGTATCATTGCAGCACTGGGGCCAGATGGTAAGCCCTCCCGTATCGTAGTTATCTACACGACGGGGAGTCAGGCAACTATGGA
gb|X65252|+|175-1036|ARO:3000880|TEM-8 [Klebsiella pneumoniae] 	0	806	46	852	861	3478183-	806	ATGAGTATTCAACATTTCCGTGTCGCCCTTATTCCCTTTTTTGCGGCATTTTGCCTTCCTGTTTTTGCTCACCCAGAAACGCTGGTGAAAGTAAAAGATGCTGAAGATCAGTTGGGTGCACGAGTGGGTTACATCGAGCTGGATCTCAACAGCGGTAAGATCCTTGAGAGTTTTCGCCCCGAAGAACGTTTTCCAATGATGAGCACTTTTAAAGTTCTGCTATGTGGTGCGGTATTATCCCGTGTTGACGCCGGGCAAGAGCAACTCGGTCGCCGCATACACTATTCTCAGAATGACTTGGTTGAGTACTCACCAGTCACAGAAAAGCATCTTACGGATGGCATGACAGTAAGAGAATTATGCAGTGCTGCCATAACCATGAGTGATAACACTGCGGCCAACTTACTTCTGACAACGATCGGAGGACCGAAGGAGCTAACCGCTTTTTTGCACAACATGGGGGATCATGTAACCCGCCTTGATCGTTGGGAACCGGAGCTGAATGAAGCCATACCAAACGACGAGCGTGACACCACGATGCCTGCAGCAATGGCAACAACGTTGCGCAAACTATTAACTGGCGAACTACTTACTCTAGCTTCCCGGCAACAATTAATAGACTGGATGGAGGCGGATAAAGTTGCAGGACCACTTCTGCGCTCGGCCCTTCCGGCTGGCTGGTTTATTGCTGATAAATCTGGAGCCGGTGAGCGTGGATCTCGCGGTATCATTGCAGCACTGGGGCCAGATGGTAAGCCCTCCCGTATCGTAGTTATCTACACGACGGGGAGTCAGGCAACTATGGA
gb|X90856|+|387-1194|ARO:3002645|APH(3')-IIb [Pseudomonas aeruginosa] 	0	752	6925	7677	807	232416-	752	ATGCATGATGCAGCCACCTCCATGCCGCCGCAGGCTCCCTCAACCTGGGCCGACTACCTTGCCGGCTACCGCTGGCGAGGGCAGGGCGAAGGATGTTCCGCGGCCACGGTCCACCGCCTGGAGGCTGAGCGGCGGCCGACCCTGTTCGTCAAGCAGGAAGTGCTGTCCGCACATGCCGAGCTGCCCGCCGAAATCGCCCGCCTGCGCTGGCTGCACGGTGCCGGCATCGATTGCCCGCAGGTGCTGAACGAAACCCAGAGCGACGGCCGGCAATGGCTGCTGATGAGCGCCGTGCCGGGGGACACGCTGTCCGCGCTGGCGCAGCGCGGCGAGCTGGAGCCCGAGCGCCTGGTGCGCCTGGTGGCCGCCGCCCTGCGCCGGCTGCACGATCTCGATCCGGCTGCCTGTCCCTTCGACCATCGCCTGGAACGGCGTCTGGACACCGTGCGCCAGCGGGTCGAGGCCGGGCTGGTGGACGAGGCGGACTTCGATGACGACCATCGCGGTCGCAGCGCCACGGAGCTGTACCGCCTGCTCCTCGACCGGCGTCCGGCGGTCGAAGACCTGGTGGTCGCCCACGGCGACGCCTGCCTGCCCAACCTCTTGGCGGAGGGGCGGCGCTTCAGCGGCTTCATCGATTGCGGGCGGCTCGGCGTCGCCGACCGGCACCAGGACCTGGCCCTGGCCGCGCGGGACATCGAGGCCGAACTCGGCGCGGCCTGGGCCGAGGCCTTCCTCGTCGAATACGGCGG
gb|DQ679961|+|114-975|ARO:3001021|TEM-155 [Proteus mirabilis] 	0	806	46	852	861	3478183-	806	ATGAGTATTCAACATTTCCGTGTCGCCCTTATTCCCTTTTTTGCGGCATTTTGCCTTCCTGTTTTTGCTCACCCAGAAACGCTGGTGAAAGTAAAAGATGCTGAAGATCAGTTGGGTGCACGAGTGGGTTACATCGAGCTGGATCTCAACAGCGGTAAGATCCTTGAGAGTTTTCGCCCCGAAGAACGTTTTCCAATGATGAGCACTTTTAAAGTTCTGCTATGTGGTGCGGTATTATCCCGTGTTGACGCCGGGCAAGAGCAACTCGGTCGCCGCATACACTATTCTCAGAATGACTTGGTTGAGTACTCACCAGTCACAGAAAAGCATCTTACGGATGGCATGACAGTAAGAGAATTATGCAGTGCTGCCATAACCATGAGTGATAACACTGCGGCCAACTTACTTCTGACAACGATCGGAGGACCGAAGGAGCTAACCGCTTTTTTGCACAACATGGGGGATCATGTAACCCGCCTTGATCGTTGGGAACCGGAGCTGAATGAAGCCATACCAAACGACGAGCGTGACACCACGATGCCTGCAGCAATGGCAACAACGTTGCGCAAACTATTAACTGGCGAACTACTTACTCTAGCTTCCCGGCAACAATTAATAGACTGGATGGAGGCGGATAAAGTTGCAGGACCACTTCTGCGCTCGGCCCTTCCGGCTGGCTGGTTTATTGCTGATAAATCTGGAGCCGGTGAGCGTGGATCTCGCGGTATCATTGCAGCACTGGGGCCAGATGGTAAGCCCTCCCGTATCGTAGTTATCTACACGACGGGGAGTCAGGCAACTATGGA
gb|AF347054|+|208-1069|ARO:3000947|TEM-80 [Enterobacter cloacae] 	0	806	46	852	861	3478183-	806	ATGAGTATTCAACATTTCCGTGTCGCCCTTATTCCCTTTTTTGCGGCATTTTGCCTTCCTGTTTTTGCTCACCCAGAAACGCTGGTGAAAGTAAAAGATGCTGAAGATCAGTTGGGTGCACGAGTGGGTTACATCGAGCTGGATCTCAACAGCGGTAAGATCCTTGAGAGTTTTCGCCCCGAAGAACGTTTTCCAATGATGAGCACTTTTAAAGTTCTGCTATGTGGTGCGGTATTATCCCGTGTTGACGCCGGGCAAGAGCAACTCGGTCGCCGCATACACTATTCTCAGAATGACTTGGTTGAGTACTCACCAGTCACAGAAAAGCATCTTACGGATGGCATGACAGTAAGAGAATTATGCAGTGCTGCCATAACCATGAGTGATAACACTGCGGCCAACTTACTTCTGACAACGATCGGAGGACCGAAGGAGCTAACCGCTTTTTTGCACAACATGGGGGATCATGTAACCCGCCTTGATCGTTGGGAACCGGAGCTGAATGAAGCCATACCAAACGACGAGCGTGACACCACGATGCCTGCAGCAATGGCAACAACGTTGCGCAAACTATTAACTGGCGAACTACTTACTCTAGCTTCCCGGCAACAATTAATAGACTGGATGGAGGCGGATAAAGTTGCAGGACCACTTCTGCGCTCGGCCCTTCCGGCTGGCTGGTTTATTGCTGATAAATCTGGAGCCGGTGAGCGTGGATCTCGCGGTATCATTGCAGCACTGGGGCCAGATGGTAAGCCCTCCCGTATCGTAGTTATCTACACGACGGGGAGTCAGGCAACTATGGA
gb|KJ584917.1|+|0-825|ARO:3001599|OXA-408 [Acinetobacter baumannii] 	0	770	54149	54919	825	246080-	770	ATGAACATTAAAGCACTCTTACTTATAACAAGCGCTATTTTTATTTCAGCCTGCTCACCTTATATAGTGACTGCTAATCCAAATCACAGCGCTTCAAAATCTGATGTAAAAGCAGAGAAAATTAAAAATTTATTTAACGAAGCACACACTACGGGTGTTTTAGTTATCCAACAAGGCCAAACTCAACAAAGCTATGGTAATGATCTTGCTCGTGCTTCGACCGAGTATGTACCTGCTTCGACCTTCAAAATGCTTAATGCTTTGATCGGCCTTGAGCACCATAAGGCAACCACCACAGAAGTATTTAAGTGGGATGGTAAAAAAAGGTTATTCCCAGAATGGGAAAAGGACATGACCCTAGGCGATGCCATGAAAGCTTCCGCTATTCCAGTTTATCAAGATTTAGCTCGTCGTATTGGACTTGAGCTCATGTCTAAGGAAGTGAAGCGTGTTGGTTATGGCAATGCAGATATCGGTACCCAAGTCGATAATTTTTGGCTGGTGGGTCCTTTAAAAATTACTCCTCAGCAAGAGGCACAGTTTGCTTACAAGCTAGCTAATAAAACGCTTCCATTTAGCCAAAAAGTCCAAGATGAAGTGCAATCCATGCTATTCATAGAAGAAAAGAATGGAAACAAAATATACGCAAAAAGTGGTTGGGGATGGGATGTAAACCCACAAGTAGGCTGGTTAACTGGATGGGTTGTTCAGCCTCAAGGGAATATTGTAGCGTTCTCCCTTAACTTAGAAATGAAAAAAGGAATACCTAG
gb|AM941159|+|208-1069|ARO:3001022|TEM-156 [Proteus mirabilis] 	0	806	46	852	861	3478183-	806	ATGAGTATTCAACATTTCCGTGTCGCCCTTATTCCCTTTTTTGCGGCATTTTGCCTTCCTGTTTTTGCTCACCCAGAAACGCTGGTGAAAGTAAAAGATGCTGAAGATCAGTTGGGTGCACGAGTGGGTTACATCGAGCTGGATCTCAACAGCGGTAAGATCCTTGAGAGTTTTCGCCCCGAAGAACGTTTTCCAATGATGAGCACTTTTAAAGTTCTGCTATGTGGTGCGGTATTATCCCGTGTTGACGCCGGGCAAGAGCAACTCGGTCGCCGCATACACTATTCTCAGAATGACTTGGTTGAGTACTCACCAGTCACAGAAAAGCATCTTACGGATGGCATGACAGTAAGAGAATTATGCAGTGCTGCCATAACCATGAGTGATAACACTGCGGCCAACTTACTTCTGACAACGATCGGAGGACCGAAGGAGCTAACCGCTTTTTTGCACAACATGGGGGATCATGTAACCCGCCTTGATCGTTGGGAACCGGAGCTGAATGAAGCCATACCAAACGACGAGCGTGACACCACGATGCCTGCAGCAATGGCAACAACGTTGCGCAAACTATTAACTGGCGAACTACTTACTCTAGCTTCCCGGCAACAATTAATAGACTGGATGGAGGCGGATAAAGTTGCAGGACCACTTCTGCGCTCGGCCCTTCCGGCTGGCTGGTTTATTGCTGATAAATCTGGAGCCGGTGAGCGTGGATCTCGCGGTATCATTGCAGCACTGGGGCCAGATGGTAAGCCCTCCCGTATCGTAGTTATCTACACGACGGGGAGTCAGGCAACTATGGA
gb|AB700703|+|161-1022|ARO:3001057|TEM-198 [Klebsiella pneumoniae] 	0	806	46	852	861	3478183-	806	ATGAGTATTCAACATTTCCGTGTCGCCCTTATTCCCTTTTTTGCGGCATTTTGCCTTCCTGTTTTTGCTCACCCAGAAACGCTGGTGAAAGTAAAAGATGCTGAAGATCAGTTGGGTGCACGAGTGGGTTACATCGAGCTGGATCTCAACAGCGGTAAGATCCTTGAGAGTTTTCGCCCCGAAGAACGTTTTCCAATGATGAGCACTTTTAAAGTTCTGCTATGTGGTGCGGTATTATCCCGTGTTGACGCCGGGCAAGAGCAACTCGGTCGCCGCATACACTATTCTCAGAATGACTTGGTTGAGTACTCACCAGTCACAGAAAAGCATCTTACGGATGGCATGACAGTAAGAGAATTATGCAGTGCTGCCATAACCATGAGTGATAACACTGCGGCCAACTTACTTCTGACAACGATCGGAGGACCGAAGGAGCTAACCGCTTTTTTGCACAACATGGGGGATCATGTAACCCGCCTTGATCGTTGGGAACCGGAGCTGAATGAAGCCATACCAAACGACGAGCGTGACACCACGATGCCTGCAGCAATGGCAACAACGTTGCGCAAACTATTAACTGGCGAACTACTTACTCTAGCTTCCCGGCAACAATTAATAGACTGGATGGAGGCGGATAAAGTTGCAGGACCACTTCTGCGCTCGGCCCTTCCGGCTGGCTGGTTTATTGCTGATAAATCTGGAGCCGGTGAGCGTGGATCTCGCGGTATCATTGCAGCACTGGGGCCAGATGGTAAGCCCTCCCGTATCGTAGTTATCTACACGACGGGGAGTCAGGCAACTATGGA
gb|AF427127|+|208-1069|ARO:3000948|TEM-81 [Escherichia coli] 	0	806	46	852	861	3478183-	806	ATGAGTATTCAACATTTCCGTGTCGCCCTTATTCCCTTTTTTGCGGCATTTTGCCTTCCTGTTTTTGCTCACCCAGAAACGCTGGTGAAAGTAAAAGATGCTGAAGATCAGTTGGGTGCACGAGTGGGTTACATCGAGCTGGATCTCAACAGCGGTAAGATCCTTGAGAGTTTTCGCCCCGAAGAACGTTTTCCAATGATGAGCACTTTTAAAGTTCTGCTATGTGGTGCGGTATTATCCCGTGTTGACGCCGGGCAAGAGCAACTCGGTCGCCGCATACACTATTCTCAGAATGACTTGGTTGAGTACTCACCAGTCACAGAAAAGCATCTTACGGATGGCATGACAGTAAGAGAATTATGCAGTGCTGCCATAACCATGAGTGATAACACTGCGGCCAACTTACTTCTGACAACGATCGGAGGACCGAAGGAGCTAACCGCTTTTTTGCACAACATGGGGGATCATGTAACCCGCCTTGATCGTTGGGAACCGGAGCTGAATGAAGCCATACCAAACGACGAGCGTGACACCACGATGCCTGCAGCAATGGCAACAACGTTGCGCAAACTATTAACTGGCGAACTACTTACTCTAGCTTCCCGGCAACAATTAATAGACTGGATGGAGGCGGATAAAGTTGCAGGACCACTTCTGCGCTCGGCCCTTCCGGCTGGCTGGTTTATTGCTGATAAATCTGGAGCCGGTGAGCGTGGATCTCGCGGTATCATTGCAGCACTGGGGCCAGATGGTAAGCCCTCCCGTATCGTAGTTATCTACACGACGGGGAGTCAGGCAACTATGGA
gb|AF427128|+|208-1069|ARO:3000949|TEM-82 [Escherichia coli] 	0	806	46	852	861	3478183-	806	ATGAGTATTCAACATTTCCGTGTCGCCCTTATTCCCTTTTTTGCGGCATTTTGCCTTCCTGTTTTTGCTCACCCAGAAACGCTGGTGAAAGTAAAAGATGCTGAAGATCAGTTGGGTGCACGAGTGGGTTACATCGAGCTGGATCTCAACAGCGGTAAGATCCTTGAGAGTTTTCGCCCCGAAGAACGTTTTCCAATGATGAGCACTTTTAAAGTTCTGCTATGTGGTGCGGTATTATCCCGTGTTGACGCCGGGCAAGAGCAACTCGGTCGCCGCATACACTATTCTCAGAATGACTTGGTTGAGTACTCACCAGTCACAGAAAAGCATCTTACGGATGGCATGACAGTAAGAGAATTATGCAGTGCTGCCATAACCATGAGTGATAACACTGCGGCCAACTTACTTCTGACAACGATCGGAGGACCGAAGGAGCTAACCGCTTTTTTGCACAACATGGGGGATCATGTAACCCGCCTTGATCGTTGGGAACCGGAGCTGAATGAAGCCATACCAAACGACGAGCGTGACACCACGATGCCTGCAGCAATGGCAACAACGTTGCGCAAACTATTAACTGGCGAACTACTTACTCTAGCTTCCCGGCAACAATTAATAGACTGGATGGAGGCGGATAAAGTTGCAGGACCACTTCTGCGCTCGGCCCTTCCGGCTGGCTGGTTTATTGCTGATAAATCTGGAGCCGGTGAGCGTGGATCTCGCGGTATCATTGCAGCACTGGGGCCAGATGGTAAGCCCTCCCGTATCGTAGTTATCTACACGACGGGGAGTCAGGCAACTATGGA
gb|EU024485|+|0-861|ARO:3001151|SHV-102 [Escherichia coli] 	0	806	16	822	861	1612535+	806	ATGCGTTATATTCGCCTGTGTATTATCACCCTGTGAGCCACCCTGCCGCTGGCGGTACACGCCAGCCCGCAGCCGCTTGAGCAAATTAAACAAAGCGAAAGCCAGCTGTCGGGCCGCGTAGGCATGATAGAAATGGATCTGGCCAGCGGCCGCACGCTGACCGCCTGGCGCGCCGATGAACGCTTTCCCATGATGAGCACCTTTAAAGTAGTGCTCTGCGGCGCAGTGCTGGCGCGGGTGGATGCCGGTGACGAACAGCTGGAGCGAAAGATCCACTATCGCCAGCAGGATCTGGTGGACTACTCGCCGGTCAGCGAAAAACACCTTGCCGACGGCATGACGGTCGGCGAACTCTGCGCCGCCGCCATTACCATGAGCGATAACAGCGCCGCCAATCTGCTGCTGGCCACCGTCGGCGGCCCCGCAGGATTGACTGCCTTTTTGCGCCAGATCGGCGACAACGTCACCCGCCTTGACCGCTGGGAAACGGAACTGAATGAGGCGCTTCCCGGCGACGCCCGCGACACCACTACCCCGGCCAGCATGGCCGCGACCCTGCGCAAGCTGCTGACCAGCCAGCGTCTGAGCGCCCGTTCGCAACGGCAGCTGCTGCAGTGGATGGTGGACGATCGGGTCGCCGGACCGTTGATCCGCTCCGTGCTGCCGGCGGGCTGGTTTATCGCCGATAAGACCGGAGCTAGCAAGCGGGGTGCGCGCGGGATTGTCGCCCTGCTTGGCCCGAATAACAAAGCAGAGCGCATTGTGGTGATTTATCTGCGGGATACGCCGGCGAGCATGGCCGAGCG
gb|DQ909059|+|0-861|ARO:3001023|TEM-157 [Enterobacter cloacae] 	0	806	46	852	861	3478183-	806	ATGAGTATTCAACATTTCCGTGTCGCCCTTATTCCCTTTTTTGCGGCATTTTGCCTTCCTGTTTTTGCTCACCCAGAAACGCTGGTGAAAGTAAAAGATGCTGAAGATCAGTTGGGTGCACGAGTGGGTTACATCGAGCTGGATCTCAACAGCGGTAAGATCCTTGAGAGTTTTCGCCCCGAAGAACGTTTTCCAATGATGAGCACTTTTAAAGTTCTGCTATGTGGTGCGGTATTATCCCGTGTTGACGCCGGGCAAGAGCAACTCGGTCGCCGCATACACTATTCTCAGAATGACTTGGTTGAGTACTCACCAGTCACAGAAAAGCATCTTACGGATGGCATGACAGTAAGAGAATTATGCAGTGCTGCCATAACCATGAGTGATAACACTGCGGCCAACTTACTTCTGACAACGATCGGAGGACCGAAGGAGCTAACCGCTTTTTTGCACAACATGGGGGATCATGTAACCCGCCTTGATCGTTGGGAACCGGAGCTGAATGAAGCCATACCAAACGACGAGCGTGACACCACGATGCCTGCAGCAATGGCAACAACGTTGCGCAAACTATTAACTGGCGAACTACTTACTCTAGCTTCCCGGCAACAATTAATAGACTGGATGGAGGCGGATAAAGTTGCAGGACCACTTCTGCGCTCGGCCCTTCCGGCTGGCTGGTTTATTGCTGATAAATCTGGAGCCGGTGAGCGTGGATCTCGCGGTATCATTGCAGCACTGGGGCCAGATGGTAAGCCCTCCCGTATCGTAGTTATCTACACGACGGGGAGTCAGGCAACTATGGA
gb|BX664015.1|-|103017-103833|ARO:3002641|APH(3')-Ia [Serratia marcescens] 	0	759	120	879	816	211757+	759	ATGAGCCATATTCAACGGGAAACGTCTTGCTCGAGGCCGCGATTAAATTCCAACCTGGATGCTGATTTATATGGGTATAGATGGGCTCGCGATAATGTCGGGCAATCAGGTGCGACAATCTATCGATTGTATGGGAAGCCCGATGCGCCAGAGTTGTTTCTGAAACATGGCAAAGGTAGCGTTGCCAATGATGTTACAGATGAGATGGTCAGACTAAACTGGCTGACGGCATTTATGCCTCTTCCGACCATCAAGCATTTTATCCGTACTCCTGATGATGCATGGTTACTCACCACTGCGATCCCCGGGAAAACAGCATTCCAGGTATTAGAAGAATATCCTGATTCAGGTGAAAATATTGTTGATGCGCTGGCAGTGTTCCTGCGCCGGTTGCATTCGATTCCTGTTTGTAATTGTCCTTTTAACAGCGATCGCGTATTTCGTCTCGCTCAGGCGCAATCACGAATGAATAACGGTTTGGTTGATGCTAGTGATTTTGATGACGAGCGTAATGGCTGGCCTGTTGAACAAGTCTGGAAAGAAATGCATAAGCTTTTGCCATTCTCACCGGATTCAGTCGTCACTCATGGTGATTTCTCACTTGATAACCTTATTTTTGACGAGGGGAAATTAATAGGTTGTATTGATGTTGGACGAGTCGGAATCGCAGACCGATACCAGGATCTTGCCATCCTATGGAACTGCCTCGGTGAGTTTTCTCCTTCATTACAGAAACGGCTTTTTCAAAAATATGGTATT
gb|KJ584918.1|+|0-828|ARO:3001600|OXA-409 [Acinetobacter baumannii] 	0	773	54149	54919	828	246080-	770	ATGAACATTAAAGCACTCTTACTTATAACAAGCGCTATTTTTATTTCAGCCTGCTCACCTTATATAGTGACTGCTAATCCAAATCACAGCGCTTCAAAATCTGATGTAAAAGCAGAGAAAATTAAAAATTTATTTAACGAAGCACACACTACGGGTGTTTTAGTTATCCAACAAGGCCAAACTCAACAAAGCTATGGTAATGATCTTGCTCGTGCTTCGACCGAGTATGTACCTGCTTCGACCTTCAAAATGCTTAATGCTTTGATCGGCCTTGAGCACCATAAGGCAACCACCACAGAAGTATTTAAGTGGGATGGTAAAAAAAGGTTATTCCCAGAATGGGAAAAGGACATGACCCTAGGCGATGCCATGAAAGCTTCCGCTATTCCAGTTTATCAAGATTTAGCTCGTCGTATTGGACTTGAGCTCATGTCTAAGGAAGTGAAGCGTGTTGGTTATGGCAATGCAGATATCGGTACCCAAGTCGATAATTTTTGGCTGGTGGGTCCTTTAAAAATTACTCCTCAGCAAGAGGCACAGTTTGCTTACAAGCTAGCTAATAAAACGCTTCCATTTAGCCAAAAAGTCCAAGATGAAGTGCAATCCATGCTATTCATAGAAGAAAAGAATGGAAACAAAATATACGCAAAAAGTGGTTGGGGATGGGATGTAAACCCACAAGTAGGCTGGTTAACTGGATGGGTTGTTCAGCCTCAAGGGAATATTGTAGCGTTCTCCCTTAACTTAGAAATGAAAAAAGGAATACCTAG
gb|AF427129|+|208-1069|ARO:3000950|TEM-83 [Escherichia coli] 	0	806	46	852	861	3478183-	806	ATGAGTATTCAACATTTCCGTGTCGCCCTTATTCCCTTTTTTGCGGCATTTTGCCTTCCTGTTTTTGCTCACCCAGAAACGCTGGTGAAAGTAAAAGATGCTGAAGATCAGTTGGGTGCACGAGTGGGTTACATCGAGCTGGATCTCAACAGCGGTAAGATCCTTGAGAGTTTTCGCCCCGAAGAACGTTTTCCAATGATGAGCACTTTTAAAGTTCTGCTATGTGGTGCGGTATTATCCCGTGTTGACGCCGGGCAAGAGCAACTCGGTCGCCGCATACACTATTCTCAGAATGACTTGGTTGAGTACTCACCAGTCACAGAAAAGCATCTTACGGATGGCATGACAGTAAGAGAATTATGCAGTGCTGCCATAACCATGAGTGATAACACTGCGGCCAACTTACTTCTGACAACGATCGGAGGACCGAAGGAGCTAACCGCTTTTTTGCACAACATGGGGGATCATGTAACCCGCCTTGATCGTTGGGAACCGGAGCTGAATGAAGCCATACCAAACGACGAGCGTGACACCACGATGCCTGCAGCAATGGCAACAACGTTGCGCAAACTATTAACTGGCGAACTACTTACTCTAGCTTCCCGGCAACAATTAATAGACTGGATGGAGGCGGATAAAGTTGCAGGACCACTTCTGCGCTCGGCCCTTCCGGCTGGCTGGTTTATTGCTGATAAATCTGGAGCCGGTGAGCGTGGATCTCGCGGTATCATTGCAGCACTGGGGCCAGATGGTAAGCCCTCCCGTATCGTAGTTATCTACACGACGGGGAGTCAGGCAACTATGGA
gb|AF427130|+|208-1069|ARO:3000951|TEM-84 [Escherichia coli] 	0	806	46	852	861	3478183-	806	ATGAGTATTCAACATTTCCGTGTCGCCCTTATTCCCTTTTTTGCGGCATTTTGCCTTCCTGTTTTTGCTCACCCAGAAACGCTGGTGAAAGTAAAAGATGCTGAAGATCAGTTGGGTGCACGAGTGGGTTACATCGAGCTGGATCTCAACAGCGGTAAGATCCTTGAGAGTTTTCGCCCCGAAGAACGTTTTCCAATGATGAGCACTTTTAAAGTTCTGCTATGTGGTGCGGTATTATCCCGTGTTGACGCCGGGCAAGAGCAACTCGGTCGCCGCATACACTATTCTCAGAATGACTTGGTTGAGTACTCACCAGTCACAGAAAAGCATCTTACGGATGGCATGACAGTAAGAGAATTATGCAGTGCTGCCATAACCATGAGTGATAACACTGCGGCCAACTTACTTCTGACAACGATCGGAGGACCGAAGGAGCTAACCGCTTTTTTGCACAACATGGGGGATCATGTAACCCGCCTTGATCGTTGGGAACCGGAGCTGAATGAAGCCATACCAAACGACGAGCGTGACACCACGATGCCTGCAGCAATGGCAACAACGTTGCGCAAACTATTAACTGGCGAACTACTTACTCTAGCTTCCCGGCAACAATTAATAGACTGGATGGAGGCGGATAAAGTTGCAGGACCACTTCTGCGCTCGGCCCTTCCGGCTGGCTGGTTTATTGCTGATAAATCTGGAGCCGGTGAGCGTGGATCTCGCGGTATCATTGCAGCACTGGGGCCAGATGGTAAGCCCTCCCGTATCGTAGTTATCTACACGACGGGGAGTCAGGCAACTATGGA
gb|M90056.1|+|908-2477|ARO:3002829|vgaA [Staphylococcus aureus] 	331	1376	0	1045	1569	240808+	1045	ATAATAACTATATAGAAAAATTAGAACAGGATTTAAAAAATTGGCATGGAGCATTTATTATAGTTTCACATGATCGCGCTTTTTTAGATAACTTATGTACTACTATATGGGAAATTGACGAGGGGAGAATAACTGAATATAAGGGGAATTATAGTAACTATGTTGAACAAAAAGAATTAGAAAGACATCGAGAAGAATTAGAATATGAAAAATATGAAAAAGAAAAGAAACGATTGGAAAAAGCTATAAATATAAAAGAACAGAAAGCTCAACGAGCAACTAAAAAACCGAAAAACTTAAGTTCATCTGAAGGCAAAATAAAAGTAACAAAGCCATACTTTGCAAGTAAGCAAAAGAAGTTACGAAAAACTGTAAAATCTCTAGAAACCAGACTAGAAAAACTTGAAAGGGTCGAAAAGAGAAACGAACTTCCTCCAGTTAAAATGGATTTAGTGAACTTAAAAAGTGTAAAAAATAGAACTATAATACGTGGTGAAGATGTCTCGGGTACAATTGAAGGACGGGTATTGTGGAAAGCAAAAAGTTTTAGTATTCGCGGAGGAGACAAGATGGCAATTATCGGATCTAATGGTACAGGAAAGACAACGTTTATTAAAAAAATTGTGCATGGGAATCCTGGTATTTCGTTATCGCCATCTGTCAAAATCGGTTATTTTAGCCAAAAAATAGATACATTAGAATTAGATAAGAGTATTTTAGAAAATGTTCAATCTTCTTCACAACAAAATGAAACTCTTATTCGAACTATTCTAGCTAGAATGCATTTTTTTAGAGATGATGTTTATAAACCAATAAGTGTCTTAAGTGGTGGAGAGCGAGTTAAAGTAGCACTAACTAAAGTATTCTTAAGTGAAGTTAATACGTTGGTACTAGATGAACCAACAAACTTTCTTGATATGGAAGCTATAGAGGCGTTTGAATCTTTGTTAAAGGAATATAATGGCAGTATAATCTTTGTATCTCACGATCGTAAATTTATCGAAAAAGTAGCCACTCGAATAATGACAATTGATAATAAAGAAAT
gb|JX050178|+|0-853|ARO:3001058|TEM-199 [Proteus mirabilis] Partial	0	798	54	852	853	3478183-	798	TCAACATTTCCGTGTCGCCCTTATTCCCTTTTTTGCGGCATTTTGCCTTCCTGTTTTTGCTCACCCAGAAACGCTGGTGAAAGTAAAAGATGCTGAAGATCAGTTGGGTGCACGAGTGGGTTACATCGAGCTGGATCTCAACAGCGGTAAGATCCTTGAGAGTTTTCGCCCCGAAGAACGTTTTCCAATGATGAGCACTTTTAAAGTTCTGCTATGTGGTGCGGTATTATCCCGTGTTGACGCCGGGCAAGAGCAACTCGGTCGCCGCATACACTATTCTCAGAATGACTTGGTTGAGTACTCACCAGTCACAGAAAAGCATCTTACGGATGGCATGACAGTAAGAGAATTATGCAGTGCTGCCATAACCATGAGTGATAACACTGCGGCCAACTTACTTCTGACAACGATCGGAGGACCGAAGGAGCTAACCGCTTTTTTGCACAACATGGGGGATCATGTAACCCGCCTTGATCGTTGGGAACCGGAGCTGAATGAAGCCATACCAAACGACGAGCGTGACACCACGATGCCTGCAGCAATGGCAACAACGTTGCGCAAACTATTAACTGGCGAACTACTTACTCTAGCTTCCCGGCAACAATTAATAGACTGGATGGAGGCGGATAAAGTTGCAGGACCACTTCTGCGCTCGGCCCTTCCGGCTGGCTGGTTTATTGCTGATAAATCTGGAGCCGGTGAGCGTGGATCTCGCGGTATCATTGCAGCACTGGGGCCAGATGGTAAGCCCTCCCGTATCGTAGTTATCTACACGACGGGGAGTCAGGCAACTATGGA
gb|AJ277414|+|0-861|ARO:3000952|TEM-85 [Klebsiella pneumoniae] 	0	806	46	852	861	3478183-	806	ATGAGTATTCAACATTTCCGTGTCGCCCTTATTCCCTTTTTTGCGGCATTTTGCCTTCCTGTTTTTGCTCACCCAGAAACGCTGGTGAAAGTAAAAGATGCTGAAGATCAGTTGGGTGCACGAGTGGGTTACATCGAGCTGGATCTCAACAGCGGTAAGATCCTTGAGAGTTTTCGCCCCGAAGAACGTTTTCCAATGATGAGCACTTTTAAAGTTCTGCTATGTGGTGCGGTATTATCCCGTGTTGACGCCGGGCAAGAGCAACTCGGTCGCCGCATACACTATTCTCAGAATGACTTGGTTGAGTACTCACCAGTCACAGAAAAGCATCTTACGGATGGCATGACAGTAAGAGAATTATGCAGTGCTGCCATAACCATGAGTGATAACACTGCGGCCAACTTACTTCTGACAACGATCGGAGGACCGAAGGAGCTAACCGCTTTTTTGCACAACATGGGGGATCATGTAACCCGCCTTGATCGTTGGGAACCGGAGCTGAATGAAGCCATACCAAACGACGAGCGTGACACCACGATGCCTGCAGCAATGGCAACAACGTTGCGCAAACTATTAACTGGCGAACTACTTACTCTAGCTTCCCGGCAACAATTAATAGACTGGATGGAGGCGGATAAAGTTGCAGGACCACTTCTGCGCTCGGCCCTTCCGGCTGGCTGGTTTATTGCTGATAAATCTGGAGCCGGTGAGCGTGGATCTCGCGGTATCATTGCAGCACTGGGGCCAGATGGTAAGCCCTCCCGTATCGTAGTTATCTACACGACGGGGAGTCAGGCAACTATGGA
gb|X54606|+|214-1075|ARO:3000874|TEM-2 [Pseudomonas aeruginosa] 	0	806	46	852	861	3478183-	806	ATGAGTATTCAACATTTCCGTGTCGCCCTTATTCCCTTTTTTGCGGCATTTTGCCTTCCTGTTTTTGCTCACCCAGAAACGCTGGTGAAAGTAAAAGATGCTGAAGATCAGTTGGGTGCACGAGTGGGTTACATCGAGCTGGATCTCAACAGCGGTAAGATCCTTGAGAGTTTTCGCCCCGAAGAACGTTTTCCAATGATGAGCACTTTTAAAGTTCTGCTATGTGGTGCGGTATTATCCCGTGTTGACGCCGGGCAAGAGCAACTCGGTCGCCGCATACACTATTCTCAGAATGACTTGGTTGAGTACTCACCAGTCACAGAAAAGCATCTTACGGATGGCATGACAGTAAGAGAATTATGCAGTGCTGCCATAACCATGAGTGATAACACTGCGGCCAACTTACTTCTGACAACGATCGGAGGACCGAAGGAGCTAACCGCTTTTTTGCACAACATGGGGGATCATGTAACCCGCCTTGATCGTTGGGAACCGGAGCTGAATGAAGCCATACCAAACGACGAGCGTGACACCACGATGCCTGCAGCAATGGCAACAACGTTGCGCAAACTATTAACTGGCGAACTACTTACTCTAGCTTCCCGGCAACAATTAATAGACTGGATGGAGGCGGATAAAGTTGCAGGACCACTTCTGCGCTCGGCCCTTCCGGCTGGCTGGTTTATTGCTGATAAATCTGGAGCCGGTGAGCGTGGATCTCGCGGTATCATTGCAGCACTGGGGCCAGATGGTAAGCCCTCCCGTATCGTAGTTATCTACACGACGGGGAGTCAGGCAACTATGGA
gb|AF313472|+|15593-16397|ARO:3002639|APH(3'')-Ib [Pseudomonas aeruginosa] 	0	749	10	759	804	114596+	749	TTGAATCGAACTAATATTTTTTTTGGTGAATCGCATTCTGACTGGTTGCCTGTCAGAGGCGGAGAATCTGGTGATTTTGTTTTTCGACGTGGTGACGGGCATGCCTTCGCGAAAATCGCACCTGCTTCCCGCCGCGGTGAGCTCGCTGGAGAGCGTGACCGCCTCATTTGGCTCAAAGGTCGAGGTGTGGCTTGCCCCGAGGTGATCAACTGGCAGGAGGAACAGGAGGGTGCATGCTTGGTGATAACGGCAATTCCGGGAGTACCGGCGGCTGATCTGTCTGGAGCGGATTTGCTCAAAGCGTGGCCGTCAATGGGGCAGCAACTTGGCGCTGTTCACAGCCTATCGGTTGATCAATGTCCGTTTGAGCGCAGGCTGTCGCGAATGTTCGGACGCGCCGTTGATGTGGTGTCCCGCAATGCCGTCAATCCCGACTTCTTACCGGACGAGGACAAGAGTACGCCGCAGCTCGATCTTTTGGCTCGTGTCGAACGAGAGCTACCGGTGCGGCTCGACCAAGAGCGCACCGATATGGTTGTTTGCCATGGTGATCCCTGCATGCCGAACTTCATGGTGGACCCTAAAACTCTTCAATGCACGGGTCTGATCGACCTTGGGCGGCTCGGAACAGCAGATCGCTATGCCGATTTGGCACTCATGATTGCTAACGCCGAAGAGAACTGGGCAGCGCCAGATGAAGCAGAGCGCGCCTTCGCTGTCCTATTCAATGTATTGGGGATCGAAGCCCC
gb|EF534736|+|213-1074|ARO:3001024|TEM-158 [Escherichia coli] 	0	806	46	852	861	3478183-	806	ATGAGTATTCAACATTTCCGTGTCGCCCTTATTCCCTTTTTTGCGGCATTTTGCCTTCCTGTTTTTGCTCACCCAGAAACGCTGGTGAAAGTAAAAGATGCTGAAGATCAGTTGGGTGCACGAGTGGGTTACATCGAGCTGGATCTCAACAGCGGTAAGATCCTTGAGAGTTTTCGCCCCGAAGAACGTTTTCCAATGATGAGCACTTTTAAAGTTCTGCTATGTGGTGCGGTATTATCCCGTGTTGACGCCGGGCAAGAGCAACTCGGTCGCCGCATACACTATTCTCAGAATGACTTGGTTGAGTACTCACCAGTCACAGAAAAGCATCTTACGGATGGCATGACAGTAAGAGAATTATGCAGTGCTGCCATAACCATGAGTGATAACACTGCGGCCAACTTACTTCTGACAACGATCGGAGGACCGAAGGAGCTAACCGCTTTTTTGCACAACATGGGGGATCATGTAACCCGCCTTGATCGTTGGGAACCGGAGCTGAATGAAGCCATACCAAACGACGAGCGTGACACCACGATGCCTGCAGCAATGGCAACAACGTTGCGCAAACTATTAACTGGCGAACTACTTACTCTAGCTTCCCGGCAACAATTAATAGACTGGATGGAGGCGGATAAAGTTGCAGGACCACTTCTGCGCTCGGCCCTTCCGGCTGGCTGGTTTATTGCTGATAAATCTGGAGCCGGTGAGCGTGGATCTCGCGGTATCATTGCAGCACTGGGGCCAGATGGTAAGCCCTCCCGTATCGTAGTTATCTACACGACGGGGAGTCAGGCAACTATGGA
gb|EU032604|+|0-861|ARO:3001152|SHV-103 [Klebsiella pneumoniae] 	0	806	16	822	861	1612535+	806	ATGCGTTATATTCGCCTGTGTATTATCACCCTGTGAGCCACCCTGCCGCTGGCGGTACACGCCAGCCCGCAGCCGCTTGAGCAAATTAAACAAAGCGAAAGCCAGCTGTCGGGCCGCGTAGGCATGATAGAAATGGATCTGGCCAGCGGCCGCACGCTGACCGCCTGGCGCGCCGATGAACGCTTTCCCATGATGAGCACCTTTAAAGTAGTGCTCTGCGGCGCAGTGCTGGCGCGGGTGGATGCCGGTGACGAACAGCTGGAGCGAAAGATCCACTATCGCCAGCAGGATCTGGTGGACTACTCGCCGGTCAGCGAAAAACACCTTGCCGACGGCATGACGGTCGGCGAACTCTGCGCCGCCGCCATTACCATGAGCGATAACAGCGCCGCCAATCTGCTGCTGGCCACCGTCGGCGGCCCCGCAGGATTGACTGCCTTTTTGCGCCAGATCGGCGACAACGTCACCCGCCTTGACCGCTGGGAAACGGAACTGAATGAGGCGCTTCCCGGCGACGCCCGCGACACCACTACCCCGGCCAGCATGGCCGCGACCCTGCGCAAGCTGCTGACCAGCCAGCGTCTGAGCGCCCGTTCGCAACGGCAGCTGCTGCAGTGGATGGTGGACGATCGGGTCGCCGGACCGTTGATCCGCTCCGTGCTGCCGGCGGGCTGGTTTATCGCCGATAAGACCGGAGCTAGCAAGCGGGGTGCGCGCGGGATTGTCGCCCTGCTTGGCCCGAATAACAAAGCAGAGCGCATTGTGGTGATTTATCTGCGGGATACGCCGGCGAGCATGGCCGAGCG
gb|AJ277415|+|0-861|ARO:3000953|TEM-86 [Klebsiella pneumoniae] 	0	806	46	852	861	3478183-	806	ATGAGTATTCAACATTTCCGTGTCGCCCTTATTCCCTTTTTTGCGGCATTTTGCCTTCCTGTTTTTGCTCACCCAGAAACGCTGGTGAAAGTAAAAGATGCTGAAGATCAGTTGGGTGCACGAGTGGGTTACATCGAGCTGGATCTCAACAGCGGTAAGATCCTTGAGAGTTTTCGCCCCGAAGAACGTTTTCCAATGATGAGCACTTTTAAAGTTCTGCTATGTGGTGCGGTATTATCCCGTGTTGACGCCGGGCAAGAGCAACTCGGTCGCCGCATACACTATTCTCAGAATGACTTGGTTGAGTACTCACCAGTCACAGAAAAGCATCTTACGGATGGCATGACAGTAAGAGAATTATGCAGTGCTGCCATAACCATGAGTGATAACACTGCGGCCAACTTACTTCTGACAACGATCGGAGGACCGAAGGAGCTAACCGCTTTTTTGCACAACATGGGGGATCATGTAACCCGCCTTGATCGTTGGGAACCGGAGCTGAATGAAGCCATACCAAACGACGAGCGTGACACCACGATGCCTGCAGCAATGGCAACAACGTTGCGCAAACTATTAACTGGCGAACTACTTACTCTAGCTTCCCGGCAACAATTAATAGACTGGATGGAGGCGGATAAAGTTGCAGGACCACTTCTGCGCTCGGCCCTTCCGGCTGGCTGGTTTATTGCTGATAAATCTGGAGCCGGTGAGCGTGGATCTCGCGGTATCATTGCAGCACTGGGGCCAGATGGTAAGCCCTCCCGTATCGTAGTTATCTACACGACGGGGAGTCAGGCAACTATGGA
gb|JQ340365|+|0-1434|ARO:3003583|basS [Pseudomonas aeruginosa] 	10	1379	8468	9837	1434	239113+	1369	CCGCCGTCCCCTCCGTCCGCCGGCGCCTGCTGGTCAACCTGCTGGTCGGCTTCGTGCTGTGCTGGCTGAGCGTGGCGGCGCTGACCTACCACCTCTCGCTGAAGCAGGTGAACCGACTGTTCGACGACGACATGGTGGACTTCGGCGAAGCCGCCCTGCGCCTGCTCGACCTTGCCACCGAAGACCAGGCCAGCGAGGACGGCTCGATCACCGAGATCATCGAACGCAGCCGCGAGGCGATCCAGGGCCTGCCCCTGCTGCGCCGCGAAAGCGCCCTCGGCTACGCCCTGTGGCGCGACGGCCAGCCGCTGCTGTCGAGCCTCAACCTGCCGCCGGAGATCACGGCCCAGGGCCCCGGCTTCAGCACCGTGGAAGCCCAGGGCACCCACTGGCGGGTGCTCCAGCTGAACATCGACGGCTTCCAGATCTGGATCAGCGAAAACCTGATCTACCGCCAGCACACCATGAACCTGCTGCTGTTCTATTCGCTGTTCCCGCTGCTGCTGGCGCTGCCGTTGCTCGGCGGCCTGGTCTGGTTCGGCGTTGCCCGCGGCCTGGCGCCGCTACGCGAAGTGCAGGCCGAGGTCCAGCAGCGCTCCGCGCGACACCTGCAGCCGATCGCGGTGGAGGCGGTGCCGCTGGAGATCCGCGGCCTCATCGACGAACTCAACCTCCTGCTCGAGCGCCTGCGCACCGCCCTCGAGGCCGAACGCCGACTGACCAGCGACGCCGCCCATGAGATCCGCACGCCGCTGGCCAGCCTGCGCACCCATGCCCAGGTCGCGCTGCGTTCGGAAGACCCCAAGGCCCACGCCCGCGGCCTGCTGCAAGTCAGTCGCAGCGTCGAGCGGATCAGCACCTTGATGGAGCAGATCCTGCTTCTCGCCCGCCTCGACGGCGACGCCCTGCTGGAGCAATTCCACCCGGTCAACCTCGCCACCCTGGCCGAAGACGTACTCTCCGAACTGGCGCGCCAGGCCATCGACAAGGACATCGAGCTGTCGTTGCACCAGGAGACCGTGCACGTGATGGGCATCGACCTGTGGCTGAAGGCGATGGTCGGCAACCTGGTGAGCAACGCCCTGCGCTACACGCCGGCCGGGGGCCAGGTCGAGATCCGCGTCGAGAATCGCGCCCAGCACGCCGTGCTGCGGGTGCGCGACAACGGCCCCGGGGTCGCCCTGGAAGAGCAGCAGGCGATCTTCACCCGCTTCTACCGCAGCCCCGCCACCAGCAGCGGCGAGGGCAGCGGCCTGGGCCTGCCGATCGTCAAGCGCATCGTCGAACTGCACTTCGGCAGTATCGGCCTGGGCAAGGGACTGGAGGGCAAAGGGCTGGAAGTACAGGTGTTCCTGCCGAAGACCCAGCC
gb|KJ584920.1|+|0-825|ARO:3001602|OXA-411 [Acinetobacter baumannii] 	0	770	54149	54919	825	246080-	770	ATGAACATTAAAGCACTCTTACTTATAACAAGCGCTATTTTTATTTCAGCCTGCTCACCTTATATAGTGACTGCTAATCCAAATCACAGCGCTTCAAAATCTGATGTAAAAGCAGAGAAAATTAAAAATTTATTTAACGAAGCACACACTACGGGTGTTTTAGTTATCCAACAAGGCCAAACTCAACAAAGCTATGGTAATGATCTTGCTCGTGCTTCGACCGAGTATGTACCTGCTTCGACCTTCAAAATGCTTAATGCTTTGATCGGCCTTGAGCACCATAAGGCAACCACCACAGAAGTATTTAAGTGGGATGGTAAAAAAAGGTTATTCCCAGAATGGGAAAAGGACATGACCCTAGGCGATGCCATGAAAGCTTCCGCTATTCCAGTTTATCAAGATTTAGCTCGTCGTATTGGACTTGAGCTCATGTCTAAGGAAGTGAAGCGTGTTGGTTATGGCAATGCAGATATCGGTACCCAAGTCGATAATTTTTGGCTGGTGGGTCCTTTAAAAATTACTCCTCAGCAAGAGGCACAGTTTGCTTACAAGCTAGCTAATAAAACGCTTCCATTTAGCCAAAAAGTCCAAGATGAAGTGCAATCCATGCTATTCATAGAAGAAAAGAATGGAAACAAAATATACGCAAAAAGTGGTTGGGGATGGGATGTAAACCCACAAGTAGGCTGGTTAACTGGATGGGTTGTTCAGCCTCAAGGGAATATTGTAGCGTTCTCCCTTAACTTAGAAATGAAAAAAGGAATACCTAG
gb|V01499|+|230-1256|ARO:3002655|APH(4)-Ia [Escherichia coli] 	0	971	1046	2017	1026	53827366-	971	ATGAAAAAGCCTGAACTCACCGCGACGTCTGTCGAGAAGTTTCTGATCGAAAAGTTCGACAGCGTCTCCGACCTGATGCAGCTCTCGGAGGGCGAAGAATCTCGTGCTTTCAGCTTCGATGTAGGAGGGCGTGGATATGTCCTGCGGGTAAATAGCTGCGCCGATGGTTTCTACAAAGATCGTTATGTTTATCGGCACTTTGCATCGGCCGCGCTCCCGATTCCGGAAGTGCTTGACATTGGGGAATTCAGCGAGAGCCTGACCTATTGCATCTCCCGCCGTGCACAGGGTGTCACGTTGCAAGACCTGCCTGAAACCGAACTGCCCGCTGTTCTGCAGCCGGTCGCGGAGGCCATGGATGCGATCGCTGCGGCCGATCTTAGCCAGACGAGCGGGTTCGGCCCATTCGGACCGCAAGGAATCGGTCAATACACTACATGGCGTGATTTCATATGCGCGATTGCTGATCCCCATGTGTATCACTGGCAAACTGTGATGGACGACACCGTCAGTGCGTCCGTCGCGCAGGCTCTCGATGAGCTGATGCTTTGGGCCGAGGACTGCCCCGAAGTCCGGCACCTCGTGCACGCGGATTTCGGCTCCAACAATGTCCTGACGGACAATGGCCGCATAACAGCGGTCATTGACTGGAGCGAGGCGATGTTCGGGGATTCCCAATACGAGGTCGCCAACATCTTCTTCTGGAGGCCGTGGTTGGCTTGTATGGAGCAGCAGACGCGCTACTTCGAGCGGAGGCATCCGGAGCTTGCAGGATCGCCGCGGCTCCGGGCGTATATGCTCCGCATTGGTCTTGACCAACTCTATCAGAGCTTGGTTGACGGCAATTTCGATGATGCAGCTTGGGCGCAGGGTCGATGCGACGCAATCGTCCGATCCGGAGCCGGGACTGTCGGGCGTACACAAATCGCCCGCAGAAGCGCGGCCGTCTGGACCGATGGCTGTGTAGAAGT
gb|Y17581|+|78-936|ARO:3000891|TEM-20 [Klebsiella pneumoniae] 	0	803	46	849	858	3478183-	803	ATGAGTATTCAACATTTCCGTGTCGCCCTTATTCCCTTTTTTGCGGCATTTTGCCTTCCTGTTTTTGCTCACCCAGAAACGCTGGTGAAAGTAAAAGATGCTGAAGATCAGTTGGGTGCACGAGTGGGTTACATCGAGCTGGATCTCAACAGCGGTAAGATCCTTGAGAGTTTTCGCCCCGAAGAACGTTTTCCAATGATGAGCACTTTTAAAGTTCTGCTATGTGGTGCGGTATTATCCCGTGTTGACGCCGGGCAAGAGCAACTCGGTCGCCGCATACACTATTCTCAGAATGACTTGGTTGAGTACTCACCAGTCACAGAAAAGCATCTTACGGATGGCATGACAGTAAGAGAATTATGCAGTGCTGCCATAACCATGAGTGATAACACTGCGGCCAACTTACTTCTGACAACGATCGGAGGACCGAAGGAGCTAACCGCTTTTTTGCACAACATGGGGGATCATGTAACCCGCCTTGATCGTTGGGAACCGGAGCTGAATGAAGCCATACCAAACGACGAGCGTGACACCACGATGCCTGCAGCAATGGCAACAACGTTGCGCAAACTATTAACTGGCGAACTACTTACTCTAGCTTCCCGGCAACAATTAATAGACTGGATGGAGGCGGATAAAGTTGCAGGACCACTTCTGCGCTCGGCCCTTCCGGCTGGCTGGTTTATTGCTGATAAATCTGGAGCCGGTGAGCGTGGATCTCGCGGTATCATTGCAGCACTGGGGCCAGATGGTAAGCCCTCCCGTATCGTAGTTATCTACACGACGGGGAGTCAGGCAACTAT
gb|AY123251.1|+|811-1444|ARO:3002680|catB8 [Salmonella enterica subsp. enterica serovar Typhi] 	0	578	724	1302	633	104606+	578	ATGAAAAACTACTTTAACAGCCCTTTCAAAGGGGAACTTCTTTCTGAGCAAGTGAAAAATCCAAATATCAGAGTAGGCCGGTATAGCTATTACTCTGGCTACTATCACGGGCACTCATTTGATGAATGCGCGCGATACTTGCTTCCAGATCGTGATGACGTTGATAAATTGATCATTGGCAGCTTTTGTTCTATAGGAAGCGGGGCTTCCTTCATCATGGCTGGCAATCAGGGGCATCGGCATGACTGGGCATCATCCTTCCCCTTCTTCTATATGCAAGAGGAGCCTGCTTTCTCAAGAGCACTCGACGCCTTCCAAAGAGCAGGTGATACCGTCATTGGCAATGATGTCTGGATAGGCTCGGAGGCAATGATTATGCCTGGCATCAAAATTGGAGACGGTGCCGTGATAGGTAGTCGCTCGTTGGTGACAAAAGATGTAGAGCCTTATGCCATCATCGGGGGAAATCCCGCAAAGCAAATTAAGAAGCGCTTCTCCGATGAGGAAATCTCATTGCTCATGGAGATGGAGTGGTGGAACTGGCCACTAGATAAAATTAAGACAGCAATGCCTCTGCT
gb|EU274581|+|0-861|ARO:3001153|SHV-104 [Klebsiella pneumoniae] 	1	806	17	822	861	1612535+	805	TGCGTTATATTCGCCTGTGTATTATCACCCTGTGAGCCACCCTGCCGCTGGCGGTACACGCCAGCCCGCAGCCGCTTGAGCAAATTAAACAAAGCGAAAGCCAGCTGTCGGGCCGCGTAGGCATGATAGAAATGGATCTGGCCAGCGGCCGCACGCTGACCGCCTGGCGCGCCGATGAACGCTTTCCCATGATGAGCACCTTTAAAGTAGTGCTCTGCGGCGCAGTGCTGGCGCGGGTGGATGCCGGTGACGAACAGCTGGAGCGAAAGATCCACTATCGCCAGCAGGATCTGGTGGACTACTCGCCGGTCAGCGAAAAACACCTTGCCGACGGCATGACGGTCGGCGAACTCTGCGCCGCCGCCATTACCATGAGCGATAACAGCGCCGCCAATCTGCTGCTGGCCACCGTCGGCGGCCCCGCAGGATTGACTGCCTTTTTGCGCCAGATCGGCGACAACGTCACCCGCCTTGACCGCTGGGAAACGGAACTGAATGAGGCGCTTCCCGGCGACGCCCGCGACACCACTACCCCGGCCAGCATGGCCGCGACCCTGCGCAAGCTGCTGACCAGCCAGCGTCTGAGCGCCCGTTCGCAACGGCAGCTGCTGCAGTGGATGGTGGACGATCGGGTCGCCGGACCGTTGATCCGCTCCGTGCTGCCGGCGGGCTGGTTTATCGCCGATAAGACCGGAGCTAGCAAGCGGGGTGCGCGCGGGATTGTCGCCCTGCTTGGCCCGAATAACAAAGCAGAGCGCATTGTGGTGATTTATCTGCGGGATACGCCGGCGAGCATGGCCGAGCG
gb|AF024602|+|3155-3992|ARO:3002660|APH(6)-Id [Pseudomonas aeruginosa] 	0	782	813	1595	837	114596+	782	ATGTTCATGCCGCCTGTTTTTCCTGCTCATTGGCACGTTTCGCAACCTGTTCTCATTGCGGACACCTTTTCCAGCCTCGTTTGGAAAGTTTCATTGCCAGACGGGACTCCTGCAATCGTCAAGGGATTGAAACCTATAGAAGACATTGCTGATGAACTGCGCGGGGCCGACTATCTGGTATGGCGCAATGGGAGGGGAGCAGTCCGGTTGCTCGGTCGTGAGAACAATCTGATGTTGCTCGAATATGCCGGGGAGCGAATGCTCTCTCACATCGTTGCCGAGCACGGCGACTACCAGGCGACCGAAATTGCAGCGGAACTAATGGCGAAGCTGTATGCCGCATCTGAGGAACCCCTGCCTTCTGCCCTTCTCCCGATCCGGGATCGCTTTGCAGCTTTGTTTCAGCGGGCGCGCGATGATCAAAACGCAGGTTGTCAAACTGACTACGTCCACGCGGCGATTATAGCCGATCAAATGATGAGCAATGCCTCGGAACTGCGTGGGCTACATGGCGATCTGCATCATGAAAACATCATGTTCTCCAGTCGCGGCTGGCTGGTGATAGATCCCGTCGGTCTGGTCGGTGAAGTGGGCTTTGGCGCCGCCAATATGTTCTACGATCCGGCTGACAGAGACGACCTTTGTCTCGATCCTAGACGCATTGCACAGATGGCGGACGCATTCTCTCGTGCGCTGGACGTCGATCCGCGTCGCCTGCTCGACCAGGCGTACGCTTATGGGTGCCTTTCCGCAGCTTGGAACGCGGATGGAGAAGAGGAGCA
gb|AF462019|+|26-656|ARO:3002681|catB9 [Vibrio cholerae] 	0	575	656	1231	630	3840299-	575	ATGAACTTCTTTACGTCTCCATTTTCTGGGATTCCCTTAGATCAGCAAGTAACAAATCCGAACATTATTGTGGGAAAACACAGTTATTATTCTGGTTATTATCACGGGCACAGTTTCGATGATTGTGTGCGATATTTACATCCAGAAAGAGATGACGTTGATAAGTTAGTCATAGGGAGTTTTTGTTCTATAGGCTCTGGTGCTGTATTTATGATGGCCGGTAATCAAGGGCATCGCAGTGATTGGATAAGTACATTCCCATTTTTCTATCAGGATAATGATAATTTTGCAGATGCACGCGATGGTTTTACGCGTTCAGGAGACACAATTATTGGTCATGATGTGTGGATTGGCACTGAGGCTATGATAATGCCTGGGGTTAAAATTGGACATGGAGCGATAATCGCCAGTCGTTCAGTAGTGACTAAGGATGTTGCACCTTATGAAGTGGTCGGTTCAAATCCTGCTAAACATATCAAGTTTAGATTTTCTGATGTGGAAATAGCGATGTTACTTGAAATGGCATGGTGGAATTGGCCAGAATCGTGGTTGAAAGAGAGTATGCAGTCTCTGTG
gb|KJ584921.1|+|0-825|ARO:3001603|OXA-412 [Acinetobacter baumannii] 	0	770	54149	54919	825	246080-	770	ATGAACATTAAAGCACTCTTACTTATAACAAGCGCTATTTTTATTTCAGCCTGCTCACCTTATATAGTGACTGCTAATCCAAATCACAGCGCTTCAAAATCTGATGTAAAAGCAGAGAAAATTAAAAATTTATTTAACGAAGCACACACTACGGGTGTTTTAGTTATCCAACAAGGCCAAACTCAACAAAGCTATGGTAATGATCTTGCTCGTGCTTCGACCGAGTATGTACCTGCTTCGACCTTCAAAATGCTTAATGCTTTGATCGGCCTTGAGCACCATAAGGCAACCACCACAGAAGTATTTAAGTGGGATGGTAAAAAAAGGTTATTCCCAGAATGGGAAAAGGACATGACCCTAGGCGATGCCATGAAAGCTTCCGCTATTCCAGTTTATCAAGATTTAGCTCGTCGTATTGGACTTGAGCTCATGTCTAAGGAAGTGAAGCGTGTTGGTTATGGCAATGCAGATATCGGTACCCAAGTCGATAATTTTTGGCTGGTGGGTCCTTTAAAAATTACTCCTCAGCAAGAGGCACAGTTTGCTTACAAGCTAGCTAATAAAACGCTTCCATTTAGCCAAAAAGTCCAAGATGAAGTGCAATCCATGCTATTCATAGAAGAAAAGAATGGAAACAAAATATACGCAAAAAGTGGTTGGGGATGGGATGTAAACCCACAAGTAGGCTGGTTAACTGGATGGGTTGTTCAGCCTCAAGGGAATATTGTAGCGTTCTCCCTTAACTTAGAAATGAAAAAAGGAATACCTAG
gb|AF250872|+|0-861|ARO:3000954|TEM-87 [Proteus mirabilis] 	0	806	46	852	861	3478183-	806	ATGAGTATTCAACATTTCCGTGTCGCCCTTATTCCCTTTTTTGCGGCATTTTGCCTTCCTGTTTTTGCTCACCCAGAAACGCTGGTGAAAGTAAAAGATGCTGAAGATCAGTTGGGTGCACGAGTGGGTTACATCGAGCTGGATCTCAACAGCGGTAAGATCCTTGAGAGTTTTCGCCCCGAAGAACGTTTTCCAATGATGAGCACTTTTAAAGTTCTGCTATGTGGTGCGGTATTATCCCGTGTTGACGCCGGGCAAGAGCAACTCGGTCGCCGCATACACTATTCTCAGAATGACTTGGTTGAGTACTCACCAGTCACAGAAAAGCATCTTACGGATGGCATGACAGTAAGAGAATTATGCAGTGCTGCCATAACCATGAGTGATAACACTGCGGCCAACTTACTTCTGACAACGATCGGAGGACCGAAGGAGCTAACCGCTTTTTTGCACAACATGGGGGATCATGTAACCCGCCTTGATCGTTGGGAACCGGAGCTGAATGAAGCCATACCAAACGACGAGCGTGACACCACGATGCCTGCAGCAATGGCAACAACGTTGCGCAAACTATTAACTGGCGAACTACTTACTCTAGCTTCCCGGCAACAATTAATAGACTGGATGGAGGCGGATAAAGTTGCAGGACCACTTCTGCGCTCGGCCCTTCCGGCTGGCTGGTTTATTGCTGATAAATCTGGAGCCGGTGAGCGTGGATCTCGCGGTATCATTGCAGCACTGGGGCCAGATGGTAAGCCCTCCCGTATCGTAGTTATCTACACGACGGGGAGTCAGGCAACTATGGA
gb|U15027|+|0-624|ARO:3002686|catP [Clostridium perfringens] 	0	569	371	940	624	5332739+	569	ATGGTATTTGAAAAAATTGATAAAAATAGTTGGAACAGAAAAGAGTATTTTGACCACTACTTTGCAAGTGTACCTTGTACATACAGCATGACCGTTAAAGTGGATATCACACAAATAAAGGAAAAGGGAATGAAACTATATCCTGCAATGCTTTATTATATTGCAATGATTGTAAACCGCCATTCAGAGTTTAGGACGGCAATCAATCAAGATGGTGAATTGGGGATATATGATGAGATGATACCAAGCTATACAATATTTCACAATGATACTGAAACATTTTCCAGCCTTTGGACTGAGTGTAAGTCTGACTTTAAATCATTTTTAGCAGATTATGAAAGTGATACGCAACGGTATGGAAACAATCATAGAATGGAAGGAAAGCCAAATGCTCCGGAAAACATTTTTAATGTATCTATGATACCGTGGTCAACCTTCGATGGCTTTAATCTGAATTTGCAGAAAGGATATGATTATTTGATTCCTATTTTTACTATGGGGAAATATTATAAAGAAGATAACAAAATTATACTTCCTTTGGCAATTCAAGTTCATCACGCAGTATGTGA
gb|JX310327|+|0-861|ARO:3001378|TEM-201 [Escherichia coli] 	0	806	46	852	861	3478183-	806	ATGAGTATTCAACATTTCCGTGTCGCCCTTATTCCCTTTTTTGCGGCATTTTGCCTTCCTGTTTTTGCTCACCCAGAAACGCTGGTGAAAGTAAAAGATGCTGAAGATCAGTTGGGTGCACGAGTGGGTTACATCGAGCTGGATCTCAACAGCGGTAAGATCCTTGAGAGTTTTCGCCCCGAAGAACGTTTTCCAATGATGAGCACTTTTAAAGTTCTGCTATGTGGTGCGGTATTATCCCGTGTTGACGCCGGGCAAGAGCAACTCGGTCGCCGCATACACTATTCTCAGAATGACTTGGTTGAGTACTCACCAGTCACAGAAAAGCATCTTACGGATGGCATGACAGTAAGAGAATTATGCAGTGCTGCCATAACCATGAGTGATAACACTGCGGCCAACTTACTTCTGACAACGATCGGAGGACCGAAGGAGCTAACCGCTTTTTTGCACAACATGGGGGATCATGTAACCCGCCTTGATCGTTGGGAACCGGAGCTGAATGAAGCCATACCAAACGACGAGCGTGACACCACGATGCCTGCAGCAATGGCAACAACGTTGCGCAAACTATTAACTGGCGAACTACTTACTCTAGCTTCCCGGCAACAATTAATAGACTGGATGGAGGCGGATAAAGTTGCAGGACCACTTCTGCGCTCGGCCCTTCCGGCTGGCTGGTTTATTGCTGATAAATCTGGAGCCGGTGAGCGTGGATCTCGCGGTATCATTGCAGCACTGGGGCCAGATGGTAAGCCCTCCCGTATCGTAGTTATCTACACGACGGGGAGTCAGGCAACTATGGA
gb|DQ823382|+|0-1569|ARO:3002830|vgaALC [Staphylococcus haemolyticus] 	331	1376	0	1045	1569	240808+	1045	ATAATAACTATATAGAAAAATTAGAACAGGATTTAAAAAATTGGCATGGAGCATTTATTATAGTTTCACATGATCGCGCTTTTTTAGATAACTTATGTACTACTATATGGGAAATTGACGAGGGGAGAATAACTGAATATAAGGGGAATTATAGTAACTATGTTGAACAAAAAGAATTAGAAAGACATCGAGAAGAATTAGAATATGAAAAATATGAAAAAGAAAAGAAACGATTGGAAAAAGCTATAAATATAAAAGAACAGAAAGCTCAACGAGCAACTAAAAAACCGAAAAACTTAAGTTCATCTGAAGGCAAAATAAAAGTAACAAAGCCATACTTTGCAAGTAAGCAAAAGAAGTTACGAAAAACTGTAAAATCTCTAGAAACCAGACTAGAAAAACTTGAAAGGGTCGAAAAGAGAAACGAACTTCCTCCAGTTAAAATGGATTTAGTGAACTTAAAAAGTGTAAAAAATAGAACTATAATACGTGGTGAAGATGTCTCGGGTACAATTGAAGGACGGGTATTGTGGAAAGCAAAAAGTTTTAGTATTCGCGGAGGAGACAAGATGGCAATTATCGGATCTAATGGTACAGGAAAGACAACGTTTATTAAAAAAATTGTGCATGGGAATCCTGGTATTTCGTTATCGCCATCTGTCAAAATCGGTTATTTTAGCCAAAAAATAGATACATTAGAATTAGATAAGAGTATTTTAGAAAATGTTCAATCTTCTTCACAACAAAATGAAACTCTTATTCGAACTATTCTAGCTAGAATGCATTTTTTTAGAGATGATGTTTATAAACCAATAAGTGTCTTAAGTGGTGGAGAGCGAGTTAAAGTAGCACTAACTAAAGTATTCTTAAGTGAAGTTAATACGTTGGTACTAGATGAACCAACAAACTTTCTTGATATGGAAGCTATAGAGGCGTTTGAATCTTTGTTAAAGGAATATAATGGCAGTATAATCTTTGTATCTCACGATCGTAAATTTATCGAAAAAGTAGCCACTCGAATAATGACAATTGATAATAAAGAAAT
gb|AY027590|+|112-973|ARO:3000955|TEM-88 [Klebsiella pneumoniae] 	0	806	46	852	861	3478183-	806	ATGAGTATTCAACATTTCCGTGTCGCCCTTATTCCCTTTTTTGCGGCATTTTGCCTTCCTGTTTTTGCTCACCCAGAAACGCTGGTGAAAGTAAAAGATGCTGAAGATCAGTTGGGTGCACGAGTGGGTTACATCGAGCTGGATCTCAACAGCGGTAAGATCCTTGAGAGTTTTCGCCCCGAAGAACGTTTTCCAATGATGAGCACTTTTAAAGTTCTGCTATGTGGTGCGGTATTATCCCGTGTTGACGCCGGGCAAGAGCAACTCGGTCGCCGCATACACTATTCTCAGAATGACTTGGTTGAGTACTCACCAGTCACAGAAAAGCATCTTACGGATGGCATGACAGTAAGAGAATTATGCAGTGCTGCCATAACCATGAGTGATAACACTGCGGCCAACTTACTTCTGACAACGATCGGAGGACCGAAGGAGCTAACCGCTTTTTTGCACAACATGGGGGATCATGTAACCCGCCTTGATCGTTGGGAACCGGAGCTGAATGAAGCCATACCAAACGACGAGCGTGACACCACGATGCCTGCAGCAATGGCAACAACGTTGCGCAAACTATTAACTGGCGAACTACTTACTCTAGCTTCCCGGCAACAATTAATAGACTGGATGGAGGCGGATAAAGTTGCAGGACCACTTCTGCGCTCGGCCCTTCCGGCTGGCTGGTTTATTGCTGATAAATCTGGAGCCGGTGAGCGTGGATCTCGCGGTATCATTGCAGCACTGGGGCCAGATGGTAAGCCCTCCCGTATCGTAGTTATCTACACGACGGGGAGTCAGGCAACTATGGA
gb|KJ584922.1|+|0-825|ARO:3001604|OXA-413 [Acinetobacter baumannii] 	0	770	54149	54919	825	246080-	770	ATGAACATTAAAGCACTCTTACTTATAACAAGCGCTATTTTTATTTCAGCCTGCTCACCTTATATAGTGACTGCTAATCCAAATCACAGCGCTTCAAAATCTGATGTAAAAGCAGAGAAAATTAAAAATTTATTTAACGAAGCACACACTACGGGTGTTTTAGTTATCCAACAAGGCCAAACTCAACAAAGCTATGGTAATGATCTTGCTCGTGCTTCGACCGAGTATGTACCTGCTTCGACCTTCAAAATGCTTAATGCTTTGATCGGCCTTGAGCACCATAAGGCAACCACCACAGAAGTATTTAAGTGGGATGGTAAAAAAAGGTTATTCCCAGAATGGGAAAAGGACATGACCCTAGGCGATGCCATGAAAGCTTCCGCTATTCCAGTTTATCAAGATTTAGCTCGTCGTATTGGACTTGAGCTCATGTCTAAGGAAGTGAAGCGTGTTGGTTATGGCAATGCAGATATCGGTACCCAAGTCGATAATTTTTGGCTGGTGGGTCCTTTAAAAATTACTCCTCAGCAAGAGGCACAGTTTGCTTACAAGCTAGCTAATAAAACGCTTCCATTTAGCCAAAAAGTCCAAGATGAAGTGCAATCCATGCTATTCATAGAAGAAAAGAATGGAAACAAAATATACGCAAAAAGTGGTTGGGGATGGGATGTAAACCCACAAGTAGGCTGGTTAACTGGATGGGTTGTTCAGCCTCAAGGGAATATTGTAGCGTTCTCCCTTAACTTAGAAATGAAAAAAGGAATACCTAG
gb|FJ194944|+|46-907|ARO:3001154|SHV-105 [Klebsiella pneumoniae] 	0	806	16	822	861	1612535+	806	ATGCGTTATATTCGCCTGTGTATTATCACCCTGTGAGCCACCCTGCCGCTGGCGGTACACGCCAGCCCGCAGCCGCTTGAGCAAATTAAACAAAGCGAAAGCCAGCTGTCGGGCCGCGTAGGCATGATAGAAATGGATCTGGCCAGCGGCCGCACGCTGACCGCCTGGCGCGCCGATGAACGCTTTCCCATGATGAGCACCTTTAAAGTAGTGCTCTGCGGCGCAGTGCTGGCGCGGGTGGATGCCGGTGACGAACAGCTGGAGCGAAAGATCCACTATCGCCAGCAGGATCTGGTGGACTACTCGCCGGTCAGCGAAAAACACCTTGCCGACGGCATGACGGTCGGCGAACTCTGCGCCGCCGCCATTACCATGAGCGATAACAGCGCCGCCAATCTGCTGCTGGCCACCGTCGGCGGCCCCGCAGGATTGACTGCCTTTTTGCGCCAGATCGGCGACAACGTCACCCGCCTTGACCGCTGGGAAACGGAACTGAATGAGGCGCTTCCCGGCGACGCCCGCGACACCACTACCCCGGCCAGCATGGCCGCGACCCTGCGCAAGCTGCTGACCAGCCAGCGTCTGAGCGCCCGTTCGCAACGGCAGCTGCTGCAGTGGATGGTGGACGATCGGGTCGCCGGACCGTTGATCCGCTCCGTGCTGCCGGCGGGCTGGTTTATCGCCGATAAGACCGGAGCTAGCAAGCGGGGTGCGCGCGGGATTGTCGCCCTGCTTGGCCCGAATAACAAAGCAGAGCGCATTGTGGTGATTTATCTGCGGGATACGCCGGCGAGCATGGCCGAGCG
gb|AY039040|+|188-1022|ARO:3000956|TEM-89 [Proteus mirabilis] 	0	779	46	825	834	3478183-	779	ATGAGTATTCAACATTTCCGTGTCGCCCTTATTCCCTTTTTTGCGGCATTTTGCCTTCCTGTTTTTGCTCACCCAGAAACGCTGGTGAAAGTAAAAGATGCTGAAGATCAGTTGGGTGCACGAGTGGGTTACATCGAGCTGGATCTCAACAGCGGTAAGATCCTTGAGAGTTTTCGCCCCGAAGAACGTTTTCCAATGATGAGCACTTTTAAAGTTCTGCTATGTGGTGCGGTATTATCCCGTGTTGACGCCGGGCAAGAGCAACTCGGTCGCCGCATACACTATTCTCAGAATGACTTGGTTGAGTACTCACCAGTCACAGAAAAGCATCTTACGGATGGCATGACAGTAAGAGAATTATGCAGTGCTGCCATAACCATGAGTGATAACACTGCGGCCAACTTACTTCTGACAACGATCGGAGGACCGAAGGAGCTAACCGCTTTTTTGCACAACATGGGGGATCATGTAACCCGCCTTGATCGTTGGGAACCGGAGCTGAATGAAGCCATACCAAACGACGAGCGTGACACCACGATGCCTGCAGCAATGGCAACAACGTTGCGCAAACTATTAACTGGCGAACTACTTACTCTAGCTTCCCGGCAACAATTAATAGACTGGATGGAGGCGGATAAAGTTGCAGGACCACTTCTGCGCTCGGCCCTTCCGGCTGGCTGGTTTATTGCTGATAAATCTGGAGCCGGTGAGCGTGGATCTCGCGGTATCATTGCAGCACTGGGGCCAGATGGTAAGCCCTCCCGTATCGTAGTTATCTA
gb|KC900516|+|0-858|ARO:3001382|TEM-205 [Pseudomonas aeruginosa] 	0	803	46	849	858	3478183-	803	ATGAGTATTCAACATTTCCGTGTCGCCCTTATTCCCTTTTTTGCGGCATTTTGCCTTCCTGTTTTTGCTCACCCAGAAACGCTGGTGAAAGTAAAAGATGCTGAAGATCAGTTGGGTGCACGAGTGGGTTACATCGAGCTGGATCTCAACAGCGGTAAGATCCTTGAGAGTTTTCGCCCCGAAGAACGTTTTCCAATGATGAGCACTTTTAAAGTTCTGCTATGTGGTGCGGTATTATCCCGTGTTGACGCCGGGCAAGAGCAACTCGGTCGCCGCATACACTATTCTCAGAATGACTTGGTTGAGTACTCACCAGTCACAGAAAAGCATCTTACGGATGGCATGACAGTAAGAGAATTATGCAGTGCTGCCATAACCATGAGTGATAACACTGCGGCCAACTTACTTCTGACAACGATCGGAGGACCGAAGGAGCTAACCGCTTTTTTGCACAACATGGGGGATCATGTAACCCGCCTTGATCGTTGGGAACCGGAGCTGAATGAAGCCATACCAAACGACGAGCGTGACACCACGATGCCTGCAGCAATGGCAACAACGTTGCGCAAACTATTAACTGGCGAACTACTTACTCTAGCTTCCCGGCAACAATTAATAGACTGGATGGAGGCGGATAAAGTTGCAGGACCACTTCTGCGCTCGGCCCTTCCGGCTGGCTGGTTTATTGCTGATAAATCTGGAGCCGGTGAGCGTGGATCTCGCGGTATCATTGCAGCACTGGGGCCAGATGGTAAGCCCTCCCGTATCGTAGTTATCTACACGACGGGGAGTCAGGCAACTAT
gb|KJ584914.1|+|0-825|ARO:3001605|OXA-414 [Acinetobacter baumannii] 	0	770	54149	54919	825	246080-	770	ATGAACATTAAAGCACTCTTACTTATAACAAGCGCTATTTTTATTTCAGCCTGCTCACCTTATATAGTGACTGCTAATCCAAATCACAGCGCTTCAAAATCTGATGTAAAAGCAGAGAAAATTAAAAATTTATTTAACGAAGCACACACTACGGGTGTTTTAGTTATCCAACAAGGCCAAACTCAACAAAGCTATGGTAATGATCTTGCTCGTGCTTCGACCGAGTATGTACCTGCTTCGACCTTCAAAATGCTTAATGCTTTGATCGGCCTTGAGCACCATAAGGCAACCACCACAGAAGTATTTAAGTGGGATGGTAAAAAAAGGTTATTCCCAGAATGGGAAAAGGACATGACCCTAGGCGATGCCATGAAAGCTTCCGCTATTCCAGTTTATCAAGATTTAGCTCGTCGTATTGGACTTGAGCTCATGTCTAAGGAAGTGAAGCGTGTTGGTTATGGCAATGCAGATATCGGTACCCAAGTCGATAATTTTTGGCTGGTGGGTCCTTTAAAAATTACTCCTCAGCAAGAGGCACAGTTTGCTTACAAGCTAGCTAATAAAACGCTTCCATTTAGCCAAAAAGTCCAAGATGAAGTGCAATCCATGCTATTCATAGAAGAAAAGAATGGAAACAAAATATACGCAAAAAGTGGTTGGGGATGGGATGTAAACCCACAAGTAGGCTGGTTAACTGGATGGGTTGTTCAGCCTCAAGGGAATATTGTAGCGTTCTCCCTTAACTTAGAAATGAAAAAAGGAATACCTAG
gb|CP001182.1|+|2873299-2874451|ARO:3003796|Acinetobacter_baumannii_AmpC_beta-lactamase [Acinetobacter baumannii AB0057] 	0	1097	63	1160	1152	126080+	1097	ATGCGATTTAAAAAAATTTCTTGTCTACTTTTATCCCCGCTTTTTATTTTTAGTACCTCAATTTATGCGGGCAATACACCAAAAGACCAAGAAATTAAAAAACTGGTAGATCAAAACTTTAAACCGTTATTAGAAAAATATGATGTGCCAGGTATGGCTGTGGGTGTTATTCAAAATAATAAAAAGTATGAAATGTATTATGGTCTTCAATCTGTTCAAGATAAAAAAGCCGTAAATAGCAGTACTATTTTTGAGCTAGGTTCTGTCAGTAAATTATTTACCGCGACAGCAGGTGGATATGCAAAAAATAAAGGAAAAATCTCTTTTGACGATACGCCTGGTAAGTATTGGAAAGAACTAAAAAATACACCGATTGACCAAGTTAACTTACTTCAACTCGCGACGTATACAAGTGGTAACCTTGCCTTGCAATTTCCAGATGAAGTAAAAACAGATCAGCAAGTTTTAACATTTTTTAAAGACTGGAAACCTAAAAACTCAATCGGTGAATATCGACAATATTCAAACCCAAGCATTGGTTTATTTGGAAAAGTTGTAGCTTTGTCTATGAATAAACCTTTCGACCAAGTCTTAGAAAAAACAATTTTTCCGGCCCTTGGCTTAAAACATAGCTATGTAAATGTACCTAAGACCCAGATGCAAAACTATGCTTTTGGCTATAACCAAGAAAATCAGCCGATTCGAGTTAACCCCGGCCCACTCGATGCCCCAGCATATGGCGTCAAATCGACACTACCCGACATGTTGAGTTTTATTCATGCCAACCTAAATCCACAAAAATATCCAGCAGATATTCAACGGGCAATTAATGAAACACATCAGGGTCGCTATCAAGTAAATACCATGTATCAGGCACTCGGTTGGGAAGAGTTTTCTTATCCGGCAACGTTACAAACTTTATTAGACAGTAATTCAGAACAGATTGTGATGAAACCTAATAAAGTGACTGCTATTTCAAAGGAACCTTCAGTTAAGATGTACCATAAAACTGGCTCAACTACCGGTTTCGGAACATATGTGGTGTTTATTCCTAAAGAAAATATTGGTTTAGTCATGTTAACCAATAAACGTATTCC
gb|AM941847|+|0-861|ARO:3001155|SHV-106 [Klebsiella pneumoniae] 	0	806	16	822	861	1612535+	806	ATGCGTTATATTCGCCTGTGTATTATCACCCTGTGAGCCACCCTGCCGCTGGCGGTACACGCCAGCCCGCAGCCGCTTGAGCAAATTAAACAAAGCGAAAGCCAGCTGTCGGGCCGCGTAGGCATGATAGAAATGGATCTGGCCAGCGGCCGCACGCTGACCGCCTGGCGCGCCGATGAACGCTTTCCCATGATGAGCACCTTTAAAGTAGTGCTCTGCGGCGCAGTGCTGGCGCGGGTGGATGCCGGTGACGAACAGCTGGAGCGAAAGATCCACTATCGCCAGCAGGATCTGGTGGACTACTCGCCGGTCAGCGAAAAACACCTTGCCGACGGCATGACGGTCGGCGAACTCTGCGCCGCCGCCATTACCATGAGCGATAACAGCGCCGCCAATCTGCTGCTGGCCACCGTCGGCGGCCCCGCAGGATTGACTGCCTTTTTGCGCCAGATCGGCGACAACGTCACCCGCCTTGACCGCTGGGAAACGGAACTGAATGAGGCGCTTCCCGGCGACGCCCGCGACACCACTACCCCGGCCAGCATGGCCGCGACCCTGCGCAAGCTGCTGACCAGCCAGCGTCTGAGCGCCCGTTCGCAACGGCAGCTGCTGCAGTGGATGGTGGACGATCGGGTCGCCGGACCGTTGATCCGCTCCGTGCTGCCGGCGGGCTGGTTTATCGCCGATAAGACCGGAGCTAGCAAGCGGGGTGCGCGCGGGATTGTCGCCCTGCTTGGCCCGAATAACAAAGCAGAGCGCATTGTGGTGATTTATCTGCGGGATACGCCGGCGAGCATGGCCGAGCG
gb|KM433671|+|0-822|ARO:3003160|OXA-422 [Acinetobacter baumannii] 	0	767	80	847	822	254088-	767	ATGAATAAATATTTTACTTGCTATGTGGTTGCTTCTCTTTTTCTTTCTGGTTGTACGGTTCAGCATAATTTAATAAATGAAACCCCGAGTCAGATTGTTCAAGGACATAATCAGGTGATTCATCAATACTTTGATGAAAAAAACACCTCAGGTGTGCTGGTTATTCAAACAGATAAAAAAATTAATCTATATGGTAATGCTCTAAGCCGCGCAAATACAGAATATGTGCCAGCCTCTACATTTAAAATGTTGAATGCCCTGATCGGATTGGAGAACCAGAAAACGGATATTAATGAAATATTTAAATGGAAGGGCGAGAAAAGGTCATTTACCGCTTGGGAAAAAGACATGACACTAGGAGAAGCCATGAAGCTTTCTGCAGTCCCAGTCTATCAGGAACTTGCGCGACGTATCGGTCTTGATCTCATGCAAAAAGAAGTAAAACGTATTGGTTTCGGTAATGCTGAAATTGGACAGCAGGTTGATAATTTCTGGTTGGTAGGACCATTAAAGGTTACGCCTATTCAAGAGGTAGAGTTTGTTTCCCAATTAGCACATACACAGCTTCCATTTAGTGAAAAAGTGCAGGCTAATGTAAAAAATATGCTTCTTTTAGAAGAGAGTAATGGCTACAAAATTTTTGGAAAGACTGGTTGGGCAATGGATATAAAACCACAAGTGGGCTGGTTGACCGGCTGGGTTGAGCAGCCAGATGGAAAAATTGTCGCTTTTGCATTAAATATGGAAATGCGGTCAGAAATGCCGGC
gb|KC783461|+|0-861|ARO:3001383|TEM-206 [Escherichia coli] 	0	806	46	852	861	3478183-	806	ATGAGTATTCAACATTTCCGTGTCGCCCTTATTCCCTTTTTTGCGGCATTTTGCCTTCCTGTTTTTGCTCACCCAGAAACGCTGGTGAAAGTAAAAGATGCTGAAGATCAGTTGGGTGCACGAGTGGGTTACATCGAGCTGGATCTCAACAGCGGTAAGATCCTTGAGAGTTTTCGCCCCGAAGAACGTTTTCCAATGATGAGCACTTTTAAAGTTCTGCTATGTGGTGCGGTATTATCCCGTGTTGACGCCGGGCAAGAGCAACTCGGTCGCCGCATACACTATTCTCAGAATGACTTGGTTGAGTACTCACCAGTCACAGAAAAGCATCTTACGGATGGCATGACAGTAAGAGAATTATGCAGTGCTGCCATAACCATGAGTGATAACACTGCGGCCAACTTACTTCTGACAACGATCGGAGGACCGAAGGAGCTAACCGCTTTTTTGCACAACATGGGGGATCATGTAACCCGCCTTGATCGTTGGGAACCGGAGCTGAATGAAGCCATACCAAACGACGAGCGTGACACCACGATGCCTGCAGCAATGGCAACAACGTTGCGCAAACTATTAACTGGCGAACTACTTACTCTAGCTTCCCGGCAACAATTAATAGACTGGATGGAGGCGGATAAAGTTGCAGGACCACTTCTGCGCTCGGCCCTTCCGGCTGGCTGGTTTATTGCTGATAAATCTGGAGCCGGTGAGCGTGGATCTCGCGGTATCATTGCAGCACTGGGGCCAGATGGTAAGCCCTCCCGTATCGTAGTTATCTACACGACGGGGAGTCAGGCAACTATGGA
gb|AM941848|+|0-861|ARO:3001156|SHV-107 [Klebsiella pneumoniae] 	0	806	16	822	861	1612535+	806	ATGCGTTATATTCGCCTGTGTATTATCACCCTGTGAGCCACCCTGCCGCTGGCGGTACACGCCAGCCCGCAGCCGCTTGAGCAAATTAAACAAAGCGAAAGCCAGCTGTCGGGCCGCGTAGGCATGATAGAAATGGATCTGGCCAGCGGCCGCACGCTGACCGCCTGGCGCGCCGATGAACGCTTTCCCATGATGAGCACCTTTAAAGTAGTGCTCTGCGGCGCAGTGCTGGCGCGGGTGGATGCCGGTGACGAACAGCTGGAGCGAAAGATCCACTATCGCCAGCAGGATCTGGTGGACTACTCGCCGGTCAGCGAAAAACACCTTGCCGACGGCATGACGGTCGGCGAACTCTGCGCCGCCGCCATTACCATGAGCGATAACAGCGCCGCCAATCTGCTGCTGGCCACCGTCGGCGGCCCCGCAGGATTGACTGCCTTTTTGCGCCAGATCGGCGACAACGTCACCCGCCTTGACCGCTGGGAAACGGAACTGAATGAGGCGCTTCCCGGCGACGCCCGCGACACCACTACCCCGGCCAGCATGGCCGCGACCCTGCGCAAGCTGCTGACCAGCCAGCGTCTGAGCGCCCGTTCGCAACGGCAGCTGCTGCAGTGGATGGTGGACGATCGGGTCGCCGGACCGTTGATCCGCTCCGTGCTGCCGGCGGGCTGGTTTATCGCCGATAAGACCGGAGCTAGCAAGCGGGGTGCGCGCGGGATTGTCGCCCTGCTTGGCCCGAATAACAAAGCAGAGCGCATTGTGGTGATTTATCTGCGGGATACGCCGGCGAGCATGGCCGAGCG
gb|KC818234|+|0-861|ARO:3001384|TEM-207 [Escherichia coli] 	0	806	46	852	861	3478183-	806	ATGAGTATTCAACATTTCCGTGTCGCCCTTATTCCCTTTTTTGCGGCATTTTGCCTTCCTGTTTTTGCTCACCCAGAAACGCTGGTGAAAGTAAAAGATGCTGAAGATCAGTTGGGTGCACGAGTGGGTTACATCGAGCTGGATCTCAACAGCGGTAAGATCCTTGAGAGTTTTCGCCCCGAAGAACGTTTTCCAATGATGAGCACTTTTAAAGTTCTGCTATGTGGTGCGGTATTATCCCGTGTTGACGCCGGGCAAGAGCAACTCGGTCGCCGCATACACTATTCTCAGAATGACTTGGTTGAGTACTCACCAGTCACAGAAAAGCATCTTACGGATGGCATGACAGTAAGAGAATTATGCAGTGCTGCCATAACCATGAGTGATAACACTGCGGCCAACTTACTTCTGACAACGATCGGAGGACCGAAGGAGCTAACCGCTTTTTTGCACAACATGGGGGATCATGTAACCCGCCTTGATCGTTGGGAACCGGAGCTGAATGAAGCCATACCAAACGACGAGCGTGACACCACGATGCCTGCAGCAATGGCAACAACGTTGCGCAAACTATTAACTGGCGAACTACTTACTCTAGCTTCCCGGCAACAATTAATAGACTGGATGGAGGCGGATAAAGTTGCAGGACCACTTCTGCGCTCGGCCCTTCCGGCTGGCTGGTTTATTGCTGATAAATCTGGAGCCGGTGAGCGTGGATCTCGCGGTATCATTGCAGCACTGGGGCCAGATGGTAAGCCCTCCCGTATCGTAGTTATCTACACGACGGGGAGTCAGGCAACTATGGA
gb|CP006845.1|+|539695-540745|ARO:3002814|clbA [Bacillus amyloliquefaciens CC178] 	113,388	417,814	1,0	304,426	1050	55015570-;55015572-	303;426	TTTAATGAAATAACGGTTTTTCCTAAATCCTTGAGAAAATTGTTAATGAATGAGTTTGGAGAGTCAATTTTAAATATTGCTGCTTTAAAAGTGCAGCATTCTGAGCAAGTAACAAAAGTCTTATTTGAAATTTCAGGAGACGAAAAAATAGAAACGGTCAATATCAAATATAAAGCTGGCTGGGAGTCATTTTGTATATCCTCGTAGTGCGGCTGTCATTTTGGCTGTACATTTTGTGCAACAGGAGATATTGGTTTAAAACGCAGCTTAACATCAGATGAAATGACTGACCAAATGTTGTAC;CAGATGAAATGAGTGACCAAATTTTGTACATTCACTTAAAAGGACATTCAATTGACAGTATTTCTTTTATGGGAATGGGAGAAGCATTAGCTAATGTACAAGTTTTTGATGCTTCACATGTGCTTACAAATCCGGAGTTGTTTGCTTTAAGCCCTCGTCGCTTATCTATTTCGACCATAGGTATTATTCCGGGCAATAAAAAAATCACTCAGGATTATCCGCAGGTCAACCTGCCGTTTTCATTACATTCTCCTTTTAATGAACAGCGAAGCAAGTTAATCCCGATTAATGAACGCTTCCCGTTATTGGAGGTAATGGACACATTAGATGAGCATATACGTGTGACCTCAAGAAAAGTTTATATTGCTTATATTATGCTGCCGGGAGTTAATGATTCTATTGATCATGCGAATGAAGTAGTACGTC
gb|KC865667|+|183-1044|ARO:3001385|TEM-208 [Escherichia coli] 	0	806	46	852	861	3478183-	806	ATGAGTATTCAACATTTCCGTGTCGCCCTTATTCCCTTTTTTGCGGCATTTTGCCTTCCTGTTTTTGCTCACCCAGAAACGCTGGTGAAAGTAAAAGATGCTGAAGATCAGTTGGGTGCACGAGTGGGTTACATCGAGCTGGATCTCAACAGCGGTAAGATCCTTGAGAGTTTTCGCCCCGAAGAACGTTTTCCAATGATGAGCACTTTTAAAGTTCTGCTATGTGGTGCGGTATTATCCCGTGTTGACGCCGGGCAAGAGCAACTCGGTCGCCGCATACACTATTCTCAGAATGACTTGGTTGAGTACTCACCAGTCACAGAAAAGCATCTTACGGATGGCATGACAGTAAGAGAATTATGCAGTGCTGCCATAACCATGAGTGATAACACTGCGGCCAACTTACTTCTGACAACGATCGGAGGACCGAAGGAGCTAACCGCTTTTTTGCACAACATGGGGGATCATGTAACCCGCCTTGATCGTTGGGAACCGGAGCTGAATGAAGCCATACCAAACGACGAGCGTGACACCACGATGCCTGCAGCAATGGCAACAACGTTGCGCAAACTATTAACTGGCGAACTACTTACTCTAGCTTCCCGGCAACAATTAATAGACTGGATGGAGGCGGATAAAGTTGCAGGACCACTTCTGCGCTCGGCCCTTCCGGCTGGCTGGTTTATTGCTGATAAATCTGGAGCCGGTGAGCGTGGATCTCGCGGTATCATTGCAGCACTGGGGCCAGATGGTAAGCCCTCCCGTATCGTAGTTATCTACACGACGGGGAGTCAGGCAACTATGGA
gb|FO834906.1|+|304977-306633|ARO:3005053|ArnT [Klebsiella pneumoniae] 	0	1601	684	2285	1656	1839648+	1601	ATGAAAAGCATTCGCTATGGCGTCTCTCTGATTGCGCTGTTTGCGCTGTATTATCTGCTGCCGCTCAATTTCCGTTTGCTCTGGCAACCCGACGAAACCCGCTACGCGGAGATCAGCCGTGAAATGCTGGCCACCGGCGACTGGGTGGTACCGCATTTTCTCGGCCTGCGCTACTTCGAAAAACCGATTGCCGGTTACTGGATCAACAGTATCGGTCAGTGGCTGTTTGGCCATAATAACTTCGGCGTACGCTTCGGGTCGGTCTTCGCCATCACCATGACCGCCCTGCTGGTGGCCTGGCTGGCGTGGCGGATCTTTCGTGATAAGCGGGTAGCTATCCTGTCGCCGATTATCTTCCTCACCGCGATGCTGGTGTATGCGATTGGCACCTATGCGGTGCTGGACCCGATGATCACCCTGTGGCTGGCGCTGGCGATGTGCAGCTTCTGGGGCGCGGCGCAGGCGCACAGCCGCAGCGGCAAAATACTGGGCTACGTGCTGCTGGGCGTCGCCTGCGGGATGGGGGTGATGACCAAGGGCTTCCTGGCGCTGGCGGTGCCGGTGGTGGGCGTTCTGCCGTGGGTGATCGCTCGTAAACGCTGGCGTGAAGTGCTGACCTACGGCTGGCTGGCGGTAATCGTCTGTACGCTGGTGGTGCTGCCCTGGGGGCTGGCTATCGCTCAGCGCGAGCCGGACTTCTGGCGCTACTTCTTCTGGGTCGAGCATATTCAGCGTTTTGCTGAAAAAGACGCCCAGCACAAAGCGCCGTTCTGGTACTACATCCCGTTCCTGATCGCCGGCAGTCTGCCGTGGCTGGCCCTGCTGCCGGGGGCGCTAAAGCGCGGCTGGCTTGAGCGCGATGAGGCCCGCGGCGCGCTGTATCTGTTAGGTTGGGTGGCGATGCCGTTCCTGTTCTTCAGTATCGCCAAAGGCAAACTGCCGACCTATATTCTGCCGTGCTTTGCGCCGCTGTCGATCCTGATGGCCCGCTACGCGCTGGAGGCCGCAAAGACCGGCGCGAAAGCGTTGCGCATCAACGGGATGATCAACCTGGGCGTTGGTTTGCTGGGGCTTATCGCCGTGCTGGTGGTCTCGCCGTGGGGCTTCATGCATAAGCCGGTGTGGACCAAGATTGAGCTGTATAAATGTCTGCTGGCGGCGATCGCTTTTGCCGTCTGGGCGCTGATGGGCTGGCTGGCGATGAAAGACTCTGGCCGCCGCTGGAGCCTCGCCGCGCTCTGTCCGCTCGGCCTGGCGCTGCTGGTGGGCTTCGCCATCCCGGACCGGGTTATCGACAGCAAACAGCCGCAGTTCCTCGTGGATATCGTCAGCGAATCCCTGCAGCCCAGCCGTTACGTCCTGACCAACAACGTTGGGATCGCCGGCGGCCTGGCCTGGGAGCTGAAGCGAAGCGATATTATTATGTTCGACAAACAGGGTGAGCTGAAGTACGGTCTCGACTGGCCGGATGCTCAGGGAAGCTTTGTCAGCCAGGCCGGTTTTGCCGACTGGCTGGCCGCGCATCGTCAGCAGGGGCCGGTCTCGCTGGTGCTGTTGATGGATAAAGGAGAGAGTATGCTCGACTTACCGTTACCGAAACC
gb|KF240808|+|0-861|ARO:3001386|TEM-209 [Klebsiella pneumoniae] 	0	806	46	852	861	3478183-	806	ATGAGTATTCAACATTTCCGTGTCGCCCTTATTCCCTTTTTTGCGGCATTTTGCCTTCCTGTTTTTGCTCACCCAGAAACGCTGGTGAAAGTAAAAGATGCTGAAGATCAGTTGGGTGCACGAGTGGGTTACATCGAGCTGGATCTCAACAGCGGTAAGATCCTTGAGAGTTTTCGCCCCGAAGAACGTTTTCCAATGATGAGCACTTTTAAAGTTCTGCTATGTGGTGCGGTATTATCCCGTGTTGACGCCGGGCAAGAGCAACTCGGTCGCCGCATACACTATTCTCAGAATGACTTGGTTGAGTACTCACCAGTCACAGAAAAGCATCTTACGGATGGCATGACAGTAAGAGAATTATGCAGTGCTGCCATAACCATGAGTGATAACACTGCGGCCAACTTACTTCTGACAACGATCGGAGGACCGAAGGAGCTAACCGCTTTTTTGCACAACATGGGGGATCATGTAACCCGCCTTGATCGTTGGGAACCGGAGCTGAATGAAGCCATACCAAACGACGAGCGTGACACCACGATGCCTGCAGCAATGGCAACAACGTTGCGCAAACTATTAACTGGCGAACTACTTACTCTAGCTTCCCGGCAACAATTAATAGACTGGATGGAGGCGGATAAAGTTGCAGGACCACTTCTGCGCTCGGCCCTTCCGGCTGGCTGGTTTATTGCTGATAAATCTGGAGCCGGTGAGCGTGGATCTCGCGGTATCATTGCAGCACTGGGGCCAGATGGTAAGCCCTCCCGTATCGTAGTTATCTACACGACGGGGAGTCAGGCAACTATGGA
gb|HM751100|+|0-861|ARO:3001157|SHV-108 [Klebsiella pneumoniae] 	0	806	16	822	861	1612535+	806	ATGCGTTATATTCGCCTGTGTATTATCACCCTGTGAGCCACCCTGCCGCTGGCGGTACACGCCAGCCCGCAGCCGCTTGAGCAAATTAAACAAAGCGAAAGCCAGCTGTCGGGCCGCGTAGGCATGATAGAAATGGATCTGGCCAGCGGCCGCACGCTGACCGCCTGGCGCGCCGATGAACGCTTTCCCATGATGAGCACCTTTAAAGTAGTGCTCTGCGGCGCAGTGCTGGCGCGGGTGGATGCCGGTGACGAACAGCTGGAGCGAAAGATCCACTATCGCCAGCAGGATCTGGTGGACTACTCGCCGGTCAGCGAAAAACACCTTGCCGACGGCATGACGGTCGGCGAACTCTGCGCCGCCGCCATTACCATGAGCGATAACAGCGCCGCCAATCTGCTGCTGGCCACCGTCGGCGGCCCCGCAGGATTGACTGCCTTTTTGCGCCAGATCGGCGACAACGTCACCCGCCTTGACCGCTGGGAAACGGAACTGAATGAGGCGCTTCCCGGCGACGCCCGCGACACCACTACCCCGGCCAGCATGGCCGCGACCCTGCGCAAGCTGCTGACCAGCCAGCGTCTGAGCGCCCGTTCGCAACGGCAGCTGCTGCAGTGGATGGTGGACGATCGGGTCGCCGGACCGTTGATCCGCTCCGTGCTGCCGGCGGGCTGGTTTATCGCCGATAAGACCGGAGCTAGCAAGCGGGGTGCGCGCGGGATTGTCGCCCTGCTTGGCCCGAATAACAAAGCAGAGCGCATTGTGGTGATTTATCTGCGGGATACGCCGGCGAGCATGGCCGAGCG
gb|AE004091.2|+|3450837-3451509|ARO:3005063|cprR [Pseudomonas aeruginosa PAO1] 	0	617	2	619	672	226213+	617	ATGCATATCCACGTACTCGTCGTCGAAGACAACTTCGATCTCGCCGGCACCGTCATCGACTACCTCGAGGCCGCCGGGGTGGTCTGCGATCACGCCCGCGACGGCCAGGCCGGCCTCAACCTGGCGCGCGCCAACCGCTACGACGTGATCCTGCTGGACATCATGCTGCCGCGCATCAACGGCCGGCAGGTCTGTCGCCAGCTGCGCGAAGCCGGCCTGCAGACCCCGGTACTCATGCTCACCGCCCTGGATACCCTGCAGGACAAGCTCGACGGCTTCGACGCCGGCGCCGACGACTATCTGCTCAAGCCCTTCGAACTGCCGGAGCTGCTGGTCCGCCTGCAAGCCCTCAGCCGGCGCCGCAGCGGCCAGGCCCAGCGCCTGCAGGTCGACGACCTGGTGATGGACCTCGACAGCCGCCAGGCCAGCCGCGGCGGCACGCCCCTGGCGCTGTCCCCCACCGCCTGGAAGATCCTCGAGTGCCTGATGCGCGCCAGCCCCGCGCTGGTCACCCGCGAGCAGCTGGGGCGCAGCGTCTGGGGCGACGAGCCGCCGGAAAGCAACACCCTCAACGTGCACATGCACCACCTGCGCAGCACCGTCGACAAGGGGTTCGC
gb|Y17582|+|0-858|ARO:3000892|TEM-21 [Klebsiella pneumoniae] 	0	803	46	849	858	3478183-	803	ATGAGTATTCAACATTTCCGTGTCGCCCTTATTCCCTTTTTTGCGGCATTTTGCCTTCCTGTTTTTGCTCACCCAGAAACGCTGGTGAAAGTAAAAGATGCTGAAGATCAGTTGGGTGCACGAGTGGGTTACATCGAGCTGGATCTCAACAGCGGTAAGATCCTTGAGAGTTTTCGCCCCGAAGAACGTTTTCCAATGATGAGCACTTTTAAAGTTCTGCTATGTGGTGCGGTATTATCCCGTGTTGACGCCGGGCAAGAGCAACTCGGTCGCCGCATACACTATTCTCAGAATGACTTGGTTGAGTACTCACCAGTCACAGAAAAGCATCTTACGGATGGCATGACAGTAAGAGAATTATGCAGTGCTGCCATAACCATGAGTGATAACACTGCGGCCAACTTACTTCTGACAACGATCGGAGGACCGAAGGAGCTAACCGCTTTTTTGCACAACATGGGGGATCATGTAACCCGCCTTGATCGTTGGGAACCGGAGCTGAATGAAGCCATACCAAACGACGAGCGTGACACCACGATGCCTGCAGCAATGGCAACAACGTTGCGCAAACTATTAACTGGCGAACTACTTACTCTAGCTTCCCGGCAACAATTAATAGACTGGATGGAGGCGGATAAAGTTGCAGGACCACTTCTGCGCTCGGCCCTTCCGGCTGGCTGGTTTATTGCTGATAAATCTGGAGCCGGTGAGCGTGGATCTCGCGGTATCATTGCAGCACTGGGGCCAGATGGTAAGCCCTCCCGTATCGTAGTTATCTACACGACGGGGAGTCAGGCAACTAT
gb|EU418913|+|16-877|ARO:3001158|SHV-109 [Klebsiella pneumoniae] 	0	806	16	822	861	1612535+	806	ATGCGTTATATTCGCCTGTGTATTATCACCCTGTGAGCCACCCTGCCGCTGGCGGTACACGCCAGCCCGCAGCCGCTTGAGCAAATTAAACAAAGCGAAAGCCAGCTGTCGGGCCGCGTAGGCATGATAGAAATGGATCTGGCCAGCGGCCGCACGCTGACCGCCTGGCGCGCCGATGAACGCTTTCCCATGATGAGCACCTTTAAAGTAGTGCTCTGCGGCGCAGTGCTGGCGCGGGTGGATGCCGGTGACGAACAGCTGGAGCGAAAGATCCACTATCGCCAGCAGGATCTGGTGGACTACTCGCCGGTCAGCGAAAAACACCTTGCCGACGGCATGACGGTCGGCGAACTCTGCGCCGCCGCCATTACCATGAGCGATAACAGCGCCGCCAATCTGCTGCTGGCCACCGTCGGCGGCCCCGCAGGATTGACTGCCTTTTTGCGCCAGATCGGCGACAACGTCACCCGCCTTGACCGCTGGGAAACGGAACTGAATGAGGCGCTTCCCGGCGACGCCCGCGACACCACTACCCCGGCCAGCATGGCCGCGACCCTGCGCAAGCTGCTGACCAGCCAGCGTCTGAGCGCCCGTTCGCAACGGCAGCTGCTGCAGTGGATGGTGGACGATCGGGTCGCCGGACCGTTGATCCGCTCCGTGCTGCCGGCGGGCTGGTTTATCGCCGATAAGACCGGAGCTAGCAAGCGGGGTGCGCGCGGGATTGTCGCCCTGCTTGGCCCGAATAACAAAGCAGAGCGCATTGTGGTGATTTATCTGCGGGATACGCCGGCGAGCATGGCCGAGCG
gb|KF513179|+|0-861|ARO:3001388|TEM-211 [Proteus mirabilis] 	0	806	46	852	861	3478183-	806	ATGAGTATTCAACATTTCCGTGTCGCCCTTATTCCCTTTTTTGCGGCATTTTGCCTTCCTGTTTTTGCTCACCCAGAAACGCTGGTGAAAGTAAAAGATGCTGAAGATCAGTTGGGTGCACGAGTGGGTTACATCGAGCTGGATCTCAACAGCGGTAAGATCCTTGAGAGTTTTCGCCCCGAAGAACGTTTTCCAATGATGAGCACTTTTAAAGTTCTGCTATGTGGTGCGGTATTATCCCGTGTTGACGCCGGGCAAGAGCAACTCGGTCGCCGCATACACTATTCTCAGAATGACTTGGTTGAGTACTCACCAGTCACAGAAAAGCATCTTACGGATGGCATGACAGTAAGAGAATTATGCAGTGCTGCCATAACCATGAGTGATAACACTGCGGCCAACTTACTTCTGACAACGATCGGAGGACCGAAGGAGCTAACCGCTTTTTTGCACAACATGGGGGATCATGTAACCCGCCTTGATCGTTGGGAACCGGAGCTGAATGAAGCCATACCAAACGACGAGCGTGACACCACGATGCCTGCAGCAATGGCAACAACGTTGCGCAAACTATTAACTGGCGAACTACTTACTCTAGCTTCCCGGCAACAATTAATAGACTGGATGGAGGCGGATAAAGTTGCAGGACCACTTCTGCGCTCGGCCCTTCCGGCTGGCTGGTTTATTGCTGATAAATCTGGAGCCGGTGAGCGTGGATCTCGCGGTATCATTGCAGCACTGGGGCCAGATGGTAAGCCCTCCCGTATCGTAGTTATCTACACGACGGGGAGTCAGGCAACTATGGA
gb|AY453161|+|500-1430|ARO:3000090|BLA1 [Bacillus anthracis] 	0,588	496,875	455,0	951,287	930	235414+;213549+	496;287	ATGATAGTTTTGAAAAACAAGAAAATGCTAAAAATAGGGATGTGTGTTGGTATATTAGGTTTAAGTATTACAAGCCTAGTAACTTTTACAGGAGGTGCATTGCAAGTTGAAGCGAAAGAAAAGACTGGACAAGTGAAACATAAAAATCAGGCGACGCATAAAGAGTTCTCTCAACTTGAGAAAAAATTTGATGCTCGATTAGGTGTATATGCGATTGATACTGGTACAAATCAAACAATCTCTTATCGATCTAACGAAAGATTTGCCTTCGCATCAACCTACAAGGCTTTAGCAGCAGGAGTATTACTACAGCAAAACTCAATTGATTCATTAAATGAAGTAATCACATATACGAAAGAAGACTTAGTGGATTATTCACCTGTTACAGAGAAACATGTAGATACTGGAATGAAACTAGGAGAAATTGCTGAGGCAGCTGTTCGTTCAAGCGATAATACTGCAGGGAACATTTTATTTAATAAAATAGGAGGACCGA;ATTCGTGACACCAGTACAGCGAAAGCAATTGCTACGAATCTTAAAGCTTTTACGGCCGGAAATGCGCTTCCAAATCATAAACGTAACATTCTTACAAAGTGGATGAAAGGAAATGCTACAGGAGACAAACTTATTCGTGCAGGTGTGCCTACTAACTGGGTAGTTGCAGATAAATCAGGAGCTGGAAGTTACGGGACACGAAATGATATTGCTATCGTTTGGCCACCAAATAGAGCACCTATTATCATCGCAATTTTATCTAGTAAAGATGAAAAAGGGGCTACCTA
gb|X98101|+|73-934|ARO:3001070|SHV-11 [Klebsiella pneumoniae] 	0	806	16	822	861	1612535+	806	ATGCGTTATATTCGCCTGTGTATTATCACCCTGTGAGCCACCCTGCCGCTGGCGGTACACGCCAGCCCGCAGCCGCTTGAGCAAATTAAACAAAGCGAAAGCCAGCTGTCGGGCCGCGTAGGCATGATAGAAATGGATCTGGCCAGCGGCCGCACGCTGACCGCCTGGCGCGCCGATGAACGCTTTCCCATGATGAGCACCTTTAAAGTAGTGCTCTGCGGCGCAGTGCTGGCGCGGGTGGATGCCGGTGACGAACAGCTGGAGCGAAAGATCCACTATCGCCAGCAGGATCTGGTGGACTACTCGCCGGTCAGCGAAAAACACCTTGCCGACGGCATGACGGTCGGCGAACTCTGCGCCGCCGCCATTACCATGAGCGATAACAGCGCCGCCAATCTGCTGCTGGCCACCGTCGGCGGCCCCGCAGGATTGACTGCCTTTTTGCGCCAGATCGGCGACAACGTCACCCGCCTTGACCGCTGGGAAACGGAACTGAATGAGGCGCTTCCCGGCGACGCCCGCGACACCACTACCCCGGCCAGCATGGCCGCGACCCTGCGCAAGCTGCTGACCAGCCAGCGTCTGAGCGCCCGTTCGCAACGGCAGCTGCTGCAGTGGATGGTGGACGATCGGGTCGCCGGACCGTTGATCCGCTCCGTGCTGCCGGCGGGCTGGTTTATCGCCGATAAGACCGGAGCTAGCAAGCGGGGTGCGCGCGGGATTGTCGCCCTGCTTGGCCCGAATAACAAAGCAGAGCGCATTGTGGTGATTTATCTGCGGGATACGCCGGCGAGCATGGCCGAGCG
gb|KF663615|+|0-858|ARO:3001390|TEM-213 [Pseudomonas aeruginosa] 	0	803	46	849	858	3478183-	803	ATGAGTATTCAACATTTCCGTGTCGCCCTTATTCCCTTTTTTGCGGCATTTTGCCTTCCTGTTTTTGCTCACCCAGAAACGCTGGTGAAAGTAAAAGATGCTGAAGATCAGTTGGGTGCACGAGTGGGTTACATCGAGCTGGATCTCAACAGCGGTAAGATCCTTGAGAGTTTTCGCCCCGAAGAACGTTTTCCAATGATGAGCACTTTTAAAGTTCTGCTATGTGGTGCGGTATTATCCCGTGTTGACGCCGGGCAAGAGCAACTCGGTCGCCGCATACACTATTCTCAGAATGACTTGGTTGAGTACTCACCAGTCACAGAAAAGCATCTTACGGATGGCATGACAGTAAGAGAATTATGCAGTGCTGCCATAACCATGAGTGATAACACTGCGGCCAACTTACTTCTGACAACGATCGGAGGACCGAAGGAGCTAACCGCTTTTTTGCACAACATGGGGGATCATGTAACCCGCCTTGATCGTTGGGAACCGGAGCTGAATGAAGCCATACCAAACGACGAGCGTGACACCACGATGCCTGCAGCAATGGCAACAACGTTGCGCAAACTATTAACTGGCGAACTACTTACTCTAGCTTCCCGGCAACAATTAATAGACTGGATGGAGGCGGATAAAGTTGCAGGACCACTTCTGCGCTCGGCCCTTCCGGCTGGCTGGTTTATTGCTGATAAATCTGGAGCCGGTGAGCGTGGATCTCGCGGTATCATTGCAGCACTGGGGCCAGATGGTAAGCCCTCCCGTATCGTAGTTATCTACACGACGGGGAGTCAGGCAACTAT
gb|KP050491|+|0-861|ARO:3001391|TEM-214 [Escherichia coli] 	0	806	46	852	861	3478183-	806	ATGAGTATTCAACATTTCCGTGTCGCCCTTATTCCCTTTTTTGCGGCATTTTGCCTTCCTGTTTTTGCTCACCCAGAAACGCTGGTGAAAGTAAAAGATGCTGAAGATCAGTTGGGTGCACGAGTGGGTTACATCGAGCTGGATCTCAACAGCGGTAAGATCCTTGAGAGTTTTCGCCCCGAAGAACGTTTTCCAATGATGAGCACTTTTAAAGTTCTGCTATGTGGTGCGGTATTATCCCGTGTTGACGCCGGGCAAGAGCAACTCGGTCGCCGCATACACTATTCTCAGAATGACTTGGTTGAGTACTCACCAGTCACAGAAAAGCATCTTACGGATGGCATGACAGTAAGAGAATTATGCAGTGCTGCCATAACCATGAGTGATAACACTGCGGCCAACTTACTTCTGACAACGATCGGAGGACCGAAGGAGCTAACCGCTTTTTTGCACAACATGGGGGATCATGTAACCCGCCTTGATCGTTGGGAACCGGAGCTGAATGAAGCCATACCAAACGACGAGCGTGACACCACGATGCCTGCAGCAATGGCAACAACGTTGCGCAAACTATTAACTGGCGAACTACTTACTCTAGCTTCCCGGCAACAATTAATAGACTGGATGGAGGCGGATAAAGTTGCAGGACCACTTCTGCGCTCGGCCCTTCCGGCTGGCTGGTTTATTGCTGATAAATCTGGAGCCGGTGAGCGTGGATCTCGCGGTATCATTGCAGCACTGGGGCCAGATGGTAAGCCCTCCCGTATCGTAGTTATCTACACGACGGGGAGTCAGGCAACTATGGA
gb|HQ877615|+|0-861|ARO:3001159|SHV-110 [Klebsiella pneumoniae] 	0	806	16	822	861	1612535+	806	ATGCGTTATATTCGCCTGTGTATTATCACCCTGTGAGCCACCCTGCCGCTGGCGGTACACGCCAGCCCGCAGCCGCTTGAGCAAATTAAACAAAGCGAAAGCCAGCTGTCGGGCCGCGTAGGCATGATAGAAATGGATCTGGCCAGCGGCCGCACGCTGACCGCCTGGCGCGCCGATGAACGCTTTCCCATGATGAGCACCTTTAAAGTAGTGCTCTGCGGCGCAGTGCTGGCGCGGGTGGATGCCGGTGACGAACAGCTGGAGCGAAAGATCCACTATCGCCAGCAGGATCTGGTGGACTACTCGCCGGTCAGCGAAAAACACCTTGCCGACGGCATGACGGTCGGCGAACTCTGCGCCGCCGCCATTACCATGAGCGATAACAGCGCCGCCAATCTGCTGCTGGCCACCGTCGGCGGCCCCGCAGGATTGACTGCCTTTTTGCGCCAGATCGGCGACAACGTCACCCGCCTTGACCGCTGGGAAACGGAACTGAATGAGGCGCTTCCCGGCGACGCCCGCGACACCACTACCCCGGCCAGCATGGCCGCGACCCTGCGCAAGCTGCTGACCAGCCAGCGTCTGAGCGCCCGTTCGCAACGGCAGCTGCTGCAGTGGATGGTGGACGATCGGGTCGCCGGACCGTTGATCCGCTCCGTGCTGCCGGCGGGCTGGTTTATCGCCGATAAGACCGGAGCTAGCAAGCGGGGTGCGCGCGGGATTGTCGCCCTGCTTGGCCCGAATAACAAAGCAGAGCGCATTGTGGTGATTTATCTGCGGGATACGCCGGCGAGCATGGCCGAGCG
gb|AE004091.2|+|3451505-3452801|ARO:3005064|cprS [Pseudomonas aeruginosa PAO1] 	0	1241	670	1911	1296	226213+	1241	ATGAAACGCGGCCTGAGCCTGATCCCCATCGTCGGTGGCGGCGTCAGCCTGATCCTCGCCGGGGTGCTGCTGGTCTACACGCGCATGCTCGGCGACTACGGCGAGACCGGCGCCCTCTACCTGCTCAGCATGATGATGGAAGAGGAAGGGCTGTACTTCGCCCAGCGCTACCAGGAAGACCCGGCTACGCCGGCGCCGGACAGCTACTACTTCAAGGGCAGCGTCGGCACCGCGGGGCTGCCGCCGAAACTCAGGGAGATGCTCGACACCCCCCCCTACAAGAGCATCGGCGCCATGCAACTGCTCGGCAACTGGGACGACGATGACGAAGAGGAGGATGACGACGCGCCCAGCGACGATGCCTACGTGGTAGTCCGCCAGCCACTGGCCGACGGCAAGACGCTCTACCTCTACGACAACGACGCCGCCGGCAGCATCGACACGCCGTTGTCCGACGCCATCATCGATGCCCGCGTCAGGCAGACCTGGATCGTCACCCTATCGGTCACCCTGCCTTCGCTGGCCGCCGTCGGCCTGCTGGTCTGGTTCATCGTCGCGCCGTTGCGCAAGCTGACGCGCTGGTCGATGACCCTCGACGACCTCGCCCCGGACAGCCAGCGGCCGCGCTTCAACTACCGCGAACTCAACGTGCTGGCGGATACCCTGTGGAACAGCGTGACCCGGATCAAGGACTTCAGCCAGCGCGAGGAGCGCTTCCTGCGCTACGCCAGCCATGAGCTGCGCACCCCGCTGGCGGTGATCGGCATGAACCTGGAGTTGCTCGACCAACCCGGCCGCGCGCCCTCCCCGCATGCCTTGCAACGCATCCGCCGCTCGGCGCTGGGCATGCAGCAGATGACCGAGACCCTGCTCTGGCTCAGCCGCGAGAGCGGCGAACTGCGCGACGACGGACACATCGAGGTCGGTCGCCTGCTGGAGGAGCTGCTCGAGGAACAGCAGGCGCTGAGCCAGCGCCGCGGCCTGACCTTCCACCTCGACGTGGAGCCACACAGCCTGCCGCAGACCCGCGCACGGATCATCATCGGCAACCTGCTGCGCAACGCCCTGCAGTACAGCGACGAGGGCGTGGTGGAAATCGTCGTGCGCGACCGCAGCCTGCTGATCAGCAACCCCATTGGTGCGGCCCAGGGCACGGACGAGTCGATGGCGTTCGGTTATGGCCTGGGCCTCGACCTGGTCCAGCGCCTATGCCAGAAGAGCGGCTGGCGCCTGCATTACAG
gb|KP050492|+|0-861|ARO:3001392|TEM-215 [Escherichia coli] 	0	806	46	852	861	3478183-	806	ATGAGTATTCAACATTTCCGTGTCGCCCTTATTCCCTTTTTTGCGGCATTTTGCCTTCCTGTTTTTGCTCACCCAGAAACGCTGGTGAAAGTAAAAGATGCTGAAGATCAGTTGGGTGCACGAGTGGGTTACATCGAGCTGGATCTCAACAGCGGTAAGATCCTTGAGAGTTTTCGCCCCGAAGAACGTTTTCCAATGATGAGCACTTTTAAAGTTCTGCTATGTGGTGCGGTATTATCCCGTGTTGACGCCGGGCAAGAGCAACTCGGTCGCCGCATACACTATTCTCAGAATGACTTGGTTGAGTACTCACCAGTCACAGAAAAGCATCTTACGGATGGCATGACAGTAAGAGAATTATGCAGTGCTGCCATAACCATGAGTGATAACACTGCGGCCAACTTACTTCTGACAACGATCGGAGGACCGAAGGAGCTAACCGCTTTTTTGCACAACATGGGGGATCATGTAACCCGCCTTGATCGTTGGGAACCGGAGCTGAATGAAGCCATACCAAACGACGAGCGTGACACCACGATGCCTGCAGCAATGGCAACAACGTTGCGCAAACTATTAACTGGCGAACTACTTACTCTAGCTTCCCGGCAACAATTAATAGACTGGATGGAGGCGGATAAAGTTGCAGGACCACTTCTGCGCTCGGCCCTTCCGGCTGGCTGGTTTATTGCTGATAAATCTGGAGCCGGTGAGCGTGGATCTCGCGGTATCATTGCAGCACTGGGGCCAGATGGTAAGCCCTCCCGTATCGTAGTTATCTACACGACGGGGAGTCAGGCAACTATGGA
gb|CP000813.4|-|2349398-2350187|ARO:3004759|BPU-1 [Bacillus pumilus SAFR-032] 	0	734	15235	15969	789	1848066-	734	TTGAAGAAAAAGTATATAAAATGGCTGTTTTCTAGCATCATGCTGATGGCACTTTGTATCAGCCAGCCTTCATCAACTGAAGCAAGATCACCAGCGTGGTCAGTAGATGAATTCTTTAAAAATCGGGAAGGCACGTTTGTGATTCAAGAAGTAAAAGAAAAGTCACCTTGAGTGTATAACAAAAAAAGAGCGAAAGAGCGCTTTGCACCTCAATCGACATTTAAGGTAACAAATGCCTTAATCGGACTCCAAACGGGCGCAGTGAGAGATGAATATGACATCAAATATTGGGATGGAGTAAAAAGAGAGATTGAGAGCTGGAACAGGGATCATACATTAGGATCTGGGATGAGAGATTCAGTCGTCTGGTACTATCAAGCCATGGCGCGTGACATTGGAGAAGAACGCATGAATCATTGGGTGAAAGCCATTCATTATGGGAACAAAGACATATCTGGCGGAATCGATCAATTTTGGTTAAGCAGTACCCTGCGAATTTCTCCAATCGAACAAGTTCGTTTCCTCAAACAGCTATATGAAGAGACTCTTCCATTTGACCTAACTGTCATAAGAACAGTCAAACGAATGATGGTACAAGAAGAAGAGAAACACGCCACCCTATACGGAAAAACAGGCTCGGGATCAGGTATCGGCTGGTACGTAGGCTTTATCAAACATGAAAATAAAACCTACATTTTCGCCACAAATATCGAAGGCACCGGCATAGAAGCAAA
gb|KF944358|+|0-861|ARO:3001393|TEM-216 [Escherichia coli] 	0	806	46	852	861	3478183-	806	ATGAGTATTCAACATTTCCGTGTCGCCCTTATTCCCTTTTTTGCGGCATTTTGCCTTCCTGTTTTTGCTCACCCAGAAACGCTGGTGAAAGTAAAAGATGCTGAAGATCAGTTGGGTGCACGAGTGGGTTACATCGAGCTGGATCTCAACAGCGGTAAGATCCTTGAGAGTTTTCGCCCCGAAGAACGTTTTCCAATGATGAGCACTTTTAAAGTTCTGCTATGTGGTGCGGTATTATCCCGTGTTGACGCCGGGCAAGAGCAACTCGGTCGCCGCATACACTATTCTCAGAATGACTTGGTTGAGTACTCACCAGTCACAGAAAAGCATCTTACGGATGGCATGACAGTAAGAGAATTATGCAGTGCTGCCATAACCATGAGTGATAACACTGCGGCCAACTTACTTCTGACAACGATCGGAGGACCGAAGGAGCTAACCGCTTTTTTGCACAACATGGGGGATCATGTAACCCGCCTTGATCGTTGGGAACCGGAGCTGAATGAAGCCATACCAAACGACGAGCGTGACACCACGATGCCTGCAGCAATGGCAACAACGTTGCGCAAACTATTAACTGGCGAACTACTTACTCTAGCTTCCCGGCAACAATTAATAGACTGGATGGAGGCGGATAAAGTTGCAGGACCACTTCTGCGCTCGGCCCTTCCGGCTGGCTGGTTTATTGCTGATAAATCTGGAGCCGGTGAGCGTGGATCTCGCGGTATCATTGCAGCACTGGGGCCAGATGGTAAGCCCTCCCGTATCGTAGTTATCTACACGACGGGGAGTCAGGCAACTATGGA
gb|AB200915.1|-|1831-2305|ARO:3005084|dfrA31 [Vibrio cholerae O1] 	0	419	7	426	474	54829473-	419	ATGAAAATATCCATTATGGCAGCAGTTTCTGAGAATGGAGTAATTGGCTCTGGATTGGATATACCTTGGCATGTACAAGGTGAGCAGCTCCTGTTCAAAGCTATGACTTACAATCATTGGCTTTTAGTCGGTCGTAAAACTGTCGACTCAATGGGTAAACTTCCCAATAGGAAATATGCTGTGGTTACTCGCTCAGAAATGGTCTCGAATGATCCAGATGTTATTTATTTCACCAGCATTGAATCGGCATTATCTTACTTAGACAATACGACAACACATGTCTTTGTTTCTGGTGGTGGTGAAATTTACAAAGCATTAATCGAACAAGCAGATGTTATCCATCTTTCAGTGATTCATAAGCACATCTCTGGCGACGTGTTTTTCCCTTCAGTTCCACAGAGTTTCAAACAAACATTTGA
gb|AB372881|+|8-869|ARO:3001160|SHV-111 [Klebsiella pneumoniae] 	0	806	16	822	861	1612535+	806	ATGCGTTATATTCGCCTGTGTATTATCACCCTGTGAGCCACCCTGCCGCTGGCGGTACACGCCAGCCCGCAGCCGCTTGAGCAAATTAAACAAAGCGAAAGCCAGCTGTCGGGCCGCGTAGGCATGATAGAAATGGATCTGGCCAGCGGCCGCACGCTGACCGCCTGGCGCGCCGATGAACGCTTTCCCATGATGAGCACCTTTAAAGTAGTGCTCTGCGGCGCAGTGCTGGCGCGGGTGGATGCCGGTGACGAACAGCTGGAGCGAAAGATCCACTATCGCCAGCAGGATCTGGTGGACTACTCGCCGGTCAGCGAAAAACACCTTGCCGACGGCATGACGGTCGGCGAACTCTGCGCCGCCGCCATTACCATGAGCGATAACAGCGCCGCCAATCTGCTGCTGGCCACCGTCGGCGGCCCCGCAGGATTGACTGCCTTTTTGCGCCAGATCGGCGACAACGTCACCCGCCTTGACCGCTGGGAAACGGAACTGAATGAGGCGCTTCCCGGCGACGCCCGCGACACCACTACCCCGGCCAGCATGGCCGCGACCCTGCGCAAGCTGCTGACCAGCCAGCGTCTGAGCGCCCGTTCGCAACGGCAGCTGCTGCAGTGGATGGTGGACGATCGGGTCGCCGGACCGTTGATCCGCTCCGTGCTGCCGGCGGGCTGGTTTATCGCCGATAAGACCGGAGCTAGCAAGCGGGGTGCGCGCGGGATTGTCGCCCTGCTTGGCCCGAATAACAAAGCAGAGCGCATTGTGGTGATTTATCTGCGGGATACGCCGGCGAGCATGGCCGAGCG
gb|HG934763|+|0-861|ARO:3001394|TEM-217 [Enterobacter cloacae] 	0	806	46	852	861	3478183-	806	ATGAGTATTCAACATTTCCGTGTCGCCCTTATTCCCTTTTTTGCGGCATTTTGCCTTCCTGTTTTTGCTCACCCAGAAACGCTGGTGAAAGTAAAAGATGCTGAAGATCAGTTGGGTGCACGAGTGGGTTACATCGAGCTGGATCTCAACAGCGGTAAGATCCTTGAGAGTTTTCGCCCCGAAGAACGTTTTCCAATGATGAGCACTTTTAAAGTTCTGCTATGTGGTGCGGTATTATCCCGTGTTGACGCCGGGCAAGAGCAACTCGGTCGCCGCATACACTATTCTCAGAATGACTTGGTTGAGTACTCACCAGTCACAGAAAAGCATCTTACGGATGGCATGACAGTAAGAGAATTATGCAGTGCTGCCATAACCATGAGTGATAACACTGCGGCCAACTTACTTCTGACAACGATCGGAGGACCGAAGGAGCTAACCGCTTTTTTGCACAACATGGGGGATCATGTAACCCGCCTTGATCGTTGGGAACCGGAGCTGAATGAAGCCATACCAAACGACGAGCGTGACACCACGATGCCTGCAGCAATGGCAACAACGTTGCGCAAACTATTAACTGGCGAACTACTTACTCTAGCTTCCCGGCAACAATTAATAGACTGGATGGAGGCGGATAAAGTTGCAGGACCACTTCTGCGCTCGGCCCTTCCGGCTGGCTGGTTTATTGCTGATAAATCTGGAGCCGGTGAGCGTGGATCTCGCGGTATCATTGCAGCACTGGGGCCAGATGGTAAGCCCTCCCGTATCGTAGTTATCTACACGACGGGGAGTCAGGCAACTATGGA
gb|FJ905898.1|+|328-802|ARO:3004547|dfrA6 [Vibrio cholerae] 	0	419	7	426	474	54829473-	419	ATGAAAATATCCATTATGGCAGCAGTTTCTGAGAATGGAGTAATTGGCTCTGGATTGGATATACCTTGGCATGTACAAGGTGAGCAGCTCCTGTTCAAAGCTATGACTTACAATCATTGGCTTTTAGTCGGTCGTAAAACTGTCGACTCAATGGGTAAACTTCCCAATAGGAAATATGCTGTGGTTACTCGCTCAGAAATGGTCTCGAATGATCCAGATGTTATTTATTTCACCAGCATTGAATCGGCATTATCTTACTTAGACAATACGACAACACATGTCTTTGTTTCTGGTGGTGGTGAAATTTACAAAGCATTAATCGAACAAGCAGATGTTATCCATCTTTCAGTGATTCATAAGCACATCTCTGGCGACGTGTTTTTCCCTTCAGTTCCACAGAGTTTCAAACAAACATTTGA
gb|K00544|+|0-663|ARO:3002672|Bacillus_pumilus_cat86 [Bacillus pumilus] 	1	608	2119	2726	663	1262438-	607	TGTTTAAACAAATAGACGAAAATTATCCGCGAAAAGAGCACTTTCACCATTATATGACGTTAACCCGATGCTCATATAGCTTGGTGATCAATCTAGACATCACGACATTGCATGCAATATTAAAAGAAAAAAAGCTAAAAGTATATCCTGTGCAAATTTATTTGTTAGCAAGAGCTGTGCAAAAAATACCGGAGTTTCGGATGGATCAAGTGAACGATGAACTGGGTTACTGGGAGATTCTCCATCCTAGTTATACGATTCTAAATAAAGAAACAAAGACATTTTCAAGTATTTGGACGCCTTATGACGAAAACTTTGCTCAGTTTTATAAAAGCTGTGTAACCGACATTGAAACATTTAGCAAAAGCAGCAACCTATTTCCGAAACCTCATATGCCAGAAAACATGTTCAATATTTCAAGTCTACCGTGGATTGATTTTACTTCTTTTAACCTTAATGTATCTACAGACGAAACTTATTTACTGCCAATATTTACGTTAGGTCAATTTAAGGCGAAAGAAGAAAAAATCATCCTGCCCGTCGCCATACAAGTACATCATGCAGTTTGTGATGGCTATCATGCCGGTCAATATGTTGAATATTTGAG
gb|KJ776406|+|16-877|ARO:3001340|SHV-119 [Klebsiella pneumoniae] 	0	806	16	822	861	1612535+	806	ATGCGTTATATTCGCCTGTGTATTATCACCCTGTGAGCCACCCTGCCGCTGGCGGTACACGCCAGCCCGCAGCCGCTTGAGCAAATTAAACAAAGCGAAAGCCAGCTGTCGGGCCGCGTAGGCATGATAGAAATGGATCTGGCCAGCGGCCGCACGCTGACCGCCTGGCGCGCCGATGAACGCTTTCCCATGATGAGCACCTTTAAAGTAGTGCTCTGCGGCGCAGTGCTGGCGCGGGTGGATGCCGGTGACGAACAGCTGGAGCGAAAGATCCACTATCGCCAGCAGGATCTGGTGGACTACTCGCCGGTCAGCGAAAAACACCTTGCCGACGGCATGACGGTCGGCGAACTCTGCGCCGCCGCCATTACCATGAGCGATAACAGCGCCGCCAATCTGCTGCTGGCCACCGTCGGCGGCCCCGCAGGATTGACTGCCTTTTTGCGCCAGATCGGCGACAACGTCACCCGCCTTGACCGCTGGGAAACGGAACTGAATGAGGCGCTTCCCGGCGACGCCCGCGACACCACTACCCCGGCCAGCATGGCCGCGACCCTGCGCAAGCTGCTGACCAGCCAGCGTCTGAGCGCCCGTTCGCAACGGCAGCTGCTGCAGTGGATGGTGGACGATCGGGTCGCCGGACCGTTGATCCGCTCCGTGCTGCCGGCGGGCTGGTTTATCGCCGATAAGACCGGAGCTAGCAAGCGGGGTGCGCGCGGGATTGTCGCCCTGCTTGGCCCGAATAACAAAGCAGAGCGCATTGTGGTGATTTATCTGCGGGATACGCCGGCGAGCATGGCCGAGCG
gb|AJ920369|+|23-860|ARO:3001071|SHV-12 [Escherichia coli] 	0	782	16	798	837	1612535+	782	ATGCGTTATATTCGCCTGTGTATTATCACCCTGTGAGCCACCCTGCCGCTGGCGGTACACGCCAGCCCGCAGCCGCTTGAGCAAATTAAACAAAGCGAAAGCCAGCTGTCGGGCCGCGTAGGCATGATAGAAATGGATCTGGCCAGCGGCCGCACGCTGACCGCCTGGCGCGCCGATGAACGCTTTCCCATGATGAGCACCTTTAAAGTAGTGCTCTGCGGCGCAGTGCTGGCGCGGGTGGATGCCGGTGACGAACAGCTGGAGCGAAAGATCCACTATCGCCAGCAGGATCTGGTGGACTACTCGCCGGTCAGCGAAAAACACCTTGCCGACGGCATGACGGTCGGCGAACTCTGCGCCGCCGCCATTACCATGAGCGATAACAGCGCCGCCAATCTGCTGCTGGCCACCGTCGGCGGCCCCGCAGGATTGACTGCCTTTTTGCGCCAGATCGGCGACAACGTCACCCGCCTTGACCGCTGGGAAACGGAACTGAATGAGGCGCTTCCCGGCGACGCCCGCGACACCACTACCCCGGCCAGCATGGCCGCGACCCTGCGCAAGCTGCTGACCAGCCAGCGTCTGAGCGCCCGTTCGCAACGGCAGCTGCTGCAGTGGATGGTGGACGATCGGGTCGCCGGACCGTTGATCCGCTCCGTGCTGCCGGCGGGCTGGTTTATCGCCGATAAGACCGGAGCTAGCAAGCGGGGTGCGCGCGGGATTGTCGCCCTGCTTGGCCCGAATAACAAAGCAGAGCGCATTGTGGTGATTTATCTGCGGGA
gb|AP009048|-|4338624-4340268|ARO:3003576|eptA [Escherichia coli str. K-12 substr. W3110] 	0	1589	7278	8867	1644	268608-	1589	ATGTTGAAGCGCCTACTAAAAAGACCCTCTTTGAATTTACTCGCCTGGCTATTGTTGGCCGCTTTTTATATCTCTATCTGCCTGAATATTGCCTTTTTTAAACAGGTGTTGCAGGCGCTGCCGCTGGATTCGCTGCATAACGTACTGGTTTTCTTGTCGATGCCGGTCGTCGCTTTCAGCGTGATTAATATTGTCCTGACACTAAGCTCTTTCTTATGGCTTAATCGACCACTGGCCTGCCTGTTTATTCTGGTTGGCGCGGCTGCACAATATTTCATAATGACTTACGGCATCGTCATCGACCGCTCGATGATTGCCAATATTATTGATACCACTCCGGCAGAAAGTTATGCGCTGATGACACCGCAAATGTTATTAACGCTGGGATTCAGCGGCGTGCTTGCTGCGCTGATTGCCTGCTGGATAAAAATCAAACCTGCCACCTCGCGTCTGCGCAGTGTTCTTTTCCGTGGAGCCAATATTCTGGTTTCTGTACTACTGATTTTGCTGGTCGCCGCACTGTTTTATAAAGACTACGCCTCGTTGTTCCGCAATAACAAAGAGCTGGTGAAATCCTTAAGCCCCTCTAACAGCATTGTTGCCAGCTGGTCATGGTACTCCCATCAGCGACTGGCAAATCTACCGCTGGTGCGAATTGGTGAAGACGCCCACCGCAACCCGTTAATGCAGAACGAAAAACGTAAAAATTTGACCATCCTGATTGTCGGCGAAACCTCGCGGGCGGAGAACTTCTCCCTCAACGGCTACCCGCGTGAAACTAACCCGCGGCTGGCGAAAGATAACGTGGTCTATTTCCCTAATACCGTATCTTGCGGCACGGCAACGGCAGTTTCAGTACCGTGCATGTTCTCGGATATGCCGCGTGAGCATTACAAAGAAGAGCTGGCACAGCACCAGGAAGGCGTGCTGGATATCATTCAGCGAGCGGGCATCAACGTGCTGTGGAATGACAACGATGGCGGCTGTAAAGGTGCCTGCGACCGCGTGCCTCACCAGAACGTCACCGCGCTGAATCTGCCTGGTCAGTGCATCAACGGCGAATGCTATGACGAAGTGCTGTTCCACGGGCTGGAAGAGTACATCAATAACCTGCAGGGTGATGGCGTGATTGTCTTACACACCATCGGCAGCCACGGTCCGACCTATTACAACCGCTATCCGCCGCAGTTCAGGAAATTTACCCCAACCTGCGACACCAATGAGATCCAGACCTGTACCAAAGAGCAACTGGTGAACACTTACGACAACACGCTGGTTTACGTCGACTATATTGTTGATAAAGCGATTAATCTGCTGAAAGAACATCAGGATAAATTTACCACCAGCCTGGTTTATCTTTCTGACCACGGTGAATCGTTAGGTGAAAATGGCATCTATCTGCACGGTCTGCCTTATGCCATCGCCCCGGATAGCCAAAAACAGGTGCCGATGCTGCTGTGGCTGTCGGAGGATTATCAAAAACGGTATCAGGTTGACCAGAACTGCCTGCAAAAACAGGCGCAAACGCAACACTATTCACAAGACAATTTATTCTCCACGCTATTGGGATTAACTGGCGTTGAGACGAA
gb|FO203501.1|+|5123640-5125365|ARO:3005047|eptB [Klebsiella pneumoniae subsp. rhinoscleromatis SB3432] 	0,1133	1185,1670	7394,0	8579,537	1725	1604265-;54335162-	1185;537	GTGCCACAGCGTCAGGCGGTGTTTTATTCTTCTTTTTCCAGGTTTGCTTGCATGAAATATATTAGAACGATGACGCAGCAGAAGCTTAGTTTTTGGCTGGCGCTGTACATCGGCTGGTTTATGAACGTCGCCGTTTTTTTCCGGCGTTTCGATGGTTATGCTCAAGAGTTCACTTTCTGGAAAGGGCTTTCCGGTGTTGTTGAACTGGTTGCCACGGTATTTGTCACCTTCTTCCTGTTACGTCTTCTGTCGCTGTTCGGCCGCCGTATCTGGCGCATTCTGGCGACGCTGATTGTCCTGTTTTCCGCCGCGGCGAGTTACTACATGACGTTCCTCAATGTGGTGATTGGCTACGGGATCATCGCTTCGGTGATGACCACCGATATCGACCTGTCGAAAGAGGTCATCGGCTGGCACCTGATCCTCTGGCTGGTGGCGGTGAGCGCGCCGCCGTTGCTGTTCATCTGGAGCAACCGCTGCCGCCATACGCTGCTGCGCCAGCTGCGCACCCCGGGCCAGCGGGTTAAAAACGTGCTGATCGTGGTGCTGGCCGGACTGATTGTCTGGGGACCCATCCGCCTGCTAGAGCTGCGCCAGCATGATGTGGAGCGCCATTCGGAAGTGGATATGCCGAGCTATGGCGGGGTGATCGCCAACTCTTACCTGCCGTCGAACTGGTTGTCGGCGCTGGGTCTGTACGCCTGGGCGCAGGTGGATGAATCCTCAGACAACAAATCGCTGATTAACCCGGCGAAGAAGTTCACCTACGTCGCGCCGGAAGGTCTGGATGATACCTACGTGGTGTTTATCATTGGCGAAACGACCCGCTGGGACCATATGGGCATCCTCGGCTATAGCCGCAATACCACGCCAGAGCTGGAGAAAGAGAAGAATCTCGTCGCCTTCCGCGGTTACTCGTGCGATACCGCTACCAAACTGTCGTGACGCTGCATGTTTGTGCGCGAGGGCGGGGCGGAAGATAACCCACAGCGGACGCTCAAAGAGCAGAATGTCTTTGCCGTGCTGCATCAGCTGGGCTTCAGCGGCAATCTGTACGCCATGCAGAGCGAGATGTGGTTCTACAGCAACACGATGGCCAACAATATCGCCTACCGCGAGCAGATTGGCGCCGAGCCGCGCAACCGCGGTAAGAGCGTTGACGATATGCTGCTGGTGGATGAGATG;GCCGCGCAACCGCGGTAAGAGCGTTGACGATATGCTGCTGGTGGCTGAGATGAAGCGCGGTATGGCGCAGGGCAACGCCTCCGGTAAGCATCTGATCATTCTCCACACCAAAGGCTCCCACTTTAACTACACCCAACGCTACCCGCGCAGCTTCGCCCAGTGGAAACCGGAGTGCGTCGGCGTCGACAACAAGTGCTCGAAAGCGGAACTGATCAATTCCTACGACAATAGCGTGACCTATGTCGATCACTTTATCGTCAGCGTCCTCGACCAGCTGCGGGATAAGAAAGCGATTGTGTTCTATGCCGCCGACCACGGGGAGTCGATTAACGAGCGTGAACACCTGCACGGTACGCCGCGCAAGATGGCGCCGCCGGAGCAGTTCCGCGTGCCGATGATGGTGTGGATGTCGGATAAGTACCTGGAAAATCCCGATCACGCCGCCGCGTTTGCCCATCTGCAGCAGCAGGCTGCGATGAAGGTGCCGCGCCGTCACGTCGAGCTGTACGACACCATTATGGGCTGCCTCGGCTATAC
gb|AE004091.2|+|1221690-1222098|ARO:3000149|fosA [Pseudomonas aeruginosa PAO1] 	0	353	25069	25422	408	234408+	353	ATGCTTACCGGTCTCAATCACCTGACCCTGGCGGTCGCCGACCTGCCGGCCAGCATCGCCTTCTACCGCGATCTTCTCGGCTTTCGCCTGGAAGCGCGCTGGGACCAGGGCGCCTATCTCGAACTGGGTTCGCTGTGGCTGTGCCTGTCCCGGGAGCCGCAGTACGGCGGGCCGGCCGCGGACTACACGCACTACGCCTTCGGCATCGCCGCCGCGGACTTCGCCCGCTTCGCCGCGCAGCTGCGCGCGCATGGCGTGCGCGAATGGAAGCAGAACCGCAGCGAGGGCGATTCGTTCTACTTCCTCGACCCGGACGGCCATCGCCTGGAGGCCCACGTCGGCGACCTGCGCAG
gb|AL009126|+|916777-919348|ARO:3003324|Bacillus_subtilis_mprF [Bacillus subtilis subsp. subtilis str. 168] 	579,1193,1407,1860	792,1414,1853,2516	0,0,0,0	213,221,446,656	2571	1396557+;55171538-;833946-;1508585+	213;221;446;656	GCGGATAAAGTGAAAAATCCGATTTTCGCATATATTGGAGCTTCAGTTGTTGAATGGCTCATGGCCGGGAACGTCATCTATTTTGCTTTGTTCGCTATGGGCATTCATGCAGATATCAGGTATGTTTTCGGGGTGTTCGTCATTGCGGCGATCGGAGGAATGATCAGCCTCGTGCCGGGCGGCTTCGGCTCGTTTGACCTTTTATTTTTGCTG;TAAACGGACAAAACGTTCCTATACGATGGCCATTACAGCGCTTGTCGGCGGCTTTGTGTTCAGCTTTTTAAAAGGGCTTAACATCAGCGCGATATTCGTACTGCCGATGATTATCGTATTGCTTGTGCTATTGAAAAAACAATTTGTCCGCGAACAGGCATCCTATACACTGGGACAATTGATATTCGCTGTGGCGCTGTTTACTGTGGCGCTCTTTAACT;TTTAACTACAATCTGATCGCGGGCTTTATTTGGGACCGGATGAAGAAGGTGCTGCGTCACGAATATTTCGTCCACAGCACCTCGCATATTACACATGCAACCATCATGGCGATCATTATTGTGCCGCTGTTCTTCTTGATATTTACAGTGGTCTATCATAAGAGAACGAAACCGATCGGAGAGAAAGCTGACCCTGAGCGTCTTGCTGCGTTTCTCAATGAAAAAGGCGGCAACGCGCTGAGCCATCTTGGTTTTCTTGGAGATAAGCGGTTTTATTTTTCTAGTGATGGGAATGCACTGCTTCTGTTTGGGAAAATCGCCAGAAGGCTGGTCGTGCTCGGCGATCCGTCTGGCCAAAGAGAATCATTCCCGCTCGTGCTGGAAGAATTTCTGAACGAAGCGCATCAGAAGGGATTCAGTGTTTTGTTCTATCAAATTGAACGAGA;GCGCTGTATCATGATTTTGGCTACAACTTCTTTAAATTGGGCGAGGAAGCATATGTAGATTTAAATACATTTACCTTGACTGGGAAGAAAAAAGCCGGCCTTCGGGCAATCAATAACCGCTTTGAGCGGGAGGAGTATACTTTCCATGTGGATCATCCCCCATTTTCTGATGCGTTTTTGGAGGAGCTGAAGCAAATCTCAGACGAATGGCTCGGCTCGAAAAAAGAGAAGGGATTCTCGCTCGGATTTTTTGATCCTTCTTATTTACAGAAAGCGCCGATCGCCTATATGAAAAATGCAGAAGGAGAGATCGTTGCATTCGCAAATGTCATGCCGATGTACCAGGAAGGAGAGATATCGGTTGATCTGATGCGCTATCGCGGCGACGCTCCAAATGGCATTATGGACGCATTGTTTATCCGTATGTTTTTATGGGCAAAGGAAGAGGGCTGCACGTCATTTAATATGGGGATGGCACCCTTGGCTAATGTCGGCACTGCCTTTACATCCTTCTGGTCCGAAAGGTTTGCCGCTGTCATTTTTAATAATGTCAGATACATGTACAGCTTCAGCGGCCTAAGAGCCTTTAAAGAAAAATACAAACCGGAGTGGCGAGGGAAATACTTAGCGTATCGGAAAAACAGATCTCTTTCTGT
gb|U00096.3|-|721055-721733|ARO:3003841|kdpE [Escherichia coli str. K-12 substr. MG1655] 	0	623	6263	6886	678	239041-	623	GTGACAAACGTTCTGATTGTTGAAGATGAACAGGCTATTCGTCGCTTTCTGCGCACGGCGCTGGAGGGCGACGGGATGCGCGTCTATGAGGCCGAAACGCTGCAACGCGGCTTGCTGGAAGCGGCTACCCGTAAGCCAGATTTGATTATTCTCGATCTCGGCCTGCCCGATGGTGATGGGATTGAGTTTATCCGCGACCTGCGCCAGTGGAGCGCGGTGCCGGTGATTGTGCTTTCCGCACGCAGCGAAGAGAGCGACAAAATCGCCGCGCTGGATGCCGGAGCGGATGATTATCTGAGTAAGCCGTTTGGCATTGGCGAATTGCAGGCCCGTCTGCGCGTCGCTTTACGCCGCCACTCCGCTACCGCCGCGCCCGATCCGCTGGTGAAATTTTCCGATGTTACCGTCGATTTAGCCGCCCGCGTGATTCACCGGGGTGAGGAAGAGGTGCATCTCACACCAATTGAGTTCCACCTGCTGGCGGTGCTGCTCAACAATGCCGGAAAAGTACTCACCCAGCGCCAGCTCCTTAACCAGGTGTGGGGGCCAAACGCGGTCGAACACAGTCACTATTTGCGTATTTATATGGGACATCTGCGACAAAAACTGGAACAGGATCCCGC
gb|AY453162|+|500-1271|ARO:3004189|Bla2 [Bacillus anthracis] 	0	716	1446	2162	771	226465-	716	ATGAAAAATACATTATTAAAATTAGGGGTATGTGTTAGTTTACTAGGAATAACTCCATTTGTTAGTACAATTTCTTCTGTACAAGCAGAACGAAAGGTAGAGCATAAAGTAATAAAAAATGAGACAGGAACTATTTCAATTTCTCAGTTAAACAAAAATGTTTGGGTTCATACGGAGTTAGGTTATTTTAACGGAGAAGCAGTTCCTTCGAACGGTTTAATCCTTAATACTTCTAAAGGATTAGTACTTGTCGATTCTTCTTGGGATGATAAGTTAACGAAGGAATTAATAGAGATGGCAGAAAAGAAATTTAAGAAGAGTGTAACGGATGTTATTATTACACATGCACACGCTGATCGGATTGGTGGAATAAAAACGTTGAAAGAAAGAGGCATTAAAGCGCATAGTACAACGTTAACTGCGGAACTAGCAAAGAAAAATGGATATGAAGAACCACTTGGAGACTTACAAGCAATTACGAAATTGAAGTTTGGAAATATGAAAGTAGAAACGTTTTATCCAGGGAAAGGACATACAGAAGATAATATCGTCGTATGGTTACCACAATACAACATGTTAGTTGGAGGCTGTTTAGTGAAGTCTGCGTCCGCGAAAGATTTAGGAAATATTACTGATGCTTATGTAAATGAATGGTCTACATCGATTGAGAATGTGCTGAAGCGATATGAAAATATAAATTTTGTAGTACCTGGTCA
gb|AE014292|+|568280-570923|ARO:3003772|Brucella_suis_mprF [Brucella suis] 	0	2588	29696	32284	2643	3128843-	2588	TTGCTCTGGTGGGACGACATTTCGATGAGCCTGATTGATGATGAAATACCTTCTTCGCAACCGCAAGTGTCAGGTAGGCATTTCGGCTGGTTGAAACAATATCAGCATTTTCTGTTTCCAATCGCAGGCATCGCCATTGCGTTATTGGCTATTTATGATCTGGAAAATCTTCTCAGGCACACCTCCCGCACCGAAACGCTTGCAGCCCTTCACAATATTTCATGGACGACGCTCGCACTGGCCGTCTTTTTCACAGCATTAAGCTATGCCGCAGTGGCGCTTTATGATGTCGTGGCGGTGGACACCATAGCGCCCAACCAGATACCGCGCCGCATCGCGGCGGTGGCGGGTGCTGCGGGCTATGCGATTTCCAACGCGCTCGGCTTCTCGCTCCTGACCGGCGGGGCGCTGCGTTATCGCATTTATGCCGCAGAAGGCATAAGCCTGGCCGATATCGGCAAGATCGTCGGCACCTCATGGTTCGCCATCTGGTTCGCCCTCATCATCATGGTGGGCGCAGCCCTGCTGATCGATCCGCAGGACGTGCCTTTTCTTTCCGCCATCGATATACGGATTGATATTGTCGCAGGCATTCTCATCCTTGGCGGCATTGGCTGGCTGATCTACTGGCTTTCGCATGGCGAACGCAATGTCAGCATCGGTTCGTTCAGCCTGCGCCTGCCCAATTCAAAAGGCGCGCTCACGCAGATTTTTGCGGGCGTGGTGGATGTGGGCGCTGCCGCGGCCACGCTCTATGTGCTGTTGCCGGAAGGGGCTGTGCCAAGCTTCGCCGTCTTTGCGCTCGTTTATGTCATCGCCATCGTGCTTGGCATTGCAAGCCACGCGCCAGGCGGCCTCGGCGCTTTTGAGGCAACAATCATCGCAGGGCTTGGCCTCGGTGGAAAACCCGATGCAATTGCGGGCCTGCTGGCCTATCGCCTCATTTACACGGTTCTTCCCCTCGTGGTTGCCACCGCCGGAATCCTCATCTGGGAGGTCATGCGCCGCCGCCATATGCTCGACAAGCAGGCCCGATTCGCCAAGCGGCTGGTGGAGCCGCTGGTTCCGGGGCTTTCAGCCAGCATCATCTTTCTCGGTGGCATCATCCTGCTTATCTCAGGCGCCACGCCCGATATGCGCTATCGTGTGAAGTTGCTGTCCGACATCGTGCCGGAATTTCTTGTGGAGATGTCGCATCTGGCGGCAAGCCTCGTCGGCGTTGCTCTTCTCATCGTCGCGCGCGGCCTTTCCAAACGGCTGGAGCGCGCCTGGGTGGCCGCGATGGTGCTTCTTCTTTGCGGCGCGGTGTTTTCGATCGCAAAAGGACTGGACTGGGAAGAGGCAAGCATTTTGTGCCTTTTTGCCCTTTCACTCTGGGGCTTTCGCGATTCCTTCTACCGTCGTCCGATTGCCGGCCCGTTTGAACTGAGCTGGAACTGGATCGCAACCGTTGGAACCACGGTTCTCGTGTCCACCTGGCTTGGTTTTTTCGTCTACCGCCATATCGAATATTCAAGCGATCTCTGGTGGGATTTCGCGTGGAACGGCAACGCCCCGCGTTTCCTGCGCGCCACCGTTCTGGTTTTCGCAGTCGTGGCGGCAGTCGGCCTTCATTCGATCATCAACCGGCATGGCCAGCGCAGGCGCAAGGTTGATCATTCCATCCCCGATGCCGTGCCCGCACTCGTCGCCCGGTGCCCGCATACAGATGCAGCCCTTGCCATGCTGGGCGACAAGCAATTTCTGCTGGCGCCCGACGACAGCGCGTTCATCATGTATGCGCAGTCGGGCGGCAGCCTGATCGCGCTTGGCGAGCCTATCGGCGATGCCGAAGCGGGCAAGGAACTTGCCTGGTCTTTCCATTCGCTTGCCGACCGTCTGGCGCTGCGCACTGTCTTCTATGGTGTCGGCCCGCAAAGCCTGCCGCTTTTCCTCGATATGGGCCTGATTGCGCTCAAGCTGGGTGAAGTCGCACGCGTTGACCTGACAGATTTTTCGCTGGAAGGCCCGCGCCGCCAGCCCTTCCGTTATGCCGACCGCAAGGTGGACAAGGATGGGCTGACCTTCGAGATTATCCCTGCTGCGGACGTGCCGCCGCTGATCCCGCGCCTGCGCGCAATTTCCGACGCTTGGCTCGACCATAAATCAGGCAGCGAAAAGGGTTTTTCGCTTGGCTATTTCAACGATGAGTATTTAAAGCGTTTCGATATTGCCGTGCTGAAGAAAGACGGCGAAATCGTTGCTTTCGCCAATATATGGCGCGGTGCCGACAAGTATGAGATCACGGTCGACCTGATGCGCTACATGCCCAATGTGCACAAGCTCCTGATGGATGCGCTGTTCGCCAAGCTGCTGACCTTTTCCAAGCAAGAAGGCTACAAATGGTTTAACCTTGGCGCGGCCCCGCTTTCCGGCCTTAGCGGCAGCAGGCTTGCCTCGCGCTGGAACCGTTTCGGCTCGTTCATCTATCGCCGTGGGGCCGATCTTTATCACTTCGACGGGCTCAAAGTCTTCAAGGAAAAATTCGATCCCGTCTGGACCCCGCATTATATGGTTTGCCCCGGCGGGCTTGAAACGCCGCGCGCCCT
gb|AJ579365.1|+|4149-5628|ARO:3003111|lsaB [Staphylococcus sciuri] 	0	1420	1200	2620	1479	3833997-	1420	ATGTCAATGATACAAGTACAAAATTTAACTTTCTCTTATCCGAGTAGTTTTGATAATATTTTTGAAGATATAAGCTTTCAAATTGATACAGATTGGAAGCTTGGATTTATTGGTCGAAATGGACGAGGGAAAACAACGTTCTTTAATTTATTACTAGGTAAATTTGAATATAAGGGGAAAATCATTTCTTCGGTCGATTTTAACTACTTCCCATATCCAGTAGAAGATAAAAGTAAGTATACGCATGAAATTTTAGAAGAAATATGCCCTCAAGCTGAGGACTGGGAATTTCTTCGAGAAATAGCTTATTTAAATGTGGATGCCGAAGCCATGTACCGCCCATTTGAAACTTTATCAAACGGTGAACAAACAAAGGTATTGCTTGCTGCTCTATTTTTAAACGAAGGGCAATTTTTATTAATTGATGAACCAACAAATCATTTAGATACTGAAGCTCGTAAGATGGTTTCTAATTACTTGAGGAAGAAAAAAGGGTTTATTTTAATTTCTCATGACCGTAACTTTTTAGATGGTTGTGTTGATCATATCTTGTCTATAAATAGAGCAGATATTGAGGTTCAAAGTGGAAATTATTCTTCATGGAAGTTGAACTTTGACCGACAGCAGGAACATGAACAAGCAACAAATGAACGCTTGCAGAAGGATATTGGACGGTTAAATCAATCTTCAAAACGTTCGGCTGGTTGGTCTAACCAAGTCGAAGCTTCAAAAAATGCAACAACGAATTCTGGTTCTAAATTGGACAAAGGTTTTGTAGGGCATAAAGCAGCAAAATTGATGAAACGCTCTAAGAACCTTGAGGCTCGACAACAAAAAGCGATTGAAGAAAAGTCGAAGCTTCTAAAAAACATTGAAAAAACGGAGTCCTTACAGTTAGAATCGATGGAATATAAATCGAAGGAACTCATTCAATTAACAGATGTGTCTGTAATGTATGATGGTCAAGTTGTCAACAAACCAATAAGTTTTAATGTTGAACAAGGAGATAGAATTGTACTGGACGGAAAGAACGGCAGTGGAAAAAGTAGTATTTTAAAATTAATTTTAGGCGATCCAATACAGCATACAGGCACGTCAAATAAGGGTTCTAATCTGATAATTTCTTATGTTCAGCAAGACACCTCTCATTTAAAGGGGATGCTATCTGACTTTATTGAAGAAAATGAGATTGATGAAACGTTGTTTAAGTCCATTTTGAGAAAGATGGATTTTGACCGAATACAGTTTGAAAAAGATATATCTCATTATTCAGGTGGTCAGAAGAAAAAATTGCTTATCGCTAAAAGTTTATGTGAAAAAGCTCACCTGTATATTTGGGATGAACCATTAAACTTTATTGATATTTACTCTCGCATGCAAATTGAAGAGCTTATTCAAACCTTTAATCCGACTATAGTTT
gb|AY152390|+|0-1335|ARO:3003785|Chlamydia_trachomatis_intrinsic_murA_conferring_resistance_to_fosfomycin [Chlamydia trachomatis] 	0	1280	722	2002	1335	223703+	1280	ATGCCTGGTATCAAGGTTTTTGGAGAAACGGTCTTAAGAGGATCTGTGCGCGTGTCAGGAGCTAAAAATGCTACAACTAAATTACTTGTAGCCTCCTTACTTTCGGATCAGCGAACGATTTTAAAGAATGTCCCTAATATTGAAGATGTTCGGCAAACGGTAGATCTTTGTCGGGTTTTAGGGGCGATTGTAGAGTGGGATCAGCAAGCGCAAGTGATTGAAATTCACACTCCGCGCATTTTATTGTCCAAGGTTCCTCCGCAATTTTCTTGTGTTAATCGGATTCCTATTTTGCTGTTAGGAGCGTTGTTACGTCGTTGTCCTTATGGGATTTTTGTTCCTATTTTGGGAGGGGATGCTATAGGACCTCGTACGCTACATTTCCATTTAGAAGGATTGAAGAAGCTTGGAGCAGAGATAGTAATTAGTGATGAAGGCTATTGGGCTTCAGCTCCAAATGGTCTTGTTGGAGCACACATCACGTTACCCTACCCTTCTGTGGGAGCCACAGAAAACCTCATCCTTGCTTCTGTAGGGGCTCAAGGACGAACGATTATTAAGAATGCTGCTCTTGAAGTGGAAATCATTGATTTGATTGTCTTTTTACAGAAAGCAGGCATGGAGATTACAACAGATAATGATAAGACCATCGAAATTTTTGGATGTCAGGATTTCTATTCTGTTGAGCACTCCATTATTCCAGATAAAATCGAGGCTGCTTCTTTCGGTATGGCTGCGGTAGTTTCTCAGGGAAGGATCTTCGTAGAACAAGCGCGCCATGAGCATATGATCCCTTTTTTAAAGGTATTAAGATCGATAGGAGGGGGATTCTCTGTACATGAGAATGGGATCGAATTTTTCTACGATAAGCCTTTGAAAGGGGGAGTTCTTCTAGAAACGGATGTGCATCCAGGGTTTATTACAGATTGGCAACAACCTTTTGCCGTATTGCTCTCTCAGTCAGAAGGTTGTTCGGTGATCCATGAGACAGTGCATGAGAATCGTCTTGGGTATTTGAAAGGTTTGGTAAAAATGGGAGCGCATTGTGATTTATTTCACGAGTGTTTGAGTGCTAAGTCGTGTCGCTATTCTACAGGGAATCATCCTCATAGCGCAGTCATTCATGGTCCGACTCCTTTGCAGGCAACAGACTTAGTGATTCCTGATTTGCGCGCAGGATTTGCTTATGTCATGGCCGCACTCATTGCAGAAGGCGGAGCCTCATGGATTGAGAATACCGAGATGCTGGATCGAGGGTACACTGATTGGCGAGGGAAATT
gb|M36726.1|+|295-1150|ARO:3000596|ErmX [Plasmid pNG2] 	0	800	235	1035	855	3789486-	800	ATGTCTGCATACGGACACGGCCGTCACGAGCATGGCCAAAATTTTCTCACCAACCACAAGATCATCAACTCCATCATCGACCTTGTGAAACAAACCTCCGGCCCCATCATTGAGATCGGACCAGGAAGCGGTGCCCTCACTCACCCGATGGCCCACTTGGGGAGGGCGATAACGGCAGTTGAAGTGGACGCAAAACTAGCTGCCAAAATCACACAAGAAACCTCCTCGGCGGCGGTCGAAGTGGTCCATGATGATTTCCTTAACTTCCGGTTACCCGCCACTCCCTGCGTCATTGTGGGAAACATTCCCTTTCACCTCACCACTGCCATTCTTCGAAAGTTGCTGCATGCGCCAGCATGGACTGACGCTGTACTCCTCATGCAGTGGGAAGTCGCTCGCCGCCGGGCCGGGGTAGGCGCAAGCACGATGATGACGGCTCAGTGGTCCCCATGGTTCACATTTCACCTGGGTTCTCGGGTACCAAGGTCTGCTTTCCGGCCACAGCCAAACGTTGACGGGGGGATCTTAGTGATCCGCCGGGTGGGTGACCCGAAGATTCCGATAGAGCAGCGCAAAGCCTTTCAGGCGATGGTGCACACCGTTTTCACTGCCCGGGGACGCGGGATAGGGGAAATTCTCCGAAGGGCAGGGTTGTTTTCATCACGTTCAGAAACACAATCATGGTTGCGCTCGCGAGGAATCGACCCCGCGACCCTACCTCCCAGATTGCACACCAACGACTGGATCGATCTCTTCCAGGTGACTGGTTCCTCTCTACCTCACCATCGACCCATTTCACC
gb|D16251.1|-|1625-2531|ARO:3000316|mphA [Escherichia coli] 	0,433	380,680	68,0	448,247	906	52755441+;54826655-	380;247	ATGACCGTAGTCACGACCGCCGATACCTCCCAACTGTACGCACTTGCAGCCCGACATGGGCTCAAGCTCCATGGCCCGCTGACTGTCAATGAGCTTGGGCTCGACTATAGGATCGTGATCGCCACCGTCGACGATGGACGTCGGTGGGTGCTGCGCATCCCGCGCCGAGCCGAGGTAAGCGCGAAGGTCGAACCAGAGGCGCGGGTGCTGGCAATGCTCAAGAATCGCCTGCCGTTCGCGGTGCCGGACTGGCGCGTGGCCAACGCCGAGCTCGTTGCCTATCCCATGCTCGAAGACTCGACTGCGATGGTCATCCAGCCTGGTTCGTCCACGCCCGACTGGGTCGTGCCGCAGGACTCGGAGGTCTTCGCGGAGAGCTT;CGGGGATGCTCATCCGTACACCGACGCAGGCCCGTCAGAAGGTGGCCGACGACGTTGACCGCGTCCGACGCGAGTTCGTGGTGAACGACAAGCGCCTCCACCGGTGGCAGCACTGGCTCGACGACGATTCGTCGTGGCCAGATTTCTCCGTGGTGGTGCATGGCGATCTCTACGTGGGCCATGTGCTCATCGACAACACGGAGCGCGTCAGCGGGATGATCGACTGGAGCGAGGCTCGCGTTGGTGA
gb|DQ839391.1|-|12872-13757|ARO:3003741|mphE [uncultured bacterium] 	0	830	4740	5570	885	638787+	830	ATGACAATTCAAGATATTCAATCACTTGCTGAAGCACACGGCTTGTTGCTTACGGACAAAATGAATTTCAATGAAATGGGCATTGATTTTAAGGTCGTTTTTGCTCTTGATACAAAGGGGCAACAATGGTTGCTGCGTATTCCTCGTCGTGATGGCATGAGGGAACAAATCAAGAAAGAAAAACGCATTTTAGAATTGGTAAAAAAACATCTTTCTGTAGAGGTTCCTGATTGGAGAATTTCATCTACAGAATTAGTGGCTTATCCCATACTTAAAGATAATCCTGTTTTAAATTTGGATGCTGAAACCTATGAAATAATTTGGAATATGGACAAAGATAGCCCGAAATACATAACATCTTTGGCAAAAACCTTATTTGAAATCCATAGTATTCCTGAAAAAGAAGTTCGGGAAAATGATTTGAAAATTATGAAACCTTCAGATTTAAGACCTGAAATAGCAAACAATTTGCAGTTAGTAAAATCTGAAATTGGTATAAGTGAGCAATTGGAAACCCGCTACAGAAAATGGTTGGATAATGATGTTCTATGGGCAGATTTCACCCAATTTATACATGGCGATTTATATGCTGGGCATGTACTAGCTTCAAAGGATGGAGCTGTTTCAGGCGTTATTGATTGGTCAACAGCCCATATAGATGACCCAGCGATTGATTTTGCTGGGCATGTAACTTTGTTTGGAGAAGAAAGCCTCAAAACTCTAATCATCGAGTATGAAAAACTAGGGGGTAAAGTTTGGAATAAACTATATGAACAGACTTTAGAAAGAGCAGCGGCCTCTCCTTTGATGTATGGTTTATTTGCCTTAGA
gb|U00096.3|-|4377810-4378944|ARO:3004290|Escherichia_coli_ampC [Escherichia coli str. K-12 substr. MG1655] 	0	1079	5462	6541	1134	246331+	1079	ATGTTCAAAACGACGCTCTGCGCCTTATTAATTACCGCCTCTTGCTCCACATTTGCTGCCCCTCAACAAATCAACGATATTGTGCATCGCACAATTACCCCGCTTATAGAGCAACAAAAGATCCCCGGTATGGCGGTGGCGGTAATTTATCAGGGTAAACCTTATTACTTTACCTGGGGCTATGCGGACATCGCCAAAAAGCAGCCCGTCACACAGCAAACGTTGTTTGAGTTAGGTTCGGTCAGCAAAACATTTACGGGCGTGCTTGGTGGCGATGCTATTGCTCGAGGGGAAATCAAGTTAAGCGATCCCGCAACAAAATACTGGCCTGAACTTACCGCTAAACAGTGGAATGGGATCACACTATTACATCTTGCGACCTACACCGCTGGCGGCCTGCCATTGCAGATGCCGGATGAAGTGAAATCCTCAAGCGACTTGCTGCGCTTCTATCAAAACTGGCAGCCTGCATGGGCTCCAGGAACACAACGTCTGTATGCCAACTCCAGTATCGGTTTGTTCGGCGCACTGGCTGTGAAGCCGTCTGGTTTGAGTTTTGAGCAGGCGATGCAAACTCGTGTCTTCCAGCCACTCAAACTCAACCATACGTGGATTAATGTACCGCCCGCAGAAGAAAAGAATTACGCCTGGGGATATCGCGAAGGCAAGGCAGTTCATGTTTCGCCAGGGGCGTTAGATGCTGAAGCTTATGGTGTGAAGTCGACCATTGAAGATATGGCCCGCTGGGTGCAAAGCAATTTAACCCCCCTTGATATCAATGAGAAAACGCTTCAACAAGGGATACAACTGGCACAATCTCGCTACTGGCAAACCGGCGATATGTATCAGGGCCTGGGCTGGGAAATGCTGGACTGGCCGGTCAATCCTGACAGCATCATTAACGGCAGTGACAATAAAATTGCACTGGCAGCACGCCCGGTAAAAGCGATTAAGCCCCCAACTCCTGCAGTACGCGCATCATGGGTACATAAAACGGGGGCGACCGGCGGATTTGGTAGCTATGTCGCGTTTATTCCAGAAAAAGAGCTGGGTATCGTGATGCTGGCTAACAAAAACTA
gb|CP010314.1|+|275837-276758|ARO:3004541|mphK [Bacillus subtilis subsp. subtilis] 	0,272,563	304,594,787	920,0,0	1224,321,224	921	3737543+;197573+;2027252+	304;321;224	ATGACAAACCTTAACGAAAAACAGCTTATCACTGAGATTGTCGGGCTTGCACGCAGCCAAGGTTTGACGGTTCATTCTGAGAACGCGCAATTGAATGAAACCGGAATGGACTTTCAAGTTGTATTTGCCAAGGACGACACAGGTATGCCATGGGTGCTGCGAAAACCGCGGCGAAGTGATGTTGTGGAAAGAGCATCCGCAGAAGGCATAACGCTTGCCTTTCTCCGCGCGAATCTGACTGCTGATGTGCCGGATTGGAGAATTCATACACCGGAATTGATCGCTTACCCCATGTTAAAAGGAA;GGAATTGATCGCTTACCCCATGTTAAAAGGAACGCCGGCTGCTGGAATTGACTTGGAACAAAAGCAATATGTATGGAATATGGATCATCAGCCGCCGTCAGACGACTTTGTCCGCACACTTGCCGACATACTGGCTGAATTACATGGCACGGATCAAATATCTGCTGGGCAATCCGGAATAGAAGTGATAAGGCTAGAAGATTTCAGGCAAATGACAGCAGACTCTATGGTTGATGTGAAGAATAAGCTTGGCGTATTACGACGCTTTGGGAAAGATGGCAAAAGTGGATAGATGATGATGCATACTGGCCGGGTTTCTCT;AGATGATGATGCATACTGGCCGGGTTTCTCTTCTTTGATACACGGCGATCTCCAGCCCCCGCATATTCTTATCGACCAAAATGAACGTGTCACAGGACTTCTGGATTGGACAGAAGCGAAGGTTGCTGACCCAGCCAAGGATTTTGTTCTTTATCAAACCATTTTCGGAGAAAAAGAAACTGCCCGTTTGCTTGAATACTATGATCAAGCAGGCGGCCGAATAT
gb|EU294228.1|+|21241-22717|ARO:3003109|msrE [Acinetobacter baumannii] 	0	1421	3209	4630	1476	638787+	1421	ATGAGTTTAATTATTAAAGCGAGAAACATACGCTTGGATTATGCTGGGCGTGATGTTTTGGATATTGATGAATTGGAAATTCACTCTTATGACCGTATTGGTCTTGTGGGTGATAACGGAGCAGGAAAGAGTAGTTTACTCAAAGTACTTAATGGCGAAATTGTTTTAGCCGAAGCGACATTACAGCGTTTTGGTGATTTTGCACATATCAGCCAACTGGGCGGAATCGAAATAGAAACGGTCGAAGACCGGGCAATGTTATCTCGCCTTGGTGTTTCCAATGTACAAAACGACACAATGAGTGGCGGAGAGGAAACTCGTGCAAAAATTGCTGCCGCATTTTCCCAACAAGTACATGGCATTCTAGCGGATGAACCAACCAGCCACCTTGATCTCAATGGAATAGATCTACTTATTGGTCAACTTAAAGCATTTGATGGAGCATTACTTGTTATCAGTCATGACCGATATTTTCTTGATATGGTTGTAGACAAGATATGGGAGTTAAAAGACGGTAAAATTACGGAATATTGGGGTGGTTACTCGGATTACTTGCGTCAAAAAGAAGAAGAGCGACAACACCAAGCCGTAGAATATGAGCTGATGATGAAGGAACGGGAGCGATTAGAATCTGCTGTGCAAGAAAAACGCCAGCAAGCTAATCGATTAGACAATAAGAAAAAAGGAGAAAAATCCAAAAACTCTACCGAAAGTGCTGGACGACTTGGGCATGCAAAAATGACTGGCACCAAGCAAAGAAAACTGTATCAGGCAGCTAAGAGTATGGAAAAGCGTTTGGCTGCATTAGAAGATATTCAAGCACCAGAGCATTTGCGTTCTATTCGTTTTCGTCAAAGTTCAGCCCTAGAACTGCACAATAAGTTCCCGATTACGGCAGATGGTCTGAGCTTAAAATTTGGTAGCCGTACTATCTTTGATGACGCTAACTTTATAATACCGCTTGGCGCTAAAGTCGCTATAACTGGATCGAATGGAACAGGGAAAACGTCCTTGTTAAAAATGATATCAGAACGTGCTGATGGATTAACCATATCTCCAAAAGCTGAAATTGGCTACTTTACACAAACAGGATATAAATTTAACACGCATAAATCTGTGCTCTCCTTTATGCAGGAAGAGTGCGAGTACACAGTTGCGGAAATTCGTGCAGTATTGGCTTCAATGGGGATCGGAGCGAATGATATTCAAAAAAACTTATCCGACTTATCGGGAGGTGAAATCATCAAACTGCTTTTATCCAAAATGCTTTTAGGAAAATATAATATTTTGCTTATGGATGAACCAGGAAACTATCTTGACCTAAAAAGTATTGCCGCATTAGAAACAATGATGAAGTCCTATGCAGGAACTATTATCTTCGTATCTCATGACAAGCAATTGGTCGATAATATTGCTGACAT
gb|FN649414.1|+|2765050-2766355|ARO:3004611|Escherichia_coli_ampC1_beta-lactamase [Escherichia coli ETEC H10407] 	0	1250	413	1663	1305	2924723-	1250	ATGAAACGGACAATGCTCTATCTTTCTCTGCTGGCTGTTAGTTGTAGCGTCAGCGCCGCAAAATACCCTGTTCTGACAGAAAGCTCGCCAGAGAAAGCAGGGTTTAACGTCAAACGGCTTAACCAGATGGATCGCTGGATTAGCCAGCAAGTTGATGCCGGTTATCCCGGCGTAAACCTGCTGATCATTAAAGATAATCAGATTGTGTATCGCAAAGCCTGGGGAGCGGCGAAAAAGTACGATGGCAGCGTGTTGATGGAACAGCCTGTCAAAGCCACCACCGGGACGCTGTATGACCTGGCCTCAAACACCAAAATGTACGCCACGAACTTCGCCCTGCAAAAGCTGATGAGCGAAGGCAAACTGCATCCTGACGATCGGATTGCGAAATATATTCCGGGGTTTGCCGATAGTCCAAATGACACCATTAAAGGCAAAAACACCCTGCGGATTTCTGACCTGCTGCATCACAGCGGCGGTTTCCCGGCAGATCCGCAATACCCGAATAAAGCGGTCGCGGGCGCGTTATATTCCTAGGATAAAGGCCAGACGCTGGAGATGATCAAGCGCACGCCGCTGGAATATCAGCCCGGCAGCAAACATATCTACAGCGATGTCGATTATATGCTGCTTGGATTTATCGTCGAGTCGGTTACCGGTCAGCCGCTTGACCGCTATGTTGAAGAGTCGATTTATCGCCCGCTCGGCCTGACACATACGGTATTTAACCCGCTGCTGAAAGGCTTTAAACCGCAACAAATTGCCGCCACGGAATTGAACGGCAATACCCGCGATGGCGTGATCCATTTCCCGAATATCCGCACCTCCACTCTCTGGGGTCAGGTGCACGATGAAAAAGCCTTTTATTCGATGGGCGGCGTTTCCGGGCACGCAGGTTTGTTTTCCAATACCGGCGATATTGCGGTGTTAATGCAAACGATGCTGAACGGCGGGGGCTATGGCGATGTGCAGCTGTTCAGTGCGGAAACGGTGAAGATGTTCACCACCAGCTCTAAGGAAGATGCCACTTTTGGCCTCGGCTGGCGCGTGAATGGTAATGCCACCATGACGCCGACGTTTGGCACGCTGGCAAGCCCGCAAACCTACGGTCACACTGGCTGGACCGGGACAGTAACCGTTATCGATCCGGTCAATCATATGGCGATTGTGATGTTAAGCAACAAGCCCCATTCGCCAGTTGCCGATCCACAAAAAAATCCCAATATGTTCGAAAGCGGTCAGTTACCGAT
gb|U00096|+|2367070-2368039|ARO:3003578|pmrF [Escherichia coli str. K-12 substr. MG1655] 	0	914	3046	3960	969	251478+	914	ATGTTTGAAATCCACCCTGTTAAGAAAGTCTCGGTGGTTATTCCCGTTTATAACGAGCAGGAAAGCTTACCGGAATTAATCAGGCGCACCACCACAGCCTGTGAATCGTTGGGGAAAGAGTATGAGATCCTGCTGATTGATGACGGCAGTAGCGATAATTCCGCGCATATGCTGGTCGAAGCCTCACAAGCGGAGAACAGCCATATTGTGTCTATTTTGCTTAACCGCAATTACGGGCAACATTCAGCGATTATGGCGGGATTCAGTCACGTTACTGGCGACTTAATTATTACCCTTGATGCCGATCTCCAGAATCCGCCAGAAGAAATCCCCCGCCTAGTGGCAAAAGCCGATGAAGGTTACGACGTGGTAGGGACTGTACGCCAGAACCGCCAGGACAGCTGGTTTCGTAAAACAGCTTCGAAGATGATTAACCGGCTTATTCAGCGCACCACCGGCAAAGCGATGGGTGACTACGGTTGTATGCTGCGCGCCTATCGCCGTCATATTGTCGATGCGATGTTGCACTGCCATGAACGTAGCACCTTTATCCCGATTCTGGCGAATATCTTCGCCCGCCGTGCCATTGAAATTCCAGTACATCATGCCGAGCGTGAGTTTGGTGAATCCAAATACAGTTTTATGCGCCTGATTAATTTGATGTACGACCTGGTGACCTGCCTTACCACAACGCCGCTACGTATGCTGAGTCTGCTCGGCAGCATTATTGCGATTGGAGGTTTTAGCATTGCGGTGCTGCTGGTGATTTTACGCCTGACCTTCGGACCACAATGGGCGGCAGAAGGCGTCTTTATGCTATTTGCCGTGCTGTTTACTTTTATTGGCGCTCAGTTTATCGGCATGGGATTACTCGGTGAATATATCGGCAGGATCTACACCGATGTCCGCGCCCG
gb|JF969163|+|1053-1893|ARO:3000410|sul1 [Vibrio fluvialis] 	0	785	1306	2091	840	104600-	785	ATGGTGACGGTGTTCGGCATTCTGAATCTCACCGAGGACTCCTTCTTCGATGAGAGCCGGCGGCTAGACCCCGCCGGCGCTGTCACCGCGGCGATCGAAATGCTGCGAGTCGGATCAGACGTCGTGGATGTCGGACCGGCCGCCAGCCATCCGGACGCGAGGCCTGTATCGCCGGCCGATGAGATCAGACGTATTGCGCCGCTCTTAGACGCCCTGTCCGATCAGATGCACCGTGTTTCAATCGACAGCTTCCAACCGGAAACCCAGCGCTATGCGCTCAAGCGCGGCGTGGGCTACCTGAACGATATCCAAGGATTTCCTGACCCTGCGCTCTATCCCGATATTGCTGAGGCGGACTGCAGGCTGGTGGTTATGCACTCAGCGCAGCGGGATGGCATCGCCACCCGCACCGGTCACCTTCGACCCGAAGACGCGCTCGACGAGATTGTGCGGTTCTTCGAGGCGCGGGTTTCCGCCTTGCGACGGAGCGGGGTCGCTGCCGACCGGCTCATCCTCGATCCGGGGATGGGATTTTTCTTGAGCCCCGCACCGGAAACATCGCTGCACGTGCTGTCGAACCTTCAAAAGCTGAAGTCGGCGTTGGGGCTTCCGCTATTGGTCTCGGTGTCGCGGAAATCCTTCTTGGGCGCCACCGTTGGCCTTCCTGTAAAGGATCTGGGTCCAGCGAGCCTTGCGGCGGAACTTCACGCGATCGGCAATGGCGCTGACTACGTCCGCACCCACGCGCCTGGAGATCTGCGAAGCGCAATCACCTTCTCGGAAAC
gb|AP012030.1|-|395553-396711|ARO:3004612|Escherichia_coli_ampH [Escherichia coli DH1] 	0	1093	3880	4973	1158	243533-	1093	TTGAAACGTAGTCTGCTTTTTTCTGCCGTGCTGTGTGCGGCGTCATTGACCTCCGTCCATGCGGCGCAGCCGATCACTGAACCGGAGTTTGCCTCTGATATTGTCGATCGTTATGCCGATCATATTTTTTACGGCAGCGGTGCCACGGGGATGGCGCTGGTTGTTATCGACGGTAACCAGCGCGTCTTTCGCAGTTATGGCGAAACGCGACCTGGTAATAACGTTCGCCCGCAGCTGGATTCGGTCGTGCGTATTGCTTCCCTCACCAAGCTAATGACCAGTGAAATGCTGGTGAAATTGCTCGACCAGGGGACCGTGAAGTTAAACGATCCGCTAAGTAAATATGCTCCGCCAGGCGCACGCGTGCCAACCTACAATGGGACGCCCATTACCCTAGTGAATCTGGCAACCCATACCAGCGCCCTGCCCCGTGAACAGCCCGGTGGCGCGGCACATCGTCCGGTGTTTGTCTGGCCAACGCGCGAGCAACGCTGGAAATACCTTTCTACGGCGAAGCTGAAAGCCGCGCCAGGCAGTCAGGCGGCGTACTCTAACCTTGCGTTCGACCTGCTGGCAGATGCACTGGCGAATGCGTCCGGCAAGCCTTATACCCAGTTGTTTGAAGAGCAGATTACCCGTCCATTGGGGATGAAAGACACCACCTACACCCCCTCACCGGATCAGTGCCGCCGTTTAATGGTTGCTGAGCGCGGTGCCAGTCCGTGCAATAACACGCTGGCGGCAATTGGCAGCGGCGGCGTCTATTCCACGCCTGGCGATATGATGCGCTGGATGCAGCAGTATTTATCATCTGATTTTTATCAGCGCAGTAACCAGGCAGATCGCATGCAGACGTTGATTTATCAGCGCGCGCAGTTTACCAAAGTGATTGGCATGGATGTCCCCGGCAAAGCGGATGCGCTTGGTTTAGGCTGGGTATATATGGCCCCGAAAGAGGGTCGTCCGGGGATTATTCAGAAGACAGGCGGTGGTGGCGGTTTCATTACCTATATGGCGATGATCCCGCAGAAGAATATTGGCGCGTTTGTGGTGGTCACTCGTTCGCCGTTGACGCGCTTTAAAAATATGAGCG
gb|AY055428.1|-|20268-21084|ARO:3000412|sul2 [Vibrio cholerae] 	0	761	21	782	816	51050683+	761	ATGAATAAATCGCTCATCATTTTCGGCATCGTCAACATAACCTCGGACAGTTTCTCCGATGGAGGCCGGTATCTGGCGCCAGACGCAGCCATTGCGCAGGCGCGTAAGCTGATGGCCGAGGGGGCAGATGTGATCGACCTCGGTCCGGCATCCAGCAATCCCGACGCCGCGCCTGTTTCGTCCGACACAGAAATCGCGCGTATCGCGCCGGTGCTGGACGCGCTCAAGGCAGATGGCATTCCCGTCTCGCTCGACAGTTATCAACCCGCGACGCAAGCCTATGCCTTGTCGCGTGGTGTGGCCTATCTCAATGATATTCGCGGTTTTCCAGACGCTGCGTTCTATCCGCAATTGGCGAAATCATCTGCCAAACTCGTCGTTATGCATTCGGTGCAAGACGGGCAGGCAGATCGGCGCGAGGCACCCGCTGGCGACATCATGGATCACATTGCGGCGTTCTTTGACGCGCGCATCGCGGCGCTGACGGGTGCCGGTATCAAACGCAACCGCCTTGTCCTTGATCCCGGCATGGGGTTTTTTCTGGGGGCTGCTCCCGAAACCTCGCTCTCGGTGCTGGCGCGGTTCGATGAATTGCGGCTGCGCTTCGATTTGCCGGTGCTTCTGTCTGTTTCGCGCAAATCCTTTCTGCGCGCGCTCACAGGCCGTGGTCCGGGGGATGTCGGGGCCGCGACACTCGCTGCAGAGCTTGCCGCCGCCGCAGGTGGAGCTGACTTCATCCGCACACACGAGCCGCGCCCCTT
gb|CP001633.1|-|630303-631167|ARO:3004801|FTU-1 [Francisella tularensis subsp. tularensis NE061598] 	0,535	588,809	3008,0	3596,274	864	542936+;1737029+	588;274	ATGCGTCTATTAGTTACAACTTTATCATTAATCCCGAGTATCATACTAGCTGCTCCTCAATTAGATGATTCTTTTAAAAATCTGGAAAACAAATATGATGGAAAAATTGGCATCTACACTCTCAACACTGATGATAAAACTAACATCAAATATAACGAAAGCTATCACTTCCCTATTTGTAGTGTTTTCAAGTTTTTATTAGTTGGTGCAATTTTAGATTATGATATGCATAATCAAGGCTTCTTAGATAAAAAAATTCCAATAAATCAAGATGATATTGGTAAACTCGGATATGCTCCTATTACTGCTAAAAACGTTGGTAAAACTCTAACAATATCACAACTTAACTACGCTGCTATCCTAAGTGATAGTCCTGCCAGTAACATATTAGTTAGAGAACTTGGAGGTTTACAAAACTTAAATAAATTTATAAAAAAATTAGGTGATAACGATACTATAATTACTGCTGATGAACCAGAAATTAATTATACTCAGCCACATAGTAATATAAATAAAACAACTCCAAAGGCTATTACTAAAGATATTTATAAATTAGCATTTGGCAATATTCTAGATAAAAAACATAAA;CTAAAGATATTTATAAATTAGCATATGGCAATATTCTAGATAAAAAACATAAAGATATTATTATAAAGTATCTAGAAGATAATAATACTGGTGCAAATAGAATAGCTTTTAGCATGCCTAAAGATTGGATAATTGGCGATAAAACTGGAACTTGTGGTCAATATGCAGCAACTAATGATGTAGCTATTATATGGCCTAAAAATCAGCAACCTATTGCGTTAGGAATTTTATATACTAACCCTAATGATAAAAATGCACCAAGTAATGAAGAAAT
gb|FJ196385|-|8531-9323|ARO:3000413|sul3 [Escherichia coli] 	0	737	233	970	792	206563+	737	ATGAGCAAGATTTTTGGAATCGTAAATATAACCACCGATAGTTTTTCCGATGGAGGACTTTATTTAGATACAGATAAGGCAATTGAGCATGCTCTGCATTTGGTTGAAGATGGAGCAGATGTGATTGATTTGGGAGCCGCTTCCAGTAATCCTGATACAACTGAAGTGGGCGTTGTGGAAGAAATCAAAAGACTCAAACCTGTCATTAAGGCTTTAAAAGAAAAAGGCATTTCTATTTCTGTTGATACATTTAAACCTGAGGTTCAGAGTTTTTGCATAGAACAAAAGGTTGATTTTATTAATGATATTCAAGGTTTTCCTTATCCTGAGATTTATTCAGGCTTGGCAAAGTCAGATTGCAAACTTGTGTTGATGCACTCCGTTCAGCGAATTGGTGCAGCTACTAAAGTTGAAACGAATCCGGAAGAGGTTTTTACTTCCATGATGGAATTTTTTAAAGAAAGAATTGCTGCTTTAGTTGAGGCTGGTGTAAAGCGTGAACGAATTATTCTTGATCCGGGTATGGGCTTCTTTTTAGGCTCTAATCCAGAAACATCTATTCTTGTTTTGAAGCGTTTCCCTGAAATTCAAGAAGCTTTTAATTTGCAAGTAATGATTGCAGTGTCACGGAAATCATTCTTAGGTAAAATAACTGGAACCGATGTGAAATCTCGTTTAGCACCAACTCTTGCAGCAGAAATGTATGCATACAAAAAAGGTGCAGATTATCTCCGCAC
gb|KP143090.1|-|1199-1619|ARO:3003209|FosA5 [Escherichia coli] 	0	357	929	1286	420	29844-	357	ATGCTGAGTGGACTGAATCACCTGACCCTGGCAGTCAGCCAGCTGGCGCCGAGCGTGGCGTTTTATCAGCAGCTGCTGGGCATGACGCTGCATGCCCGCTGGGACAGCGGGGCTTATCTCTCCTGCGGCGATTTGTGGCTGTGCCTGTCGCTGGATCCGCAGCGGCGCGTTACTCCGCCGGAAGAGAGCGACTACACCCATTATGCGTTTAGTATTAGCGAAGCCGATTTTGCTAGCTTCGCCGCCCGCCTTGAGGCTGCCGGCGTGGCGGTCTGGAAGCTGAACCGTAGCGAAGGTGCCTCGCACTATTTCCTCGATCCCGATGGCCATAAGCTGGAGCTGCACGTCGGCAGTCTC
gb|KU254579.1|+|59421-59841|ARO:3004111|FosA6 [Escherichia coli] 	0	365	929	1294	420	29844-	365	ATGCTGAGTGGACTGAATCACCTGACCCTGGCAGTCAGCCAGCTGGCGCCGAGCGTGGCGTTTTATCAGCAGCTGCTGGGCATGACGCTGCATGCCCGCTGGGACAGCGGGGCTTATCTCTCCTGCGGCGATTTGTGGCTGTGCCTGTCGCTGGATCCGCAGCGGCGCGTTACTCCGCCGGAAGAGAGCGACTACACCCATTATGCGTTTAGTATTAGCGAAGCCGATTTTGCTAGCTTCGCCGCCCGCCTTGAGGCTGCCGGCGTGGCGGTCTGGAAGCTGAACCGTAGCGAAGGTGCCTCGCACTATTTCCTCGATCCCGATGGCCATAAGCTGGAGCTGCACGTCGGCAGTCTCGCCCAGCG
gb|AE016877.1|+|1972251-1972668|ARO:3000172|FosB [Bacillus cereus ATCC 14579] 	0	362	69	431	417	2163774+	362	TTGTTAAGGGGAATCAATCATATTTGTTTTTCGGTATCTAATTTAGAAAACTCTATTATGTTTTATGAAAAAGTATTAGAAGGAGAATTATTAGTTAAAGGAAGAAAATTGGCTTATTTTAACATATGTGGAGTATGGATAGCGCTTAATGAAGAGACGCATATTCCGAGAAATGAGATTCATCAATCTTATACGCACATTGCATTTTCTGTTGAACAAGAAGACTTTAAATGTCTAATACAGCGATTAGAAGAAAATGATGTTCATATTTTACAAGGAAGAGAACGTGATGTAAGAGATTACGAATCTATATACTTTGTTGATCCTGACGGTCATAAATTTGAGTTTCACTCAGGGACACT
gb|FN594949|+|25244-27167|ARO:3000556|tet44 [Campylobacter fetus subsp. fetus] 	0	1868	1263	3131	1923	1758066+	1868	ATGAAAATAATCAACATTGGTATTCTTGCTCATGTAGATGCAGGAAAGACGACTTTAACGGAAAGTCTGCTTTATACAAGTGGAGCGATTTTAGAATTAGGCAGTGTAGATAAGGGAACAACAAGGACAGATACTATGTTTTTAGAACGTCAGCGTGGAATCACAATTCAGGCAGCAGTTACTTCTTTTAATTGGAATGACTACAAAATCAATATTGTAGATACTCCTGGACATACAGATTTTATAACAGAAGTGTATCGTTCCTTATCTGTTCTTGATGGAGCTATTTTAGTAATTTCTGCTAAAGATGGTGTACAAGCACAAACAAGAATACTATTCCATGCACTTCAAAAAATGAATATACCAACAATTATTTTTATAAATAAAATAGATCAGTATGGAATTAACTTAAATAATATTTATCAAAATATCAAAGAAAAACTTTCAAATGATATTATTGTTATGCAAAATGTAACATTAACTCCAGAAATATCAATTAAAAATATCATTGATTTAGATGAATGGGATCCTGTAATTTCCAAAAATGATAAACTTTTAAAAAAATATATTGCAGGAGAAAAATTGACTATACAGGAATTAACGCAGGAAGAATATAGGTGTGTTAAAAAAGGTTCGTTGTTTCCTATATACCATGGAAGTGCTAAAAATAATATAGGAACTCAACAACTCATTGAAGCTATTTCAAATCTTTTTTGTCCTGAAATGAATAAGAATTATTCAGAACTATGTGGAAGAGTTTTTAAAATTGAATATACAGACCATAAGCAAAGATTAGTTTATTTGCGTCTTTACAGTGGAACATTACACTTACGAGATACAATTGTATTGTCAGAAAAAAAGAAAGTGAAACTTACAGAAATATATATTCCTTCAAATGGAGAAATGATACAGACAGAAATAGTTTGTTCTGGAGATATTTTTATAATACCTAACAATACATTAAGATTGAACGATATTATAGGAAATGAAAAGATTTTGCCATGCAATGTATGGAATGACAAGCCTGTACCAATGCTACGAACAAGAATTGAACCGATAAAAATAGAAGAGAGAGAAAAATTATTGGATGCTCTTACAGAAATTGCAGATACTGATCCTCTTTTACGTTATTGTGTTGATACGATAACACATGAAATCGTCATTTCTTTTTTAGGAACAGTGCAGTTAGAAGTTATCTGTTCTCTGTTGATTGAAAAATATCACATAAACATAAGAATCGAAGATCCAACCGTAATTTATTTGGAAAAGCCATTACAAAAGGCAGATTATACTATTCATATTGAAGTACCACCAAATCCATTTTGGGCATCAATTGGATTATCAATAACTCCACTTCCAATTGGCAGTGGAATACAGTACGAAAGCAAAGTTTCACTCGGTTATTTAAATCAAAGTTTCCAAAATGCAGTAAGAGAAGGTATTAATTATGGACTGGAGCAAGGTTTGTATGGCTGGGAAGTAACAGATTGTAAAATATGTTTTGAATATGGTGTTTATTATAGCCCTGTTAGTACTCCCTCGGATTTTCGTTTTCTTGCCCCAATTGTACTTGAACAAACATTGAAAAAAGCGGGAACGCAATTATTAGAGCCATATCTTTCGTTTATACTTTTTACACCACAGGGATACCTTTCTCGTGCATATAATGATGCACAAAAACATTGTGCAATAATTGAAACTAGTCAATCAAAAAATGATGAAATTATTTTTACAGGACATATTCCTGTACGTTGTATTAATGAATATCGTAATACTTTAACTCTATATACAAATGGGCAAGCAGTTTTTTTGACAGAATTAAAAGGTTATCAAATTGCTACTTGTGAACCAGTTATTCAATCACGTAG
gb|AJ011502.1|+|300-1425|ARO:3004122|Klebsiella_pneumoniae_OmpK37 [Klebsiella pneumoniae] 	0,843	864,1070	219,1	1113,228	1125	55313077+;55304798+	894;227	ATGAAAAGAAAAGTACTGGCCCTCGTTACTCCGGCTTTATTAGCCGCAGGTGCCGCGCATGCGGCGGAAATTTATAATAAAGACGGGAATAAATTAGATCTCTATGGCAAGGTAGATGGTCTGCATTATTTCTCCAGCGACTCGAAAAAAGACGGCGATCAAACTTATTTACGTTTTGGCTTTAAAGGCGAAACCCAGATCAACGATATGCTTACCGGCTATGGCCAGTGGGAATATAACGTTCAGGCCAACAACACCGAGACCTCCAGCGATCAGGCGTGGACCCGTCTGGCATTCGCCGGTATCAAAGTGGGCGATTACGGCTCCTTCGACTACGGTCGTAACTACGGCGTGCTGTACGACGTTGAAGGCTGGACCGATATGCTGCCGGAGTTCGGCGGCGACTCCTACACCTATGCGGATAACTTTATGGCAGGCCGCGCCAACGGCGTCGCAACCTACCGCAACAGCGATTTCTTCGGTCTGGTGGAGGGTCTGAACTTCGCCCTGCAGTATCAGGGTAAAAACGAAGGCCAGAACGCGCAGGATATCAACGTCGGCACCAATAACCGCAGCAGCGACAGCGATGTTCGCTTCGACAATGGCGATGGTTTCGGCCTCTCCACTTCCTACGACTTCGGCATGGGTATCAGCGCGGCGGCAGCTTACACCTCGTCTGACCGTACAGGCGACCAGCAACACTATACTCACACCGAACGATACGCCAAAGGCGACAAAGCGGACGCCTGGACCGCCGGCCTGAAGTACGACGCCAACGATATTTACCTGGCGACCATGTACTCTGAAACCCGCAATATGACGCCATACGGCTCTACCAGCAGTACCAACGGTGGCGGTATCGCCAATAAAACGCAAAACTTCGAAGTCACCGCG;CAAAACTTCGAAGTCACCGCGCAGTATCAGTTCGACTTCGGCCTGCGTCCGGCCATCTCCTACCTGCAGTCCAAAGGCAAAGATCTGTACAATAACGGCCGCTATGCCGATAAAGATCTGGTCAAATATATGGACGTTGGCGCGACCTATTACTTCAACCGTAATATGTCCACCTATGTTGATTACAAAATCAACCTGCTGGATGGTAACGACAAATTCTACGAAGA
gb|M18896.2|+|206-2126|ARO:3000190|tetO [Campylobacter jejuni] 	0	1865	253	2118	1920	248320-	1865	ATGAAAATAATTAACTTAGGCATTCTGGCTCACGTTGACGCAGGAAAGACAACATTAACGGAAAGTTTATTGTATACCAGTGGTGCAATTGCAGAACTAGGGAGCGTAGATGAAGGCACAACAAGGACAGATACAATGAATTTGGAGCGTCAAAGGGGAATCACTATCCAGACAGCAGTGACATCTTTTCAGTGGGAGGATGTAAAAGTCAACATTATAGATACGCCAGGCCATATGGATTTTTTGGCGGAAGTATACCGTTCTTTATCCGTATTAGACGGAGCAGTATTATTAGTTTCTGCAAAGGATGGCATACAGGCACAGACCCGTATACTGTTTCATGCACTACAGATAATGAAGATTCCGACAATTTTTTTCATCAATAAAATTGACCAAGAGGGGATTGATTTGCCAATGGTATATCGGGAAATGAAAGCAAAGCTTTCTTCGGAAATTATAGTGAAGCAAAAGGTTGGGCAGCATCCCCATATAAATGTAACGGACAATGACGATATGGAACAGTGGGATGCGGTAATTATGGGAAACGATGAACTATTAGAGAAATATATGTCAGGGAAACCGTTTAAAATGTCAGAACTGGAACAGGAAGAAAACAGGAGATTCCAAAACGGAACGTTATTTCCCGTTTATCACGGAAGCGCTAAAAACAATCTGGGGATTCGGCAGCTTATAGAAGTAATTGCCAGTAAATTTTATTCATCAACGCCTGAAGGTCAATCTGAACTATGCGGGCAGGTTTTTAAGATTGAATATTCAGAGAAAAGGCGGCGTTTTGTTTATGTGCGTATATATAGCGGAACATTGCATTTGAGGGATGTTATTAGAATATCTGAAAAAGAGAAAATAAAAATCACAGAGATGTGTGTTCCGACAAACGGTGAATTATATTCATCCGATACAGCCTGCTCTGGTGATATTGTAATTTTACCAAATGATGTTTTGCAGCTAAACAGTATTTTGGGGAACGAAATACTGTTGCCGCAGAGAAAATTTATTGAAAATCCTCTCCCTATGCTCCAAACAACGATTGCAGTAAAGAAATCTGAACAGCGGGAAATATTGCTTGGGGCACTTACAGAAATTTCAGATGGCGACCCTCTTTTAAAATATTATGTGGATACTACAACGCATGAGATTATACTTTCTTTTTTGGGGAATGTGCAGATGGAAGTCATTTGTGCCATCCTTGAGGAAAAATATCATGTGGAGGCAGAAATAAAAGAGCCTACTGTTATATATATGGAAAGACCGCTTAGAAAAGCAGAATATACCATCCACATAGAAGTCCCGCCAAATCCTTTCTGGGCTTCTGTCGGGTTGTCCATAGAGCCGCTCCCTATTGGAAGCGGAGTGCAGTATGAAAGCAGAGTTTCACTTGGATATTTAAATCAATCGTTCCAAAATGCGGTTATGGAGGGGGTTCTTTATGGCTGCGAGCAGGGGCTGTATGGATGGAAAGTGACAGACTGTAAAATCTGTTTTGAATATGGATTGTATTATAGTCCTGTAAGTACCCCCGCAGACTTTCGGCTGCTTTCCCCTATCGTATTGGAGCAGGCTTTAAAAAAAGCAGGGACAGAACTATTAGAGCCATATCTCCACTTTGAAATTTATGCACCGCAGGAATATCTCTCACGGGCGTATCATGATGCTCCAAGGTATTGTGCAGATATTGTAAGTACTCAGATAAAGAATGACGAGGTCATTCTGAAAGGAGAAATCCCTGCTAGATGTATTCAAGAATACAGGAACGATTTAACTTATTTCACAAATGGGCAGGGAGTCTGCTTGACAGAGTTAAAAGGATACCAGCCAGCTATTGGTAAATTTATTTGCCAACCCCG
gb|CP045110.1|-|521271-522372|ARO:3005051|LpsB [Acinetobacter baumannii] 	0	1046	116380	117426	1101	249398+	1046	ATGAAAGTGATGCAACTTCTCCCAGAACTTAATAGCGGTGGCGTAGAACGCGGCACACTGGAAATTGCACGTGCACTGGTTGCACAAGGTCATCAGTCTCTAGTTGTGTCTAATGGCGGGCGTTTGGTCTCACAACTTGAAGCTGAAGGTTCCACACACTTAACGCTGCCTATCCATAAAAAATCATTGTCAAGCTTGTGGCAAATCCGTCCATTACGTCAGCTGATTGAAGAGCACCAACCAGACATTGTACATGTGCGCTCTCGCGTACCTGCGTGGCTAACCCACTTCGCTTTAAGAAAAATACCAGCGAATAAACGCCCTCACCTCATTAGCACGGTACATGGTTTCTATTCAGTTAATCGTTATAGTGCGATCATGACTCAGGCAGAAAAAGTGATCGCTGTTTCTGACAGCGTAGTTAAATACATCACAGACCATTATAAAAACTGTCCACCACAAGATATTGTCCGTATTTATCGAGGCATTGACCCTGCTGCTTTTCCGCATAACTACCAACCTTCAGCACAGTGGTTTAACCAAGTTTTTAACGACTTTCCCGAACTCGAGAATAAATTTTTACTTTGCCTACCTGGCCGTATTACTCGTTTAAAAGGACATGAAAGTTTAATTGAACTGATGCAAAAACTAGGTGAACAATATCCTCAACTGCATGCTGTTGTTGTGGGTGGGGCTGATGTAAAAAAACAAGCCTATTTAAGTGAGTTGCAAAACACCATTCAAAGCAAAGGACTTGCAGATAAAATTACCTTTGTAGGACATCGCTCAGATATACGCGAATGGCTCGCTTTTAGCGATATAGTGCTCTCTCTATCCAATCAAGCAGAAACATTCGGTAGAACAGCATTAGAAGCCCTTTCGGTAGGCACGCCGGTCATTGGCTGGAACCGTGGCGGTGTTGCCGAGATTTTATCTCATGTATACCCACAAGGTCTTGTTGAAGCAGAAAATGAAAAAGCTTTAGTAGAAACAGTAAAGAATCATATTGAACAACCGCAAACAGTCGCTCCTGTGACAATGTTTAG
gb|AF205943|+|7511-8312|ARO:3001405|OXA-10 [Escherichia coli] 	0	746	659	1405	801	104604+	746	ATGAAAACATTTGCCGCATATGTAATTATCGCGTGTCTTTCGAGTACGGCATTAGCTGGTTCAATTACAGAAAATACGTCTTGGAACAAAGAGTTCTCTGCCGAAGCCGTCAATGGTGTCTTCGTGCTTTGTAAAAGTAGCAGTAAATCCTGCGCTACCAATGACTTAGCTCGTGCATCAAAGGAATATCTTCCAGCATCAACATTTAAGATCCCCAACGCAATTATCGGCCTAGAAACTGGTGTCATAAAGAATGAGCATCAGGTTTTCAAATGGGACGGAAAGCCAAGAGCCATGAAGCAATGGGAAAGAGACTTGACCTTAAGAGGGGCAATACAAGTTTCAGCTGTTCCCGTATTTCAACAAATCGCCAGAGAAGTTGGCGAAGTAAGAATGCAGAAATACCTTAAAAAATTTTCCTATGGCAACCAGAATATCAGTGGTGGCATTGACAAATTCTGGTTGGAAGGCCAGCTTAGAATTTCCGCAGTTAATCAAGTGGAGTTTCTAGAGTCTCTATATTTAAATAAATTGTCAGCATCTAAAGAAAACCAGCTAATAGTAAAAGAGGCTTTGGTAACGGAGGCGGCACCTGAATATCTAGTGCATTCAAAAACTGGTTTTTCTGGTGTGGGAACTGAGTCAAATCCTGGTGTCGCATGGTGGGTTGGGTGGGTTGAGAAGGAGACAGAGGTTTACTTTTTCGCCTTTAACATGGATATAGACAACGAAAGTAAGTTGCCGCT
gb|AM231720|+|0-825|ARO:3001438|OXA-100 [Acinetobacter baumannii] 	0	770	54149	54919	825	246080-	770	ATGAACATTAAAGCACTCTTACTTATAACAAGCGCTATTTTTATTTCAGCCTGCTCACCTTATATAGTGACTGCTAATCCAAATCACAGCGCTTCAAAATCTGATGTAAAAGCAGAGAAAATTAAAAATTTATTTAACGAAGCACACACTACGGGTGTTTTAGTTATCCAACAAGGCCAAACTCAACAAAGCTATGGTAATGATCTTGCTCGTGCTTCGACCGAGTATGTACCTGCTTCGACCTTCAAAATGCTTAATGCTTTGATCGGCCTTGAGCACCATAAGGCAACCACCACAGAAGTATTTAAGTGGGATGGTAAAAAAAGGTTATTCCCAGAATGGGAAAAGGACATGACCCTAGGCGATGCCATGAAAGCTTCCGCTATTCCAGTTTATCAAGATTTAGCTCGTCGTATTGGACTTGAGCTCATGTCTAAGGAAGTGAAGCGTGTTGGTTATGGCAATGCAGATATCGGTACCCAAGTCGATAATTTTTGGCTGGTGGGTCCTTTAAAAATTACTCCTCAGCAAGAGGCACAGTTTGCTTACAAGCTAGCTAATAAAACGCTTCCATTTAGCCAAAAAGTCCAAGATGAAGTGCAATCCATGCTATTCATAGAAGAAAAGAATGGAAACAAAATATACGCAAAAAGTGGTTGGGGATGGGATGTAAACCCACAAGTAGGCTGGTTAACTGGATGGGTTGTTCAGCCTCAAGGGAATATTGTAGCGTTCTCCCTTAACTTAGAAATGAAAAAAGGAATACCTAG
gb|AM412777|+|117-918|ARO:3001439|OXA-101 [Citrobacter freundii] 	0	746	659	1405	801	104604+	746	ATGAAAACATTTGCCGCATATGTAATTATCGCGTGTCTTTCGAGTACGGCATTAGCTGGTTCAATTACAGAAAATACGTCTTGGAACAAAGAGTTCTCTGCCGAAGCCGTCAATGGTGTCTTCGTGCTTTGTAAAAGTAGCAGTAAATCCTGCGCTACCAATGACTTAGCTCGTGCATCAAAGGAATATCTTCCAGCATCAACATTTAAGATCCCCAACGCAATTATCGGCCTAGAAACTGGTGTCATAAAGAATGAGCATCAGGTTTTCAAATGGGACGGAAAGCCAAGAGCCATGAAGCAATGGGAAAGAGACTTGACCTTAAGAGGGGCAATACAAGTTTCAGCTGTTCCCGTATTTCAACAAATCGCCAGAGAAGTTGGCGAAGTAAGAATGCAGAAATACCTTAAAAAATTTTCCTATGGCAACCAGAATATCAGTGGTGGCATTGACAAATTCTGGTTGGAAGGCCAGCTTAGAATTTCCGCAGTTAATCAAGTGGAGTTTCTAGAGTCTCTATATTTAAATAAATTGTCAGCATCTAAAGAAAACCAGCTAATAGTAAAAGAGGCTTTGGTAACGGAGGCGGCACCTGAATATCTAGTGCATTCAAAAACTGGTTTTTCTGGTGTGGGAACTGAGTCAAATCCTGGTGTCGCATGGTGGGTTGGGTGGGTTGAGAAGGAGACAGAGGTTTACTTTTTCGCCTTTAACATGGATATAGACAACGAAAGTAAGTTGCCGCT
gb|APQF01000011.1|+|291557-292379|ARO:3001707|OXA-103 [Acinetobacter radioresistens DSM 6976 = NBRC 102413 = CIP 103788] 	0	767	80	847	822	254088-	767	ATGAATAAATATTTTACTTGCTATGTGGTTGCTTCTCTTTTTCTTTCTGGTTGTACGGTTCAGCATAATTTAATAAATGAAACCCCGAGTCAGATTGTTCAAGGACATAATCAGGTGATTCATCAATACTTTGATGAAAAAAACACCTCAGGTGTGCTGGTTATTCAAACAGATAAAAAAATTAATCTATATGGTAATGCTCTAAGCCGCGCAAATACAGAATATGTGCCAGCCTCTACATTTAAAATGTTGAATGCCCTGATCGGATTGGAGAACCAGAAAACGGATATTAATGAAATATTTAAATGGAAGGGCGAGAAAAGGTCATTTACCGCTTGGGAAAAAGACATGACACTAGGAGAAGCCATGAAGCTTTCTGCAGTCCCAGTCTATCAGGAACTTGCGCGACGTATCGGTCTTGATCTCATGCAAAAAGAAGTAAAACGTATTGGTTTCGGTAATGCTGAAATTGGACAGCAGGTTGATAATTTCTGGTTGGTAGGACCATTAAAGGTTACGCCTATTCAAGAGGTAGAGTTTGTTTCCCAATTAGCACATACACAGCTTCCATTTAGTGAAAAAGTGCAGGCTAATGTAAAAAATATGCTTCTTTTAGAAGAGAGTAATGGCTACAAAATTTTTGGAAAGACTGGTTGGGCAATGGATATAAAACCACAAGTGGGCTGGTTGACCGGCTGGGTTGAGCAGCCAGATGGAAAAATTGTCGCTTTTGCATTAAATATGGAAATGCGGTCAGAAATGCCGGC
gb|EF650032|+|0-825|ARO:3001637|OXA-106 [Acinetobacter baumannii] 	0	770	54149	54919	825	246080-	770	ATGAACATTAAAGCACTCTTACTTATAACAAGCGCTATTTTTATTTCAGCCTGCTCACCTTATATAGTGACTGCTAATCCAAATCACAGCGCTTCAAAATCTGATGTAAAAGCAGAGAAAATTAAAAATTTATTTAACGAAGCACACACTACGGGTGTTTTAGTTATCCAACAAGGCCAAACTCAACAAAGCTATGGTAATGATCTTGCTCGTGCTTCGACCGAGTATGTACCTGCTTCGACCTTCAAAATGCTTAATGCTTTGATCGGCCTTGAGCACCATAAGGCAACCACCACAGAAGTATTTAAGTGGGATGGTAAAAAAAGGTTATTCCCAGAATGGGAAAAGGACATGACCCTAGGCGATGCCATGAAAGCTTCCGCTATTCCAGTTTATCAAGATTTAGCTCGTCGTATTGGACTTGAGCTCATGTCTAAGGAAGTGAAGCGTGTTGGTTATGGCAATGCAGATATCGGTACCCAAGTCGATAATTTTTGGCTGGTGGGTCCTTTAAAAATTACTCCTCAGCAAGAGGCACAGTTTGCTTACAAGCTAGCTAATAAAACGCTTCCATTTAGCCAAAAAGTCCAAGATGAAGTGCAATCCATGCTATTCATAGAAGAAAAGAATGGAAACAAAATATACGCAAAAAGTGGTTGGGGATGGGATGTAAACCCACAAGTAGGCTGGTTAACTGGATGGGTTGTTCAGCCTCAAGGGAATATTGTAGCGTTCTCCCTTAACTTAGAAATGAAAAAAGGAATACCTAG
gb|EF650033|+|0-825|ARO:3001638|OXA-107 [Acinetobacter baumannii A424] 	0	770	54149	54919	825	246080-	770	ATGAACATTAAAGCACTCTTACTTATAACAAGCGCTATTTTTATTTCAGCCTGCTCACCTTATATAGTGACTGCTAATCCAAATCACAGCGCTTCAAAATCTGATGTAAAAGCAGAGAAAATTAAAAATTTATTTAACGAAGCACACACTACGGGTGTTTTAGTTATCCAACAAGGCCAAACTCAACAAAGCTATGGTAATGATCTTGCTCGTGCTTCGACCGAGTATGTACCTGCTTCGACCTTCAAAATGCTTAATGCTTTGATCGGCCTTGAGCACCATAAGGCAACCACCACAGAAGTATTTAAGTGGGATGGTAAAAAAAGGTTATTCCCAGAATGGGAAAAGGACATGACCCTAGGCGATGCCATGAAAGCTTCCGCTATTCCAGTTTATCAAGATTTAGCTCGTCGTATTGGACTTGAGCTCATGTCTAAGGAAGTGAAGCGTGTTGGTTATGGCAATGCAGATATCGGTACCCAAGTCGATAATTTTTGGCTGGTGGGTCCTTTAAAAATTACTCCTCAGCAAGAGGCACAGTTTGCTTACAAGCTAGCTAATAAAACGCTTCCATTTAGCCAAAAAGTCCAAGATGAAGTGCAATCCATGCTATTCATAGAAGAAAAGAATGGAAACAAAATATACGCAAAAAGTGGTTGGGGATGGGATGTAAACCCACAAGTAGGCTGGTTAACTGGATGGGTTGTTCAGCCTCAAGGGAATATTGTAGCGTTCTCCCTTAACTTAGAAATGAAAAAAGGAATACCTAG
gb|EF650034|+|0-825|ARO:3001639|OXA-108 [Acinetobacter baumannii] 	0	770	54149	54919	825	246080-	770	ATGAACATTAAAGCACTCTTACTTATAACAAGCGCTATTTTTATTTCAGCCTGCTCACCTTATATAGTGACTGCTAATCCAAATCACAGCGCTTCAAAATCTGATGTAAAAGCAGAGAAAATTAAAAATTTATTTAACGAAGCACACACTACGGGTGTTTTAGTTATCCAACAAGGCCAAACTCAACAAAGCTATGGTAATGATCTTGCTCGTGCTTCGACCGAGTATGTACCTGCTTCGACCTTCAAAATGCTTAATGCTTTGATCGGCCTTGAGCACCATAAGGCAACCACCACAGAAGTATTTAAGTGGGATGGTAAAAAAAGGTTATTCCCAGAATGGGAAAAGGACATGACCCTAGGCGATGCCATGAAAGCTTCCGCTATTCCAGTTTATCAAGATTTAGCTCGTCGTATTGGACTTGAGCTCATGTCTAAGGAAGTGAAGCGTGTTGGTTATGGCAATGCAGATATCGGTACCCAAGTCGATAATTTTTGGCTGGTGGGTCCTTTAAAAATTACTCCTCAGCAAGAGGCACAGTTTGCTTACAAGCTAGCTAATAAAACGCTTCCATTTAGCCAAAAAGTCCAAGATGAAGTGCAATCCATGCTATTCATAGAAGAAAAGAATGGAAACAAAATATACGCAAAAAGTGGTTGGGGATGGGATGTAAACCCACAAGTAGGCTGGTTAACTGGATGGGTTGTTCAGCCTCAAGGGAATATTGTAGCGTTCTCCCTTAACTTAGAAATGAAAAAAGGAATACCTAG
gb|EF650035|+|0-825|ARO:3001640|OXA-109 [Acinetobacter baumannii] 	0	770	54149	54919	825	246080-	770	ATGAACATTAAAGCACTCTTACTTATAACAAGCGCTATTTTTATTTCAGCCTGCTCACCTTATATAGTGACTGCTAATCCAAATCACAGCGCTTCAAAATCTGATGTAAAAGCAGAGAAAATTAAAAATTTATTTAACGAAGCACACACTACGGGTGTTTTAGTTATCCAACAAGGCCAAACTCAACAAAGCTATGGTAATGATCTTGCTCGTGCTTCGACCGAGTATGTACCTGCTTCGACCTTCAAAATGCTTAATGCTTTGATCGGCCTTGAGCACCATAAGGCAACCACCACAGAAGTATTTAAGTGGGATGGTAAAAAAAGGTTATTCCCAGAATGGGAAAAGGACATGACCCTAGGCGATGCCATGAAAGCTTCCGCTATTCCAGTTTATCAAGATTTAGCTCGTCGTATTGGACTTGAGCTCATGTCTAAGGAAGTGAAGCGTGTTGGTTATGGCAATGCAGATATCGGTACCCAAGTCGATAATTTTTGGCTGGTGGGTCCTTTAAAAATTACTCCTCAGCAAGAGGCACAGTTTGCTTACAAGCTAGCTAATAAAACGCTTCCATTTAGCCAAAAAGTCCAAGATGAAGTGCAATCCATGCTATTCATAGAAGAAAAGAATGGAAACAAAATATACGCAAAAAGTGGTTGGGGATGGGATGTAAACCCACAAGTAGGCTGGTTAACTGGATGGGTTGTTCAGCCTCAAGGGAATATTGTAGCGTTCTCCCTTAACTTAGAAATGAAAAAAGGAATACCTAG
gb|Z22590|+|154-955|ARO:3001406|OXA-11 [Pseudomonas aeruginosa] 	0	746	659	1405	801	104604+	746	ATGAAAACATTTGCCGCATATGTAATTATCGCGTGTCTTTCGAGTACGGCATTAGCTGGTTCAATTACAGAAAATACGTCTTGGAACAAAGAGTTCTCTGCCGAAGCCGTCAATGGTGTCTTCGTGCTTTGTAAAAGTAGCAGTAAATCCTGCGCTACCAATGACTTAGCTCGTGCATCAAAGGAATATCTTCCAGCATCAACATTTAAGATCCCCAACGCAATTATCGGCCTAGAAACTGGTGTCATAAAGAATGAGCATCAGGTTTTCAAATGGGACGGAAAGCCAAGAGCCATGAAGCAATGGGAAAGAGACTTGACCTTAAGAGGGGCAATACAAGTTTCAGCTGTTCCCGTATTTCAACAAATCGCCAGAGAAGTTGGCGAAGTAAGAATGCAGAAATACCTTAAAAAATTTTCCTATGGCAACCAGAATATCAGTGGTGGCATTGACAAATTCTGGTTGGAAGGCCAGCTTAGAATTTCCGCAGTTAATCAAGTGGAGTTTCTAGAGTCTCTATATTTAAATAAATTGTCAGCATCTAAAGAAAACCAGCTAATAGTAAAAGAGGCTTTGGTAACGGAGGCGGCACCTGAATATCTAGTGCATTCAAAAACTGGTTTTTCTGGTGTGGGAACTGAGTCAAATCCTGGTGTCGCATGGTGGGTTGGGTGGGTTGAGAAGGAGACAGAGGTTTACTTTTTCGCCTTTAACATGGATATAGACAACGAAAGTAAGTTGCCGCT
gb|EF650036|+|0-825|ARO:3001641|OXA-110 [Acinetobacter baumannii] 	0	770	54149	54919	825	246080-	770	ATGAACATTAAAGCACTCTTACTTATAACAAGCGCTATTTTTATTTCAGCCTGCTCACCTTATATAGTGACTGCTAATCCAAATCACAGCGCTTCAAAATCTGATGTAAAAGCAGAGAAAATTAAAAATTTATTTAACGAAGCACACACTACGGGTGTTTTAGTTATCCAACAAGGCCAAACTCAACAAAGCTATGGTAATGATCTTGCTCGTGCTTCGACCGAGTATGTACCTGCTTCGACCTTCAAAATGCTTAATGCTTTGATCGGCCTTGAGCACCATAAGGCAACCACCACAGAAGTATTTAAGTGGGATGGTAAAAAAAGGTTATTCCCAGAATGGGAAAAGGACATGACCCTAGGCGATGCCATGAAAGCTTCCGCTATTCCAGTTTATCAAGATTTAGCTCGTCGTATTGGACTTGAGCTCATGTCTAAGGAAGTGAAGCGTGTTGGTTATGGCAATGCAGATATCGGTACCCAAGTCGATAATTTTTGGCTGGTGGGTCCTTTAAAAATTACTCCTCAGCAAGAGGCACAGTTTGCTTACAAGCTAGCTAATAAAACGCTTCCATTTAGCCAAAAAGTCCAAGATGAAGTGCAATCCATGCTATTCATAGAAGAAAAGAATGGAAACAAAATATACGCAAAAAGTGGTTGGGGATGGGATGTAAACCCACAAGTAGGCTGGTTAACTGGATGGGTTGTTCAGCCTCAAGGGAATATTGTAGCGTTCTCCCTTAACTTAGAAATGAAAAAAGGAATACCTAG
gb|EF650037|+|0-825|ARO:3001642|OXA-111 [Acinetobacter baumannii] 	0	770	54149	54919	825	246080-	770	ATGAACATTAAAGCACTCTTACTTATAACAAGCGCTATTTTTATTTCAGCCTGCTCACCTTATATAGTGACTGCTAATCCAAATCACAGCGCTTCAAAATCTGATGTAAAAGCAGAGAAAATTAAAAATTTATTTAACGAAGCACACACTACGGGTGTTTTAGTTATCCAACAAGGCCAAACTCAACAAAGCTATGGTAATGATCTTGCTCGTGCTTCGACCGAGTATGTACCTGCTTCGACCTTCAAAATGCTTAATGCTTTGATCGGCCTTGAGCACCATAAGGCAACCACCACAGAAGTATTTAAGTGGGATGGTAAAAAAAGGTTATTCCCAGAATGGGAAAAGGACATGACCCTAGGCGATGCCATGAAAGCTTCCGCTATTCCAGTTTATCAAGATTTAGCTCGTCGTATTGGACTTGAGCTCATGTCTAAGGAAGTGAAGCGTGTTGGTTATGGCAATGCAGATATCGGTACCCAAGTCGATAATTTTTGGCTGGTGGGTCCTTTAAAAATTACTCCTCAGCAAGAGGCACAGTTTGCTTACAAGCTAGCTAATAAAACGCTTCCATTTAGCCAAAAAGTCCAAGATGAAGTGCAATCCATGCTATTCATAGAAGAAAAGAATGGAAACAAAATATACGCAAAAAGTGGTTGGGGATGGGATGTAAACCCACAAGTAGGCTGGTTAACTGGATGGGTTGTTCAGCCTCAAGGGAATATTGTAGCGTTCTCCCTTAACTTAGAAATGAAAAAAGGAATACCTAG
gb|EF650038|+|0-825|ARO:3001643|OXA-112 [Acinetobacter baumannii] 	0	770	54149	54919	825	246080-	770	ATGAACATTAAAGCACTCTTACTTATAACAAGCGCTATTTTTATTTCAGCCTGCTCACCTTATATAGTGACTGCTAATCCAAATCACAGCGCTTCAAAATCTGATGTAAAAGCAGAGAAAATTAAAAATTTATTTAACGAAGCACACACTACGGGTGTTTTAGTTATCCAACAAGGCCAAACTCAACAAAGCTATGGTAATGATCTTGCTCGTGCTTCGACCGAGTATGTACCTGCTTCGACCTTCAAAATGCTTAATGCTTTGATCGGCCTTGAGCACCATAAGGCAACCACCACAGAAGTATTTAAGTGGGATGGTAAAAAAAGGTTATTCCCAGAATGGGAAAAGGACATGACCCTAGGCGATGCCATGAAAGCTTCCGCTATTCCAGTTTATCAAGATTTAGCTCGTCGTATTGGACTTGAGCTCATGTCTAAGGAAGTGAAGCGTGTTGGTTATGGCAATGCAGATATCGGTACCCAAGTCGATAATTTTTGGCTGGTGGGTCCTTTAAAAATTACTCCTCAGCAAGAGGCACAGTTTGCTTACAAGCTAGCTAATAAAACGCTTCCATTTAGCCAAAAAGTCCAAGATGAAGTGCAATCCATGCTATTCATAGAAGAAAAGAATGGAAACAAAATATACGCAAAAAGTGGTTGGGGATGGGATGTAAACCCACAAGTAGGCTGGTTAACTGGATGGGTTGTTCAGCCTCAAGGGAATATTGTAGCGTTCTCCCTTAACTTAGAAATGAAAAAAGGAATACCTAG
gb|EF653400|+|434-1259|ARO:3001644|OXA-113 [Acinetobacter baumannii] 	0	770	54149	54919	825	246080-	770	ATGAACATTAAAGCACTCTTACTTATAACAAGCGCTATTTTTATTTCAGCCTGCTCACCTTATATAGTGACTGCTAATCCAAATCACAGCGCTTCAAAATCTGATGTAAAAGCAGAGAAAATTAAAAATTTATTTAACGAAGCACACACTACGGGTGTTTTAGTTATCCAACAAGGCCAAACTCAACAAAGCTATGGTAATGATCTTGCTCGTGCTTCGACCGAGTATGTACCTGCTTCGACCTTCAAAATGCTTAATGCTTTGATCGGCCTTGAGCACCATAAGGCAACCACCACAGAAGTATTTAAGTGGGATGGTAAAAAAAGGTTATTCCCAGAATGGGAAAAGGACATGACCCTAGGCGATGCCATGAAAGCTTCCGCTATTCCAGTTTATCAAGATTTAGCTCGTCGTATTGGACTTGAGCTCATGTCTAAGGAAGTGAAGCGTGTTGGTTATGGCAATGCAGATATCGGTACCCAAGTCGATAATTTTTGGCTGGTGGGTCCTTTAAAAATTACTCCTCAGCAAGAGGCACAGTTTGCTTACAAGCTAGCTAATAAAACGCTTCCATTTAGCCAAAAAGTCCAAGATGAAGTGCAATCCATGCTATTCATAGAAGAAAAGAATGGAAACAAAATATACGCAAAAAGTGGTTGGGGATGGGATGTAAACCCACAAGTAGGCTGGTTAACTGGATGGGTTGTTCAGCCTCAAGGGAATATTGTAGCGTTCTCCCTTAACTTAGAAATGAAAAAAGGAATACCTAG
gb|EU029998|+|575-1400|ARO:3001440|OXA-115 [Acinetobacter baumannii] 	0	770	54149	54919	825	246080-	770	ATGAACATTAAAGCACTCTTACTTATAACAAGCGCTATTTTTATTTCAGCCTGCTCACCTTATATAGTGACTGCTAATCCAAATCACAGCGCTTCAAAATCTGATGTAAAAGCAGAGAAAATTAAAAATTTATTTAACGAAGCACACACTACGGGTGTTTTAGTTATCCAACAAGGCCAAACTCAACAAAGCTATGGTAATGATCTTGCTCGTGCTTCGACCGAGTATGTACCTGCTTCGACCTTCAAAATGCTTAATGCTTTGATCGGCCTTGAGCACCATAAGGCAACCACCACAGAAGTATTTAAGTGGGATGGTAAAAAAAGGTTATTCCCAGAATGGGAAAAGGACATGACCCTAGGCGATGCCATGAAAGCTTCCGCTATTCCAGTTTATCAAGATTTAGCTCGTCGTATTGGACTTGAGCTCATGTCTAAGGAAGTGAAGCGTGTTGGTTATGGCAATGCAGATATCGGTACCCAAGTCGATAATTTTTGGCTGGTGGGTCCTTTAAAAATTACTCCTCAGCAAGAGGCACAGTTTGCTTACAAGCTAGCTAATAAAACGCTTCCATTTAGCCAAAAAGTCCAAGATGAAGTGCAATCCATGCTATTCATAGAAGAAAAGAATGGAAACAAAATATACGCAAAAAGTGGTTGGGGATGGGATGTAAACCCACAAGTAGGCTGGTTAACTGGATGGGTTGTTCAGCCTCAAGGGAATATTGTAGCGTTCTCCCTTAACTTAGAAATGAAAAAAGGAATACCTAG
